"Address A","Port A","Address B","Port B","Packets","Bytes","Packets A → B","Bytes A → B","Packets B → A","Bytes B → A","Rel Start","Duration","Bits/s A → B","Bits/s B → A"
"15.71.149.111",50616,"41.177.26.46",80,512,503339,167,12787,345,490552,117.170356,3.509063999999995,29151.933393064402,1118365.467258507
"15.71.149.241",52924,"41.177.26.15",80,968,1152125,173,12850,795,1139275,19.470298,7.273785,14132.944539878481,1253020.263865374
"15.71.149.241",56148,"41.177.26.15",80,144,154436,35,2718,109,151718,23.998502,0.7112220000000029,30572.732564515594,1706561.3830843184
"15.71.149.241",57186,"41.177.26.15",80,902,1160925,97,6971,805,1153954,29.004546,2.476032,22523.133788254756,3728397.694375517
"15.128.184.13",24176,"41.177.26.46",80,16,7478,8,1153,8,6325,26.1468,5.053976000000002,1825.09770525226,10011.919328465347
"15.128.184.13",24177,"41.177.26.176",80,28,15924,9,1322,19,14602,26.147429,13.345333999999998,792.486722325571,8753.321572918296
"15.128.184.13",37684,"41.177.26.176",80,34,13436,17,1861,17,11575,99.495145,7.5766980000000075,1964.9720762263437,12221.682849177823
"15.128.184.13",37703,"41.177.26.46",80,17,7579,9,1235,8,6344,99.514511,7.601425000000006,1299.7562956945562,6676.642866304668
"15.128.184.13",47992,"41.177.26.176",80,30,16058,10,1392,20,14666,151.087089,11.371426000000014,979.2967038610625,10317.791277892487
"15.128.184.13",48019,"41.177.26.46",80,17,7509,9,1221,8,6288,151.187094,0.6253659999999854,15619.653131126775,80439.29474899686
"15.186.51.17",40917,"41.177.98.79",80,38,25221,18,1707,20,23514,34.148837,0.29155399999999787,46838.66453555808,645204.6619151216
"15.186.110.41",60306,"244.3.210.197",80,26,16004,13,1348,13,14656,10.822067,0.6623849999999987,16280.561908859683,177008.8392702133
"15.186.110.41",60393,"244.3.210.197",80,29,17986,14,1485,15,16501,11.529719,0.6313669999999991,18816.31444152136,209082.83138016428
"15.186.110.41",60461,"244.3.210.197",80,31,20060,15,1524,16,18536,12.10536,0.7830710000000014,15569.469435083125,189367.2476697512
"15.186.110.41",33001,"244.3.210.197",80,32,20848,15,1569,17,19279,19.258015,0.5746150000000014,21844.19132810659,268409.28273713635
"15.186.110.41",34113,"244.3.210.197",80,17,8170,9,1045,8,7125,31.173741,0.20805899999999866,40180.910222581355,273960.75151760015
"15.186.110.41",36422,"244.3.210.197",80,32,20447,15,1498,17,18949,53.80017,0.6210919999999973,19295.048076613533,244073.3417915553
"15.186.110.41",36506,"244.3.210.197",80,29,17867,14,1408,15,16459,54.458136,0.6661099999999962,16910.119950158478,197673.0570025983
"15.186.110.41",40268,"244.3.210.197",80,17,8166,9,1041,8,7125,88.26487,0.21095099999999434,39478.362273704435,270204.92910676665
"15.186.110.41",40848,"244.3.210.197",80,39,28665,18,1674,21,26991,93.12902,0.696858000000006,19217.688539128325,309859.39746691316
"15.186.110.41",41367,"244.3.210.197",80,17,8159,9,1034,8,7125,97.475074,0.21565199999999152,38358.09545007849,264314.7292860824
"15.186.110.41",46336,"244.3.210.197",80,32,22837,15,1479,17,21358,142.265846,0.6639809999999784,17819.787011978333,257332.6646395086
"15.186.110.41",48987,"244.3.210.197",80,29,18168,14,1489,15,16679,166.703573,0.6285419999999817,18951.79637955832,212288.12076202367
"15.186.110.41",49119,"244.3.210.197",80,26,16668,13,1362,13,15306,167.993692,0.6678759999999784,16314.405668118563,183339.42228797555
"15.186.110.41",51970,"244.3.210.197",80,29,18507,14,1408,15,17099,196.154165,0.6052259999999876,18611.229524178125,226018.04945591037
"15.186.110.132",34909,"41.177.26.91",80,10,2379,5,771,5,1608,33.274109,0.1856209999999976,33228.998874050245,69302.50348829155
"15.186.110.132",35452,"41.177.26.91",80,28,17811,14,1418,14,16393,39.450547,0.3753099999999989,30225.680104447078,349428.4724627651
"15.186.110.132",37046,"41.177.26.91",80,29,18888,14,1496,15,17392,58.045668,0.3745100000000008,31956.4230594643,371514.7793116331
"15.186.110.132",37498,"41.177.26.91",80,29,19479,14,1435,15,18044,63.607371,0.40059200000000317,28657.586771577837,360346.68690338015
"15.186.110.132",38773,"41.177.26.91",80,29,18961,14,1423,15,17538,78.770376,0.3658099999999962,31119.980317651563,383543.36950876535
"15.186.110.132",38832,"41.177.26.91",80,26,15586,13,1366,13,14220,79.350766,0.38198000000001286,28608.827687312507,297816.6396146295
"15.186.110.132",39255,"41.177.26.91",80,29,19510,14,1422,15,18088,84.129484,0.39923100000000034,28494.781216889445,362456.8232426838
"15.186.110.132",40544,"41.177.26.91",80,20,11701,10,1115,10,10586,98.860768,0.3159640000000081,28231.064298463654,268030.5351242478
"15.186.110.132",41442,"41.177.26.91",80,28,17982,14,1468,14,16514,109.454675,0.3888510000000025,30201.799661052497,339749.672753829
"15.186.110.132",41958,"41.177.26.91",80,38,27809,17,1679,21,26130,115.209617,0.5300140000000084,25342.726795895556,394404.6761028891
"15.186.110.132",44059,"41.177.26.91",80,20,11406,10,1091,10,10315,139.556137,0.322638999999981,27051.906310150087,255765.73197910003
"15.186.110.132",45331,"41.177.26.91",80,28,17363,14,1463,14,15900,153.712616,0.3498739999999998,33452.042735384755,363559.452831591
"15.186.110.132",45407,"41.177.26.91",80,28,18170,14,1429,14,16741,154.796816,0.36089300000000435,31676.979049191483,371101.68387859664
"15.186.110.132",46201,"41.177.26.91",80,28,17402,14,1463,14,15939,163.973583,0.394297000000023,29683.208342947873,323390.7435258005
"15.186.110.132",46238,"41.177.26.91",80,28,17846,14,1467,14,16379,164.421602,0.3774870000000021,31089.812364399128,347116.5894454624
"15.186.110.132",46933,"41.177.26.91",80,28,18187,14,1471,14,16716,172.597605,1.4679780000000164,8016.468911659349,91096.73305730638
"15.186.110.132",47324,"41.177.26.91",80,47,38186,20,1882,27,36304,176.626845,0.9577600000000075,15720.013364517084,303240.8954226505
"15.186.110.132",47595,"41.177.26.91",80,26,15565,13,1415,13,14150,179.825885,0.386792000000014,29266.375726487597,292663.7572648759
"15.186.110.132",47800,"41.177.26.91",80,31,20047,15,1532,16,18515,182.373605,0.3723229999999944,32917.654831960914,397826.6182857418
"15.186.110.142",44381,"41.177.26.176",80,24,10826,12,1306,12,9520,4.33615,0.9227860000000003,11322.23505774903,82532.67821575097
"15.186.110.142",44809,"41.177.26.176",80,29,14370,14,1497,15,12873,10.099884,0.9264710000000012,12926.470445378198,111157.28393009589
"15.186.110.142",45060,"41.177.26.176",80,30,12082,15,1535,15,10547,13.932819,1.672851999999999,7340.756982685861,50438.41296181614
"15.186.110.142",45569,"41.177.26.176",80,31,12797,14,1480,17,11317,21.051179,2.220537,5332.043555230108,40772.11953685077
"15.186.110.142",46004,"41.177.26.176",80,32,13399,15,1556,17,11843,27.39707,1.308835000000002,9510.748108050275,72388.03974526953
"15.186.110.142",46600,"41.177.26.176",80,26,13459,13,1369,13,12090,36.317206,1.8700839999999985,5856.4214227810135,51719.60190023554
"15.186.110.142",46705,"41.177.26.176",80,32,12251,16,1631,16,10620,37.464822,1.025071000000004,12728.874390164143,82882.06377899644
"15.186.110.142",46776,"41.177.26.176",80,29,13334,14,1468,15,11866,38.416403,1.5167539999999988,7742.850851225716,62586.28624022094
"15.186.110.142",46812,"41.177.26.176",80,16,6559,8,1034,8,5525,38.905335,0.41657699999999664,19857.073242161874,106102.83332973342
"15.186.110.142",46912,"41.177.26.176",80,24,11648,12,1293,12,10355,40.331554,2.161091000000006,4786.471277701851,38332.49039489766
"15.186.110.142",47106,"41.177.26.176",80,29,13266,14,1478,15,11788,42.930982,0.5534150000000011,21365.521353776057,170403.7657092775
"15.186.110.142",47173,"41.177.26.176",80,20,9767,10,1159,10,8608,43.875125,3.1751210000000043,2920.2036709782046,21688.62226037997
"15.186.110.142",47368,"41.177.26.176",80,22,10499,11,1361,11,9138,47.042032,0.21689400000000347,50199.6366888887,337049.43428586697
"15.186.110.142",47388,"41.177.26.176",80,24,13233,12,1320,12,11913,47.329214,0.529040000000002,19960.683502192576,180145.168607288
"15.186.110.142",48264,"41.177.26.176",80,29,12172,14,1487,15,10685,59.177724,1.121579000000004,10606.475335219326,76213.98046860693
"15.186.110.142",48377,"41.177.26.176",80,28,12646,13,1416,15,11230,60.509766,1.2821330000000017,8835.276839454242,70070.73369143442
"15.186.110.142",48973,"41.177.26.176",80,30,12597,14,1474,16,11123,69.478871,1.7000730000000033,6936.172740817587,52341.281815545466
"15.186.110.142",49083,"41.177.26.176",80,32,12756,16,1620,16,11136,70.877307,2.101989000000003,6165.58887796272,42382.714657403
"15.186.110.142",49576,"41.177.26.176",80,36,24228,17,2011,19,22217,77.741352,0.7313719999999932,21997.013831538738,243017.23336414524
"15.186.110.142",49770,"41.177.26.176",80,30,13100,15,1569,15,11531,80.694979,1.00591399999999,12478.20390212297,91705.65276952197
"15.186.110.142",49836,"41.177.26.176",80,27,13785,13,1389,14,12396,81.874189,0.517479999999992,21473.293653861354,191636.39174461146
"15.186.110.142",50822,"41.177.26.176",80,28,12827,14,1459,14,11368,96.606672,1.6828610000000026,6935.807532529414,54041.30228224426
"15.186.110.142",51104,"41.177.26.176",80,29,12545,14,1502,15,11043,100.730143,0.9923749999999956,12108.325985640564,89022.79884116427
"15.186.110.142",51246,"41.177.26.176",80,29,12361,14,1496,15,10865,102.845771,1.7540639999999996,6823.012159191457,49553.49405722939
"15.186.110.142",51392,"41.177.26.176",80,22,11129,11,1219,11,9910,104.928757,2.2545879999999983,4325.402246441482,35163.85255310508
"15.186.110.142",51500,"41.177.26.176",80,50,24312,22,2005,28,22307,106.376563,4.229165999999992,3792.7099574715276,42196.499262502424
"15.186.110.142",51883,"41.177.26.176",80,29,13176,14,1499,15,11677,111.437866,1.1668690000000055,10277.074804455293,80056.97297640058
"15.186.110.142",52041,"41.177.26.176",80,28,12330,13,1417,15,10913,113.802358,1.7573700000000088,6450.548262460349,49678.78136078319
"15.186.110.142",52509,"41.177.26.176",80,31,13146,15,1565,16,11581,120.302314,1.0924640000000068,11460.33187363604,84806.45586490669
"15.186.110.142",52668,"41.177.26.176",80,29,12966,13,1416,16,11550,122.258928,1.312618999999998,8630.074682752587,70393.6176453336
"15.186.110.142",52995,"41.177.26.176",80,14,5311,7,957,7,4354,126.444644,0.5736909999999966,13345.16316274797,60715.61171432044
"15.186.110.142",53127,"41.177.26.176",80,28,14852,14,1542,14,13310,128.170435,1.0904280000000028,11312.98902816139,97649.73019768359
"15.186.110.142",53350,"41.177.26.176",80,14,5295,7,982,7,4313,131.110803,0.5726129999999898,13719.56277625576,60257.10209164063
"15.186.110.142",54529,"41.177.26.176",80,28,13520,14,1460,14,12060,146.763094,0.5448120000000074,21438.587989985244,177088.6103830288
"15.186.110.142",54988,"41.177.26.176",80,31,12819,15,1543,16,11276,164.956058,1.8690459999999973,6604.4388420616815,48264.19467471648
"15.186.110.142",55550,"41.177.26.176",80,27,12603,13,1376,14,11227,165.218958,1.5363860000000216,7164.866120883584,58459.267397645344
"15.186.110.142",55793,"41.177.26.176",80,29,12576,14,1493,15,11083,166.806063,1.6596310000000187,7196.780489156846,53423.923751724935
"15.186.110.142",55803,"41.177.26.176",80,29,12436,14,1455,15,10981,166.873315,1.0200780000000123,11410.89210825041,86118.90463278195
"15.186.110.142",55924,"41.177.26.176",80,34,22753,16,1936,18,20817,167.947257,0.7267329999999959,21311.816031472477,229157.06318551785
"15.186.110.142",55984,"41.177.26.176",80,30,12528,15,1557,15,10971,168.508659,1.0428579999999954,11944.099771972842,84161.02671696471
"15.186.110.142",56114,"41.177.26.176",80,24,12244,12,1345,12,10899,169.989913,1.2263710000000003,8773.853915332307,71097.57161576716
"15.186.110.142",56550,"41.177.26.176",80,98,84935,37,3054,61,81881,175.642726,1.087175000000002,22472.92294248852,602523.0528663727
"15.186.110.142",56693,"41.177.26.176",80,29,14840,14,1543,15,13297,177.666267,1.1308429999999987,10915.750462265774,94067.876796337
"15.186.110.142",56712,"41.177.26.176",80,32,12857,15,1570,17,11287,177.858421,1.0381519999999966,12098.421040464249,86977.62948007642
"15.186.110.142",56830,"41.177.26.176",80,16,5451,8,1027,8,4424,179.316264,0.5709439999999972,14390.20289205253,61988.56630422628
"15.186.110.142",57413,"41.177.26.176",80,34,12625,17,1703,17,10922,186.545936,1.4026509999999917,9713.036243513234,62293.47143373549
"15.186.110.142",57598,"41.177.26.176",80,28,12852,14,1463,14,11389,189.102176,1.590233000000012,7359.927759013875,57294.748631174996
"15.186.110.142",58030,"41.177.26.176",80,36,12043,16,1547,20,10496,194.87522,1.8124859999999785,6828.1906729211405,46327.53025402734
"15.186.110.142",58756,"41.177.26.176",80,34,13475,17,1705,17,11770,204.417441,1.3152860000000146,10370.368117656424,71588.99281220887
"15.186.110.142",59082,"41.177.26.176",80,28,12261,13,1413,15,10848,208.590739,1.1284670000000006,10017.129433115895,76904.33127419761
"15.186.110.188",59778,"41.177.26.46",80,2,160,1,78,1,82,213.061154,0.0002870000000143591,0,0
"15.186.164.176",41206,"41.177.26.46",80,12,2761,6,848,6,1913,64.625174,0.15104700000000548,44913.17272107194,101319.45685779555
"15.186.164.176",42690,"41.177.26.46",80,10,1548,5,791,5,757,82.445376,0.15056500000000028,42028.35984458531,40221.83110284587
"15.186.164.220",59629,"41.177.26.15",80,18,10230,9,1260,9,8970,197.227834,0.8545320000000061,11795.930404010533,83975.7902571226
"15.205.242.71",2052,"244.3.210.197",80,4,256,2,128,2,128,25.554173,0.04748999999999981,21562.43419667307,21562.43419667307
"15.205.242.71",2062,"244.3.210.197",80,13,1697,7,1103,6,594,25.554459,66.90624600000001,131.8860424481146,71.02475903370814
"15.205.242.71",2064,"244.3.210.197",80,12,1637,7,1105,5,532,89.787172,68.34770700000001,129.33864774717313,62.269828598639
"15.205.242.71",2067,"244.3.210.197",80,6,1249,4,911,2,338,158.085364,0.26927100000000337,27065.669901325833,10041.928020469959
"18.22.130.128",2176,"41.177.98.176",80,116,86568,49,12860,67,73708,135.937951,37.41624999999999,2749.607456653193,15759.569705676013
"18.22.130.128",2177,"41.177.98.176",80,62,44277,26,5778,36,38499,138.148178,35.200592,1313.1597332226686,8749.625574478974
"18.22.130.128",2178,"41.177.98.176",80,91,77570,35,5662,56,71908,138.151658,35.195471,1286.983771292619,16344.830276600078
"18.22.130.128",2179,"41.177.98.176",80,54,37393,23,5574,31,31819,138.153154,35.19761,1266.904201734152,7232.081951018834
"18.22.130.128",2184,"41.177.98.176",80,10,1141,6,595,4,546,140.419847,26.317249000000004,180.86996858980206,165.974794705936
"18.22.130.128",2188,"41.177.98.176",80,29,21438,12,1659,17,19779,149.348874,24.003601000000003,552.9170394058791,6592.0109236943235
"18.41.246.77",4590,"244.3.61.124",445,2,132,2,132,0,0,51.945609,3.0461799999999997,346.6636902612453,0
"18.72.39.168",9074,"244.3.160.239",80,12,2530,7,1517,5,1013,193.839452,0.11264700000000971,107734.78210692653,71941.55192769716
"18.72.39.168",10864,"244.3.160.239",80,11,2392,6,1262,5,1130,194.015908,0.11776299999999651,85731.51159532536,76764.3487343246
"18.84.163.155",42332,"41.177.26.176",80,58,31830,23,4874,35,26956,0.023482,38.456823,1013.916308167214,5607.535495066766
"18.84.163.155",15749,"41.177.26.176",80,3,192,2,128,1,64,0.125563,7.457166000000001,137.31758150482366,68.65879075241183
"18.91.139.55",55441,"41.177.98.176",80,69,52735,27,6447,42,46288,179.546626,20.35562999999999,2533.746192085434,18191.72386214527
"18.91.139.55",55442,"41.177.98.176",80,28,18021,13,4166,15,13855,181.577639,18.325744999999984,1818.6436622358344,6048.321637128537
"18.91.139.55",55443,"41.177.98.176",80,26,13022,13,4035,13,8987,181.581628,18.321730000000002,1761.8423587728885,3924.0835881764438
"18.91.139.55",55444,"41.177.98.176",80,29,16290,13,3343,16,12947,181.583131,18.318386000000004,1459.9539500914543,5654.209928756823
"18.91.139.55",55446,"41.177.98.176",80,72,64851,26,2484,46,62367,181.597855,18.305138,1085.5968417173365,27256.609592345056
"18.91.139.55",55447,"41.177.98.176",80,37,26016,15,3432,22,22584,181.600654,18.301626,1500.1945728756561,9871.909741790156
"18.91.139.55",55448,"41.177.98.176",80,49,44716,16,3916,33,40800,199.903432,5.083460000000002,6162.731682751509,64208.23612264085
"18.91.139.55",55449,"41.177.98.176",80,33,25960,13,2772,20,23188,202.683875,5.124799999999993,4327.1932563222035,36197.31501717145
"18.91.139.55",55450,"41.177.98.176",80,12,5420,6,2225,6,3195,202.68413,5.1552879999999845,3452.765393514398,4958.015924619551
"18.91.139.55",55451,"41.177.98.176",80,21,15058,9,2545,12,12513,202.684635,10.388475000000028,1959.8641764070226,9636.063041014175
"18.91.139.55",55452,"41.177.98.176",80,16,9825,7,2324,9,7501,202.684929,5.424205999999998,3427.5984356051385,11063.001663284917
"18.180.188.214",3095,"41.177.26.91",80,134,119046,50,3895,84,115151,48.106318,5.057200999999999,6161.511080931924,182157.6797125525
"18.197.116.244",4277,"244.3.61.22",445,2,132,2,132,0,0,177.600143,3.001107999999988,351.87004266424407,0
"18.218.26.247",1136,"244.3.210.197",80,6,1145,4,808,2,337,126.631128,0.5776029999999963,11191.077608669002,4667.565784803779
"18.224.64.143",3945,"244.3.31.26",445,2,132,2,132,0,0,69.957955,2.9447739999999953,358.6013731444252,0
"30.176.25.202",50207,"41.177.26.91",8000,4,256,0,0,4,256,1.7924449999999998,173.40238200000002,0,11.8106797402587
"40.26.47.156",49273,"41.177.26.13",80,78,54782,28,6501,50,48281,36.577207,29.697159,1751.2786324105953,13006.227296018451
"40.26.47.156",49274,"41.177.26.13",80,78,57122,27,5163,51,51959,36.709303,29.564730000000004,1397.0700899348647,14059.725896363672
"40.26.47.156",49275,"41.177.26.13",80,61,41445,22,5438,39,36007,36.709901,29.563503999999995,1471.5441038383003,9743.635260556395
"40.26.47.156",49276,"41.177.26.13",80,28,8291,15,3658,13,4633,36.919862,29.354094999999994,996.9307519104236,1262.6517697104955
"40.26.47.156",49277,"41.177.26.13",80,29,8585,16,3737,13,4848,36.920249,29.353499,1018.4816467706286,1321.2734877024373
"40.26.47.156",49278,"41.177.26.13",80,50,28445,22,4159,28,24286,36.920962,4.565706999999996,7287.370827781991,42553.76002008017
"40.26.230.139",60152,"41.177.26.176",80,106,80203,47,4696,59,75507,102.074966,15.993938999999997,2348.889788813125,37767.806917357884
"40.26.230.139",63989,"41.177.26.176",80,26,10081,13,2123,13,7958,102.542662,15.386456999999993,1103.8278662852667,4137.664700846987
"40.117.122.151",14057,"41.177.26.176",80,97,61280,39,4472,58,56808,135.156887,19.57485699999998,1827.6506438846545,23216.721327772688
"40.117.122.151",14097,"41.177.26.176",80,52,27718,23,3435,29,24283,135.801859,18.929963999999984,1451.666786054111,10262.248781878305
"40.117.122.151",14098,"41.177.26.176",80,128,100112,45,5727,83,94385,135.806181,18.925637999999992,2420.8430912606495,39897.201880327644
"40.117.122.151",14231,"41.177.26.176",80,35,20235,15,1544,20,18691,137.901348,15.997156999999987,772.1371991285707,9347.160873647745
"40.118.197.55",29733,"244.3.61.39",445,2,132,2,132,0,0,131.38919,2.9503449999999987,357.92424275805047,0
"40.138.160.255",5310,"244.3.160.239",80,1139,1052679,391,28270,748,1024409,12.387615,10.081007,22434.26673545609,812941.80234177
"40.138.160.255",14159,"244.3.160.239",80,228,183423,99,7962,129,175461,52.08133,5.496449999999996,11588.570804792193,255380.83672188432
"40.138.160.255",12280,"244.3.160.239",80,535,486300,182,13591,353,472709,86.795089,7.110858999999991,15290.417093068523,531816.4795561275
"40.138.160.255",10184,"244.3.160.239",80,97,72781,31,3115,66,69666,109.206455,2.3407029999999907,10646.374187583859,238102.8263731034
"40.138.160.255",4535,"244.3.160.239",80,11,2061,6,1575,5,486,111.619307,4.1858450000000005,3010.1449050311226,928.8447135524606
"40.138.160.255",6208,"244.3.160.239",80,176,146795,72,6027,104,140768,126.556469,6.518651999999989,7396.6212646418435,172757.18967663895
"40.138.160.255",4031,"244.3.160.239",80,512,477260,176,13235,336,464025,178.618993,7.322867000000002,14458.817837330647,506932.59893973207
"40.193.220.98",7481,"244.3.160.239",80,2,132,1,66,1,66,213.068367,0.00014899999999329339,0,0
"41.48.186.199",1894,"41.177.26.176",80,55,33754,23,4440,32,29314,5.620014,28.385631,1251.3373403606915,8261.64477372372
"41.48.186.199",1895,"41.177.26.176",80,22,5837,12,4036,10,1801,6.060381,22.946344,1407.108687989686,627.8995904532766
"41.64.157.218",56283,"244.3.210.197",80,2,128,1,64,1,64,98.509253,15.776972,32.45236158117033,32.45236158117033
"41.106.176.15",40923,"41.177.241.46",443,417,65239,175,28501,242,36738,0.097729,211.46971200000002,1078.2064147323376,1389.8160508205542
"41.106.176.15",28445,"41.177.241.46",443,120,14809,58,7965,62,6844,0.534572,210.615922,302.5412295277467,259.96135277939715
"41.106.176.15",42496,"41.177.241.46",443,76,7618,38,4997,38,2621,2.319327,202.427109,197.48343093710832,103.58296427579766
"41.106.176.15",30525,"41.177.241.46",443,92,11000,46,6356,46,4644,2.987227,197.27421600000002,257.75289356618197,188.32668938347217
"41.106.176.15",44756,"41.177.241.46",443,1600,243116,600,89855,1000,153261,3.449929,206.690096,3477.863786951843,5932.011372233336
"41.106.176.15",56908,"41.177.241.46",443,90,10063,45,6183,45,3880,8.043607,197.255441,250.76114376992015,157.3594109376177
"41.106.176.15",40950,"41.177.241.46",443,4960,735309,1629,321664,3331,413645,8.659461,203.712445,12632.080479913733,16244.270201557887
"41.106.176.15",47278,"41.177.241.46",443,78,7935,37,5013,41,2922,9.752181,190.712121,210.28553292635237,122.57217777993252
"41.106.176.15",29201,"41.177.241.46",443,4766,730687,1556,309757,3210,420930,11.806351,188.406971,13152.676818948488,17873.224022055958
"41.106.176.15",33082,"41.177.241.46",443,74,7463,37,4906,37,2557,12.172501,194.342702,201.95252816851337,105.25736129777593
"41.106.176.15",53786,"41.177.241.46",443,28,5732,12,3640,16,2092,30.097266,180.20159800000002,161.59679116719042,92.87376019828636
"41.106.180.77",25958,"41.177.241.46",443,44,3602,22,2005,22,1597,2.327272,193.23908,83.00598408976073,66.11499081862738
"41.106.180.77",49572,"41.177.241.46",443,42,3255,21,1722,21,1533,6.973925,192.875079,71.42446847682173,63.585197546438856
"41.106.180.77",47084,"41.177.241.46",443,42,3255,21,1722,21,1533,11.335481,191.32144100000002,72.00447544193439,64.10154521050256
"41.106.180.77",1269,"41.177.241.46",443,42,3255,21,1722,21,1533,13.485122,192.246286,71.65808134259613,63.793169975725824
"41.106.180.77",60133,"41.177.241.46",443,21,4293,9,2724,12,1569,40.222045,120.188762,181.31478881528042,104.4357208704754
"41.106.180.204",58774,"41.177.241.46",443,74,7463,37,4906,37,2557,4.351457,197.345201,198.87993121251526,103.65592827362445
"41.113.177.123",56482,"41.177.26.176",80,18,8388,9,1467,9,6921,196.6992,16.037615000000017,731.7796318218132,3452.3836617851184
"41.122.143.43",56619,"41.177.26.176",80,26,13355,12,1461,14,11894,181.037805,1.2227819999999952,9558.53128358125,77815.99663717684
"41.122.143.43",56620,"41.177.26.176",80,69,56781,26,2415,43,54366,181.758096,2.6099200000000167,7402.525747915598,166644.18832761052
"41.122.143.43",56621,"41.177.26.176",80,15,4045,8,1159,7,2886,181.759247,1.9330880000000263,4796.470724560844,11943.58456521363
"41.122.143.43",56622,"41.177.26.176",80,22,6038,12,2617,10,3421,181.760062,2.7889959999999974,7506.643967936856,9812.850215633161
"41.122.143.43",56623,"41.177.26.176",80,18,4401,10,1888,8,2513,181.760653,2.7889179999999953,5415.720361803404,7208.530333269044
"41.122.143.43",56624,"41.177.26.176",80,14,2982,8,1157,6,1825,184.212653,0.5100230000000181,18148.201159554905,28626.159996705013
"41.177.2.124",1274,"41.177.98.176",80,51,34357,22,11965,29,22392,125.88739699999999,20.167350999999996,4746.285221098201,8882.475442610188
"41.177.2.124",1275,"41.177.98.176",80,37,18256,19,14283,18,3973,128.378116,17.67667499999999,6464.1116046994175,1798.075712768381
"41.177.2.124",1283,"41.177.98.176",80,61,46733,23,5861,38,40872,151.335748,34.79369700000001,1347.6004001529354,9397.564162267663
"41.177.3.18",5730,"244.3.153.57",2091,4,256,4,256,0,0,11.0644,180.04174899999998,11.375139440574976,0
"41.177.3.18",5730,"244.3.153.30",1297,52,7793,25,4724,27,3069,14.786396,60.31579500000001,626.5688780194308,407.05755432718735
"41.177.3.203",58381,"41.177.3.224",1791,186,73906,112,36270,74,37636,3.056985,205.217985,1413.911163780309,1467.161857183229
"41.177.3.203",58386,"41.177.3.224",1791,147,52866,93,25350,54,27516,3.381102,205.103855,988.7673734850083,1073.2514023200588
"41.177.3.203",36735,"41.177.3.224",1791,360,228451,187,133221,173,95230,7.173604,195.451429,5452.853455474096,3897.848196341404
"41.177.3.203",58669,"41.177.3.184",657,21,3092,11,1638,10,1454,14.063454,0.006458000000000297,2029111.1799317743,1801176.834933333
"41.177.3.203",58675,"244.3.31.68",4888,20,2716,10,1534,10,1182,59.43984,0.15819600000000378,77574.65422640083,59773.95130091642
"41.177.3.203",58677,"244.3.31.68",4888,94,81827,64,79310,30,2517,96.656491,0.1698899999999952,3734651.8335394543,118523.75066219653
"41.177.3.203",58679,"244.3.31.68",4888,22,2844,11,1598,11,1246,119.649272,0.23336600000000374,54780.90210227623,42714.02003719411
"41.177.3.203",58684,"41.177.230.224",25,40,18919,21,17286,19,1633,176.387956,0.4278799999999876,323193.41871553706,30531.924838740717
"41.177.3.203",32954,"41.177.230.68",2049,7,1280,4,646,3,634,176.456334,0.03903700000000754,132387.2223787433,129928.01700947872
"41.177.3.203",58686,"244.3.31.68",4888,28,4416,13,1787,15,2629,179.908683,0.2198150000000112,65036.50797261002,95680.45856742683
"41.177.3.215",64703,"41.177.3.203",30383,14,2434,8,1377,6,1057,33.81087,0.8603609999999975,12803.927653624505,9828.432483573784
"41.177.3.215",64808,"41.177.3.224",30383,14,2442,8,1385,6,1057,84.734048,0.9610409999999945,11529.164728664087,8798.792143103206
"41.177.3.215",64835,"41.177.180.176",383,5,995,0,0,5,995,85.431508,0.3638480000000044,0,21877.26743035527
"41.177.3.215",64922,"244.3.210.95",383,13,2367,8,1372,5,995,91.2013,0.2871509999999944,38223.791663620235,27720.60692806278
"41.177.3.215",65018,"41.177.3.203",30383,14,2434,8,1377,6,1057,154.328664,0.8423310000000015,13077.994280158251,10038.808971769988
"41.177.3.215",65167,"41.177.3.224",30383,14,2442,8,1385,6,1057,202.926547,0.6820920000000115,16244.143018830031,12397.154636031295
"41.177.3.215",65237,"244.3.210.95",383,13,2367,8,1372,5,995,211.200788,0.18245200000001205,60158.28820730535,43627.91309494812
"41.177.3.224",51236,"41.177.117.184",1613,185,72622,114,35681,71,36941,0.032992,210.291507,1357.3919559195513,1405.3254181111556
"41.177.3.224",51186,"41.177.117.184",1606,191,75356,117,36822,74,38534,0.03707,210.077416,1402.2259298924355,1467.4209435249336
"41.177.3.224",51309,"41.177.117.184",1605,379,131104,197,59032,182,72072,0.037079,210.28742499999998,2245.7643389755713,2741.8472597683863
"41.177.3.224",65162,"41.177.117.184",1606,308,90135,162,46195,146,43940,0.1981,198.36653299999998,1863.015874759479,1772.0731147728434
"41.177.3.224",65138,"41.177.117.184",1606,65,25349,35,12340,30,13009,0.230101,182.384737,541.2733632420129,570.6179240206926
"41.177.3.224",51146,"41.177.117.184",1606,193,76174,118,37197,75,38977,0.350048,210.184455,1415.7850065553134,1483.5350216551456
"41.177.3.224",38629,"41.177.117.184",1606,4314,2131461,2250,1571231,2064,560230,0.368873,164.846192,76251.976751759,27188.01050618142
"41.177.3.224",47468,"41.177.117.184",1610,195,76334,118,37217,77,39117,0.388457,210.14604200000002,1416.8051758976262,1489.1358267884957
"41.177.3.224",50382,"41.177.117.184",1607,145,51802,94,24989,51,26813,0.523004,210.221485,950.9589374273519,1020.3714430045054
"41.177.3.224",51211,"41.177.117.184",1607,193,76210,118,37217,75,38993,0.556753,210.18776300000002,1416.5239486372952,1484.1206526376131
"41.177.3.224",50371,"41.177.117.184",1605,145,51845,94,24989,51,26856,1.020665,210.143812,951.3104292597491,1022.3855651766705
"41.177.3.224",50391,"41.177.117.184",1610,179,66718,112,32668,67,34050,1.086993,210.28748299999998,1242.7938946798847,1295.3695394223728
"41.177.3.224",49020,"41.177.117.184",1606,145,51802,94,24989,51,26813,1.332135,210.252337,950.8193956483822,1020.2217157757442
"41.177.3.224",51313,"41.177.117.184",1605,195,54180,105,28680,90,25500,1.505712,210.288765,1091.0711278370006,970.094622030806
"41.177.3.224",50327,"41.177.117.184",1618,145,51845,94,24989,51,26856,1.545093,210.249379,950.8327727331837,1021.8722215583809
"41.177.3.224",40118,"41.177.117.184",1613,357,221238,184,127966,173,93272,2.95682,195.397816,5239.19878408467,3818.753020248701
"41.177.3.224",50412,"41.177.117.184",1613,144,51052,92,24558,52,26494,3.080184,205.14433,957.6867174442501,1033.184782635718
"41.177.3.224",48741,"41.177.117.184",1607,174,65715,108,32109,66,33606,4.145435,205.12906700000002,1252.2457385329988,1310.628493230557
"41.177.3.224",50396,"41.177.117.184",1610,142,50924,92,24558,50,26366,4.439426,205.255079,957.1699806756061,1027.6383952477006
"41.177.3.224",51255,"41.177.117.184",1605,174,65748,108,32109,66,33639,4.5104109999999995,205.184099,1251.9098763106394,1311.5636217015042
"41.177.3.224",51281,"41.177.117.184",1605,174,65745,108,32103,66,33642,4.513066,205.181448,1251.6921120470893,1311.6975370989683
"41.177.3.224",51349,"41.177.117.184",1618,174,65754,108,32109,66,33645,4.56482,205.12971100000001,1252.2418071363636,1312.1453673768399
"41.177.3.224",51334,"41.177.117.184",1618,174,65757,108,32115,66,33642,4.573253,205.121265,1252.527376915309,1312.0823918475737
"41.177.3.224",9305,"41.177.143.72",2402,997,942549,588,774786,409,167763,4.765271,170.370927,36381.13678867287,7877.541219224569
"41.177.3.224",51263,"41.177.117.184",1605,257,145554,108,37533,149,108021,4.7674009999999996,152.257737,1972.0771234108124,5675.691869766855
"41.177.3.224",40016,"41.177.117.184",1607,361,221494,185,128030,176,93464,6.123615,195.339441,5243.385538305089,3827.7574470994828
"41.177.3.224",38680,"41.177.117.184",1607,183,50506,98,26824,85,23682,8.017941,195.166663,1099.5320445684927,970.7395570933136
"41.177.3.224",40080,"41.177.117.184",1610,361,221494,189,128286,172,93208,8.264392,195.34387700000002,5253.750543714252,3817.1864480809904
"41.177.3.224",58575,"41.177.117.184",1605,365,219085,187,125490,178,93595,8.784635,195.465591,5136.0446350887405,3830.6486383068827
"41.177.3.224",52629,"41.177.117.184",1618,360,218765,186,125426,174,93339,9.151572,195.503006,5132.442822899613,3819.439993674573
"41.177.3.224",51305,"41.177.117.184",1605,182,50596,98,26768,84,23828,9.152055,195.292507,1096.529525323775,976.094797123988
"41.177.3.224",51374,"41.177.117.184",1618,182,50470,98,26796,84,23674,9.99973,195.284833,1097.719657521995,969.8244205170813
"41.177.3.224",40064,"41.177.117.184",1610,182,50414,98,26796,84,23618,10.019271,195.2653,1097.8294658600375,967.6271206404825
"41.177.3.224",65164,"41.177.117.184",1606,182,50498,98,26712,84,23786,10.077493,195.207102,1094.7142691560475,974.8005992118053
"41.177.3.224",65167,"41.177.117.184",1606,182,50554,98,26768,84,23786,10.077497,195.207094,1097.009312581642,974.8006391611976
"41.177.3.224",65161,"41.177.117.184",1606,182,50484,98,26768,84,23716,10.08024,195.204363,1097.0246602531113,971.9454887388966
"41.177.3.224",65168,"41.177.117.184",1606,210,68180,112,34972,98,33208,10.080857,195.20372999999998,1433.25130108938,1360.9576005540468
"41.177.3.224",65163,"41.177.117.184",1606,182,50582,98,26768,84,23814,10.097438,195.18716099999997,1097.1213419103935,976.0478047016628
"41.177.3.224",38682,"41.177.117.184",1607,210,68348,112,35084,98,33264,10.109285,195.175282,1438.0509515544084,1363.4513411385772
"41.177.3.224",40058,"41.177.117.184",1610,210,68320,112,35056,98,33264,10.11508,195.16949499999998,1436.9458710747806,1363.4917690390091
"41.177.3.224",39054,"41.177.117.184",1606,539,283319,274,164931,265,118388,11.351911,196.662618,6709.195745578857,4815.88219272053
"41.177.3.224",39050,"41.177.117.184",1606,92,37686,47,23537,45,14149,11.388623,0.19831799999999866,949465.0006555193,570760.0923768935
"41.177.3.224",52650,"244.3.41.117",8412,18,5410,9,2875,9,2535,11.411708,0.06563299999999828,350433.4709673579,308990.9039660008
"41.177.3.224",9406,"244.3.41.117",1618,14,9941,6,3423,8,6518,11.420473,166.758397,164.2136197795185,312.6919000066905
"41.177.3.224",49373,"41.177.117.184",1606,413,192870,208,98969,205,93901,11.421855,166.793061,4746.912103255902,4503.8324466028
"41.177.3.224",9403,"244.3.41.117",2760,6,2530,2,404,4,2126,11.456554,166.89684499999998,19.3652552269637,101.90725894189313
"41.177.3.224",50020,"41.177.117.184",1606,352,160315,177,75768,175,84547,11.458022,196.976495,3077.2402565087777,3433.790412404282
"41.177.3.224",9309,"41.177.143.72",2687,700,671036,425,562838,275,108198,11.60725,145.497655,30946.918010465528,5949.126808950976
"41.177.3.224",51262,"41.177.117.184",1605,1976,995317,921,349779,1055,645538,11.609539999999999,145.20560999999998,19270.82569330483,35565.457835961024
"41.177.3.224",65238,"41.177.117.184",1613,295,110776,155,57772,140,53004,11.874859,195.299671,2366.4965620961034,2171.186453253165
"41.177.3.224",51261,"41.177.117.184",1605,97,38053,51,16912,46,21141,11.941571,163.133367,829.3582268794833,1036.7468232296094
"41.177.3.224",51372,"41.177.117.184",1618,182,50624,98,26796,84,23828,12.251877,195.132641,1098.5758143866867,976.8944807137623
"41.177.3.224",51312,"41.177.117.184",1605,183,50688,98,26824,85,23864,12.270755,195.32377599999998,1098.6476116455992,977.4130108973524
"41.177.3.224",51306,"41.177.117.184",1605,182,51772,98,26824,84,24948,12.272705,195.321835,1098.6585293958558,1021.8212418493816
"41.177.3.224",51307,"41.177.117.184",1605,182,50652,98,26824,84,23828,12.300989,195.29354700000002,1098.8176685633139,976.0895991100002
"41.177.3.224",38681,"41.177.117.184",1607,183,50506,98,26824,85,23682,13.269858,195.164664,1099.5433066715398,970.7495000221967
"41.177.3.224",40052,"41.177.117.184",1610,182,50610,98,26796,84,23814,14.325953,195.158541,1098.430019519361,976.1909421120339
"41.177.3.224",51373,"41.177.117.184",1618,211,68216,112,35056,99,33160,14.37897,195.315552,1435.8713227301018,1358.2123762474378
"41.177.3.224",9508,"41.177.143.72",1400,497,461372,284,366871,213,94501,15.846653,184.314175,15923.723717939762,4101.735528480107
"41.177.3.224",43836,"41.177.117.184",1607,297,141944,152,72241,145,69703,15.852153,196.37744800000002,2942.9448538306697,2839.5521261687845
"41.177.3.224",65152,"41.177.117.184",1606,32,12622,17,6138,15,6484,16.289263,0.12762900000000243,384740.1452647836,406428.00617413764
"41.177.3.224",9407,"244.3.41.117",3760,11,3543,5,2107,6,1436,78.446479,0.044375000000002274,379853.5211267411,258884.50704224026
"41.177.3.224",9401,"244.3.41.117",3835,9,822,4,378,5,444,87.99558,0.00504399999999805,599524.1871532849,704203.0134816362
"41.177.3.224",9401,"244.3.41.117",3836,9,1006,4,470,5,536,88.000838,0.001705999999998653,0,0
"41.177.3.224",9405,"244.3.41.117",3837,80,50293,41,36431,39,13862,88.002733,120.37796599999999,2421.1075305924346,921.2317144484732
"41.177.3.224",9410,"244.3.41.117",3775,10,3327,5,1955,5,1372,98.118767,0.040439999999989595,386745.7962414447,271414.44114744867
"41.177.3.224",51283,"41.177.117.184",1605,2,128,1,64,1,64,112.803784,0.00010400000000743148,0,0
"41.177.3.224",51299,"41.177.117.184",1605,2,128,1,64,1,64,113.303783,0.00017400000000122873,0,0
"41.177.3.224",65156,"41.177.117.184",1606,2,128,1,64,1,64,117.833281,0.00016600000000721593,0,0
"41.177.3.224",65153,"41.177.117.184",1606,2,128,1,64,1,64,118.853317,0.00014499999998918156,0,0
"41.177.3.224",9510,"41.177.143.72",1275,634,601361,370,476996,264,124365,150.895556,61.41077899999999,62138.40733073913,16201.064637203188
"41.177.3.224",43840,"41.177.117.184",1607,405,216439,189,80826,216,135613,150.899215,49.184731,13146.518987772852,22057.739829867118
"41.177.3.224",9408,"41.177.143.72",2673,57,51387,25,19456,32,31931,161.15108,0.5319559999999797,292595.62820986315,480205.12974759145
"41.177.3.224",9504,"41.177.143.72",1744,199,188406,115,148385,84,40021,163.447586,31.803091999999992,37325.93044726596,10067.197239815552
"41.177.3.224",43838,"41.177.117.184",1607,141,62813,71,31489,70,31324,163.449125,31.76558799999998,7930.342734408069,7888.788332833637
"41.177.3.224",52654,"41.177.230.224",25,93,71995,56,69206,37,2789,176.928269,0.5924829999999872,934453.815552534,37658.464462272306
"41.177.3.224",39052,"41.177.117.184",1606,90,36843,47,22750,43,14093,177.90604,0.5188670000000002,350764.26136177464,217288.82353281276
"41.177.3.224",52655,"244.3.41.117",8412,22,6790,11,2799,11,3991,177.933717,0.2657039999999995,84274.22997019255,120163.79128654466
"41.177.3.224",9506,"41.177.143.106",2879,241,240388,147,190017,94,50371,193.626798,0.40136799999999084,3787387.135994984,1003986.3666261615
"41.177.4.139",57154,"244.3.41.84",1522,48,15112,24,7185,24,7927,1.952313,0.8862759999999998,64855.64316307788,71553.33101652308
"41.177.4.139",54447,"244.3.41.84",1522,129,24631,71,15991,58,8640,5.777685,169.81169300000002,753.352126346211,407.03910772504923
"41.177.4.139",57164,"244.3.41.84",9992,9,1691,5,925,4,766,21.727046,0.16683499999999896,44355.20124674107,36730.90178919314
"41.177.4.139",57166,"244.3.41.84",9992,9,1691,5,925,4,766,27.326474,0.04804099999999778,154035.0950230083,127557.71112175606
"41.177.4.139",57167,"244.3.41.84",1522,48,15112,23,7121,25,7991,31.060852,1.1917930000000005,47800.24719057754,53640.187515785015
"41.177.4.139",57172,"244.3.41.84",1522,47,15048,23,7121,24,7927,61.16035,1.2436489999999978,45807.136901167534,50991.87954157493
"41.177.4.139",57177,"244.3.41.84",9992,9,1691,5,925,4,766,74.347475,0.07287099999999214,101549.31316985904,84093.80960876976
"41.177.4.139",57182,"244.3.41.84",1522,49,15178,23,7123,26,8055,91.257658,1.7964609999999936,31720.143103579874,35870.525438626406
"41.177.4.139",57190,"244.3.41.84",9992,9,1691,5,925,4,766,111.10447,0.07067499999999427,104704.63388752175,86706.75627874775
"41.177.4.139",57192,"244.3.41.84",9992,9,1691,5,925,4,766,113.863161,0.032655999999988694,226604.60558557577,187653.11122005517
"41.177.4.139",57199,"244.3.41.84",1522,49,15176,24,7185,25,7991,121.36339,1.2594260000000048,45639.83910130471,50759.63176875796
"41.177.4.139",57203,"244.3.41.84",9992,9,1691,5,925,4,766,150.822223,0.11375300000000266,65053.229365377854,53871.10669608588
"41.177.4.139",57204,"244.3.41.84",1522,47,15048,23,7121,24,7927,151.458766,0.8531169999999975,66776.30383640247,74334.46994960854
"41.177.4.139",57205,"244.3.41.84",9992,9,1691,5,925,4,766,159.865526,0.06804000000002475,108759.55320395809,90064.66784241286
"41.177.4.139",57209,"244.3.41.84",1522,47,15050,23,7123,24,7927,181.557486,0.6879219999999862,82834.97256956623,92184.8697962869
"41.177.4.139",57210,"244.3.41.84",9992,9,1691,5,925,4,766,184.630528,0.04762500000001069,155380.57742778666,128671.91601046981
"41.177.4.139",57222,"244.3.41.84",1522,47,15048,23,7121,24,7927,211.659231,0.7969630000000052,71481.36111714048,79572.07549158442
"41.177.13.249",1052,"244.3.41.84",23,84,39775,49,3540,35,36235,0.431545,206.604922,137.073210675978,1403.0643471310912
"41.177.24.108",5222,"244.3.153.235",1659,12,1736,6,1080,6,656,27.828795,165.120181,52.32552403754935,31.78291089688183
"41.177.24.241",5222,"244.3.153.48",1175,14,1980,7,1260,7,720,4.611329,165.06553799999998,61.066653416172194,34.89523052352697
"41.177.24.241",5222,"244.3.153.106",2239,10,1220,5,628,5,592,5.85583,165.063173,30.436831600226174,28.692045075372445
"41.177.24.241",5222,"244.3.153.33",1707,8,784,4,256,4,528,8.216103,165.054794,12.408000703087728,25.59150145011844
"41.177.24.241",5222,"244.3.153.156",1191,10,1220,5,628,5,592,15.072595,165.087305,30.43238242940607,28.687850952561135
"41.177.24.241",5222,"244.3.153.0",3066,8,1024,4,564,4,460,19.673216,145.195005,31.075449186423455,25.345224513749628
"41.177.24.241",5222,"244.3.153.30",1160,15,2416,8,1696,7,720,19.692238,165.17839899999998,82.14149115224201,34.87138775331029
"41.177.24.241",5222,"244.3.153.209",3930,10,1284,5,692,5,592,26.382562,165.066272,33.538044646698026,28.691506402955536
"41.177.24.241",5222,"244.3.153.111",2490,12,1736,6,1080,6,656,35.201324,177.689441,48.62416107212584,29.534675614180138
"41.177.24.241",5222,"244.3.153.247",4202,18,4500,14,4176,4,324,35.204394,153.957362,216.99514440887862,16.835830169654376
"41.177.24.241",5222,"244.3.153.13",1201,10,1220,5,628,5,592,35.571663,165.08068,30.433603738487143,28.689002250293616
"41.177.24.241",5222,"244.3.153.56",3885,8,784,4,256,4,528,44.882556,165.100684,12.40455187938531,25.5843882512322
"41.177.24.241",5222,"244.3.153.67",1280,10,1220,5,628,5,592,44.939643,165.060878,30.4372547927438,28.692444008446387
"41.177.24.247",5222,"244.3.153.40",1361,8,784,4,256,4,528,25.427337,165.07370500000002,12.406579230774518,25.588569663472445
"41.177.24.247",5222,"244.3.153.55",1560,6,588,3,192,3,396,53.977012,110.10112699999999,13.95081087589594,28.773547431535377
"41.177.26.22",1024,"118.210.77.83",80,4,260,2,128,2,132,142.994398,2.921024000000017,350.5619946977478,361.51705703205243
"41.177.26.68",46623,"188.235.231.3",80,1,64,0,0,1,64,95.52413,0,0,0
"41.177.26.84",48160,"208.138.142.127",1723,2,130,1,64,1,66,184.361636,0.0002110000000072887,0,0
"41.177.26.91",8000,"118.41.124.164",1884,4,6072,4,6072,0,0,2.962555,180.10049899999999,269.716076688938,0
"41.177.26.91",8000,"118.41.124.164",1988,4,6072,4,6072,0,0,23.852888,180.032391,269.81811289725084,0
"41.177.26.91",8000,"90.48.123.141",1395,3,210,3,210,0,0,54.503168,120.021622,13.997477887775922,0
"41.177.26.91",8000,"67.72.176.186",1259,2,128,2,128,0,0,144.034509,5.429911999999973,188.58500837582727,0
"41.177.26.91",8000,"67.72.176.186",1260,2,128,2,128,0,0,144.17446,3.3699729999999875,303.86000125223666,0
"41.177.26.176",47823,"41.177.24.224",25,25,3490,12,2047,13,1443,169.012568,0.4572960000000137,35810.50348133268,25244.043245512
"41.177.26.176",47982,"82.242.98.77",80,10,1927,6,1229,4,698,194.195821,0.16147900000001414,60887.17418363465,34580.347909013006
"41.177.26.214",38979,"15.251.180.105",80,13,1403,7,592,6,811,13.16819,0.181496000000001,26094.238991492784,35747.34429408893
"41.177.26.214",38980,"244.3.160.186",80,15,2715,8,640,7,2075,13.307642,0.007258000000000209,705428.4926976926,2287131.4411683003
"41.177.26.214",38999,"41.177.230.75",80,13,1593,7,545,6,1048,42.830175,0.10869900000000143,40110.76458845015,77130.42438292799
"41.177.26.214",39000,"15.251.180.105",80,13,1403,7,592,6,811,43.428554,0.1825109999999981,25949.120874906443,35548.54227964379
"41.177.26.214",39001,"244.3.160.186",80,15,2715,8,640,7,2075,43.568327,0.0062450000000069394,819855.8847068552,2658126.5011980073
"41.177.26.214",39002,"15.251.180.105",80,13,1403,7,592,6,811,46.378696,0.18358500000000078,25797.314595418906,35340.577933926914
"41.177.26.214",39003,"244.3.160.186",80,15,2715,8,640,7,2075,46.519192,0.00563900000000217,907962.4046813317,2943784.358927755
"41.177.26.214",39004,"15.251.180.105",80,13,1403,7,592,6,811,47.408052,0.1846960000000024,25642.136267163005,35127.994109238505
"41.177.26.214",39005,"244.3.160.186",80,15,2715,8,640,7,2075,47.549691,0.006422000000000594,797259.4207411284,2584864.528184127
"41.177.26.214",39015,"15.251.180.105",80,13,1403,7,592,6,811,83.909179,0.1830410000000029,25873.984517129633,35445.610546270495
"41.177.26.214",39016,"244.3.160.186",80,15,2715,8,640,7,2075,84.049921,0.006524999999996339,784674.3295023559,2544061.3026834195
"41.177.26.214",39022,"41.177.230.75",80,13,1593,7,545,6,1048,93.070433,0.15638900000000433,27879.198664866963,53609.90862528546
"41.177.26.214",39023,"15.251.180.105",80,13,1403,7,592,6,811,100.38872,0.1828039999999902,25907.529375726208,35491.5647360033
"41.177.26.214",39024,"244.3.160.186",80,15,2715,8,640,7,2075,100.528561,0.006419000000008168,797632.0299101862,2586072.5969744315
"41.177.26.214",39044,"15.251.180.105",80,13,1403,7,592,6,811,131.449159,0.1796760000000006,26358.556512834122,36109.441439034585
"41.177.26.214",39045,"244.3.160.186",80,15,2715,8,640,7,2075,131.586081,0.01414599999998245,361939.7709604377,1173476.6011607943
"41.177.26.214",39049,"15.251.180.105",80,13,1403,7,592,6,811,168.730801,0.18255599999997685,25942.724424289536,35539.779574491244
"41.177.26.214",39050,"244.3.160.186",80,15,2715,8,640,7,2075,168.870824,0.006150999999988471,832384.9780539094,2698748.171034159
"41.177.26.214",39052,"15.251.180.105",80,13,1403,7,592,6,811,188.630506,0.1823750000000075,25968.47155585911,35575.0514050705
"41.177.26.214",39053,"244.3.160.186",80,15,2715,8,640,7,2075,188.770179,0.005908999999974185,866474.8688479215,2809273.9888428706
"41.177.26.214",39066,"15.251.180.105",80,13,1403,7,592,6,811,206.430717,0.18307000000001494,25869.885836016896,35439.99563008396
"41.177.26.214",39067,"244.3.160.186",80,15,2715,8,640,7,2075,206.571014,0.005986000000007152,855329.1012351959,2773137.3204109864
"41.177.31.94",49240,"244.3.47.39",3260,213,21726,142,13348,71,8378,0.117651,210.23439000000002,507.92831753168446,318.8060716422275
"41.177.31.94",57614,"244.3.177.203",389,8,567,5,357,3,210,11.3143,0.0010270000000005552,0,0
"41.177.34.157",35685,"244.3.210.197",80,360,345311,124,36803,236,308508,50.19669,21.53304500000001,13673.124260874385,114617.5099713022
"41.177.34.157",35710,"244.3.210.197",80,465,438278,168,35056,297,403222,50.673409,21.056339,13318.934502336802,153197.38155811414
"41.177.34.157",41811,"244.3.210.197",80,116,61627,68,24847,48,36780,209.09172,3.3737959999999987,58917.610904749454,87213.33477187125
"41.177.34.157",41825,"244.3.210.197",80,135,83566,74,23664,61,59902,209.555504,2.898543999999987,65312.791525676636,165329.90356537703
"41.177.34.163",46787,"244.3.210.197",80,187,119036,102,35339,85,83697,194.633571,4.9495930000000214,57118.231741478296,135279.0017280203
"41.177.34.163",46810,"244.3.210.197",80,205,153782,99,33919,106,119863,195.029766,4.649267000000009,58364.46906576875,206248.42582712462
"41.177.37.95",1202,"244.3.41.84",23,80,25297,52,3483,28,21814,44.525329,68.576101,406.3223133668682,2544.793265513885
"41.177.37.144",4164,"244.3.41.84",23,137,37728,85,5718,52,32010,45.435644,165.79138600000002,275.9130079291333,1544.59170755711
"41.177.37.176",1169,"244.3.41.84",23,21,4986,10,688,11,4298,38.539198,38.737988,142.08275349767777,887.6041781003184
"41.177.40.117",11336,"244.3.160.239",80,28,22789,9,576,19,22213,0.335119,1.6416350000000002,2806.957697661173,108248.1794065063
"41.177.40.117",8406,"244.3.160.239",80,15,6293,8,5465,7,828,2.009541,0.7704049999999998,56749.37208351453,8598.075038453802
"41.177.40.117",5154,"244.3.160.239",80,7,1923,4,1360,3,563,67.382598,0.4875430000000023,22315.980334042226,9238.159505930716
"41.177.40.117",10900,"244.3.160.239",80,14,6196,6,1595,8,4601,67.899648,0.8003769999999975,15942.487102952784,45988.328000429945
"41.177.40.117",14734,"244.3.160.239",80,1919,1846971,580,38745,1339,1808226,68.701943,143.80486199999999,2155.4208646992756,100593.31651804653
"41.177.40.117",15235,"244.3.160.239",80,14,2648,7,2011,7,637,87.334731,0.17322699999999713,92872.35823514964,29418.046840273655
"41.177.43.106",2456,"244.3.41.84",23,4,256,2,128,2,128,139.523678,0.13834500000001526,7401.7853915926635,7401.7853915926635
"41.177.43.120",1093,"244.3.41.84",23,4,256,2,128,2,128,18.470544,0.17704300000000117,5783.90560485302,5783.90560485302
"41.177.43.141",49245,"244.3.41.84",23,5,359,3,213,2,146,18.484852,0.013946999999998155,122176.81221769738,83745.60837457191
"41.177.43.142",1036,"244.3.41.84",23,2,128,2,128,0,0,18.470532,0.19536599999999993,5241.44426358732,0
"41.177.43.176",1261,"244.3.41.84",23,4,256,2,128,2,128,18.493421,0.13901599999999803,7366.058583184774,7366.058583184774
"41.177.46.41",3237,"244.3.4.41",443,1,66,1,66,0,0,148.362374,0,0,0
"41.177.46.84",1459,"244.3.31.85",80,1,66,1,66,0,0,9.145665,0,0,0
"41.177.46.167",3072,"118.210.77.83",80,2,132,0,0,2,132,16.339835,3.3464859999999987,0,315.5548835405259
"41.177.46.188",46292,"188.235.231.3",80,1,64,0,0,1,64,63.780567,0,0,0
"41.177.46.210",1333,"244.3.41.84",23,4,256,2,128,2,128,18.483922,0.16523300000000063,6197.309254204645,6197.309254204645
"41.177.56.186",1603,"244.3.41.84",23,4,838,2,201,2,637,64.496232,0.20416399999999157,7876.021237828738,24960.326012422418
"41.177.56.188",1055,"244.3.41.84",23,4,256,2,128,2,128,139.534731,0.1363060000000189,7512.508620309142,7512.508620309142
"41.177.64.204",50681,"244.3.41.84",23,130,64972,66,4780,64,60192,1.324997,211.170334,181.086042133172,2280.320302945583
"41.177.67.98",1367,"244.3.41.84",23,4,256,2,128,2,128,139.521991,0.1967909999999904,5203.48999700215,5203.48999700215
"41.177.71.0",1864,"253.37.253.43",623,16,3582,0,0,16,3582,63.415039,90.833415,0,315.4786154412448
"41.177.71.18",1181,"244.3.41.84",23,4,256,2,128,2,128,139.538381,0.13149100000001113,7787.605235338642,7787.605235338642
"41.177.83.247",13425,"244.3.160.239",80,22,11290,9,1926,13,9364,151.83911,0.047329999999988104,325544.05239813804,1582759.349250345
"41.177.83.247",15229,"244.3.160.239",80,10,2777,5,1594,5,1183,151.92943,0.013408999999995785,951003.0576481473,705794.6155569375
"41.177.83.247",9008,"244.3.160.239",80,16,9113,7,1734,9,7379,151.980729,0.08539100000001554,162452.71749947272,691314.0729115393
"41.177.83.247",16012,"244.3.160.239",80,166,153034,57,5019,109,148015,151.987941,0.3788979999999924,105970.47226430544,3125168.251086107
"41.177.84.66",59482,"244.3.31.168",443,19,8716,10,1928,9,6788,68.293992,0.04433500000000379,347896.69561291713,1224856.208413113
"41.177.84.66",59483,"244.3.31.168",443,17,3022,10,2040,7,982,68.341914,0.01074799999999243,1518422.032007024,730926.6840347537
"41.177.84.66",59484,"244.3.31.168",443,17,3022,10,2040,7,982,68.342087,0.011055999999996402,1476121.5629527236,710564.39942136
"41.177.84.66",59495,"244.3.31.168",443,18,9014,9,1858,9,7156,188.3791,0.016773000000000593,886186.1324747794,3413104.393966373
"41.177.84.66",59496,"244.3.31.168",443,17,3022,10,2040,7,982,188.399331,0.06179199999999696,264111.8591403548,127136.1988607002
"41.177.84.66",59497,"244.3.31.168",443,17,3022,10,2040,7,982,188.399504,0.06380999999998949,255759.28537850946,123115.49913808642
"41.177.89.188",4014,"244.3.41.84",23,4,256,2,128,2,128,18.483166,0.18503000000000114,5534.237691185179,5534.237691185179
"41.177.93.12",1139,"244.3.41.84",23,4,256,2,128,2,128,139.521242,0.19772199999999884,5178.988681077502,5178.988681077502
"41.177.93.17",1149,"244.3.41.84",23,2,148,2,148,0,0,197.791185,1.421342999999979,833.0149724591583,0
"41.177.93.26",1151,"244.3.41.84",23,55,13317,30,2713,25,10604,0.148358,50.879321,426.5780197813568,1667.3178480506845
"41.177.93.64",1156,"244.3.41.84",23,3,431,2,132,1,299,182.514865,0.30466700000002334,3466.079358775053,7851.194911164704
"41.177.93.67",1142,"244.3.41.84",23,53,20370,24,1761,29,18609,18.491924,126.07425300000001,111.74367219927132,1180.8279363749234
"41.177.93.84",1213,"244.3.41.84",23,15,7647,6,447,9,7200,1.861266,101.497362,35.23244278999094,567.5024342011964
"41.177.93.90",1156,"244.3.41.84",23,5,2103,2,146,3,1957,182.421673,0.9181199999999876,1272.1648586241622,17052.237180325243
"41.177.93.113",1151,"244.3.41.84",23,4,256,2,128,2,128,18.481417,0.16170199999999824,6332.636578397368,6332.636578397368
"41.177.93.176",1340,"244.3.41.84",23,126,47864,69,5641,57,42223,11.553115,200.80841900000001,224.73161346885558,1682.1207082956018
"41.177.93.197",1123,"244.3.41.84",23,2,128,2,128,0,0,18.474896,0.11587199999999953,8837.337752002246,0
"41.177.93.203",1133,"244.3.41.84",23,57,10675,30,2188,27,8487,120.887192,79.12421,221.2217979806686,858.093875439641
"41.177.93.241",4556,"244.3.41.84",23,4,256,2,128,2,128,18.476531,0.15813799999999745,6475.356966700076,6475.356966700076
"41.177.98.13",50202,"161.89.210.141",80,1,64,0,0,1,64,9.087035,0,0,0
"41.177.98.13",37885,"188.235.231.3",80,1,64,0,0,1,64,26.133061,0,0,0
"41.177.98.31",48242,"41.177.230.224",25,99,77044,61,74050,38,2994,117.48997,0.3120389999999986,1898480.6386381274,76759.63581475426
"41.177.98.41",32214,"46.242.152.255",80,2,128,1,64,1,64,182.019697,0.0001929999999958909,0,0
"41.177.98.43",37819,"41.177.26.155",8010,26,9324,14,3486,12,5838,3.31864,17.325129,1609.6849841637543,2695.73750359954
"41.177.98.43",37820,"41.177.26.155",8010,22,5878,12,3374,10,2504,7.033137,17.080585,1580.2737435515237,1172.793554787497
"41.177.98.43",37808,"41.177.26.155",8010,8,560,4,280,4,280,7.428358,0.0005709999999998772,0,0
"41.177.98.43",37821,"41.177.26.155",8010,22,5132,12,2648,10,2484,8.548888999999999,19.424683,1090.571207777239,1023.028277990431
"41.177.98.43",37822,"41.177.26.155",8010,22,6386,12,3072,10,3314,8.743102,15.692325,1566.1159197250886,1689.488332672182
"41.177.98.43",37812,"41.177.26.155",8010,8,560,4,280,4,280,11.229431,0.0005790000000001072,0,0
"41.177.98.43",37827,"41.177.26.155",8010,22,5138,12,2748,10,2390,16.650627,17.062685000000002,1288.425590696892,1120.5739307734978
"41.177.98.43",37794,"41.177.26.155",8010,4,280,2,140,2,140,27.973022,0.00012299999999854094,0,0
"41.177.98.43",37836,"41.177.26.155",8010,22,5482,12,3084,10,2398,31.15396,17.068854999999996,1445.4396618871042,1123.9183881988572
"41.177.98.43",37842,"41.177.26.155",8010,44,17786,22,8318,22,9468,38.680507,33.514230000000005,1985.544647751119,2260.054908019668
"41.177.98.43",37844,"41.177.26.155",8010,22,4146,12,2428,10,1718,40.092511,15.128335999999997,1283.9482147937488,908.4938356736658
"41.177.98.43",37845,"41.177.26.155",8010,22,5158,12,2770,10,2388,44.590246,17.102040000000002,1295.751851825864,1117.0597191913946
"41.177.98.43",37847,"41.177.26.155",8010,26,6480,14,2512,12,3968,46.920885,17.161303000000004,1171.006653748844,1849.7429944567725
"41.177.98.43",37854,"41.177.26.155",8010,22,4600,12,2008,10,2592,65.945945,17.135620000000003,937.4624320567332,1210.1108684716396
"41.177.98.43",37855,"41.177.26.155",8010,22,4848,12,2570,10,2278,69.002642,16.202070000000006,1268.973655835334,1124.7945478571562
"41.177.98.43",37856,"41.177.26.155",8010,26,7544,14,2794,12,4750,70.355924,15.348331000000002,1456.3146963666602,2475.839229685625
"41.177.98.43",37865,"41.177.26.155",8010,26,7602,14,2706,12,4896,93.180965,17.339585999999997,1248.4727144004478,2258.877461088172
"41.177.98.43",37868,"41.177.26.155",8010,22,4910,12,2718,10,2192,95.521635,17.128857999999994,1269.4366431200497,1023.7693604559047
"41.177.98.43",37871,"41.177.26.155",8010,26,7318,14,3098,12,4220,104.740896,17.219388999999993,1439.3077477952331,1960.5805989980256
"41.177.98.43",37872,"41.177.26.155",8010,22,5150,12,2780,10,2370,110.04777,15.252149000000003,1458.1551753788922,1243.1035128230124
"41.177.98.43",37874,"41.177.26.155",8010,34,11250,18,5378,16,5872,114.629383,26.140147999999996,1645.8973376891365,1797.0824036650445
"41.177.98.43",37877,"41.177.230.224",25,68,49863,41,47375,27,2488,117.415017,0.3016979999999876,1256223.110527798,65973.25802624087
"41.177.98.43",37878,"41.177.26.155",8010,22,4310,12,2592,10,1718,119.780503,15.143440000000012,1369.3057852112852,907.5877079448255
"41.177.98.43",37880,"41.177.26.155",8010,22,4888,12,2594,10,2294,121.531819,17.097711999999987,1213.7296499087138,1073.3599910912064
"41.177.98.43",37886,"41.177.26.155",8010,22,4974,12,2812,10,2162,128.589451,17.069795,1317.8834309375127,1013.251770158927
"41.177.98.43",37888,"41.177.26.155",8010,22,6304,12,2804,10,3500,133.367664,17.081424,1313.2394582559396,1639.207597680381
"41.177.98.43",37891,"41.177.26.155",8010,22,5410,12,2844,10,2566,139.539837,17.058989999999994,1333.7249157189265,1203.3537741683422
"41.177.98.43",37893,"41.177.26.155",8010,30,9280,16,4556,14,4724,149.539331,18.339123,1987.4450921126381,2060.7310393196008
"41.177.98.43",37896,"41.177.26.155",8010,48,29866,22,5442,26,24424,156.604752,24.913198000000023,1747.5074857912646,7842.911215171967
"41.177.98.43",37899,"41.177.26.155",8010,22,4298,12,2580,10,1718,159.267478,35.999671999999975,573.3385570846316,381.7812562292237
"41.177.98.43",37900,"41.177.26.155",8010,22,6270,12,2934,10,3336,159.307995,17.16013799999999,1367.8211678717278,1555.2322481322713
"41.177.98.43",37907,"41.177.26.155",8010,34,12340,18,4804,16,7536,167.932901,24.09463600000001,1595.0438097508502,2502.133669917237
"41.177.98.43",37919,"41.177.26.155",8010,30,10526,16,2878,14,7648,185.635977,17.441168000000005,1320.0950762013183,3508.021939815039
"41.177.98.43",37922,"41.177.26.155",8010,22,4180,12,1888,10,2292,193.215027,15.811937,955.2276865256925,1159.6302211424193
"41.177.98.43",37923,"41.177.26.155",8010,22,5410,12,2844,10,2566,194.002107,17.064820999999995,1333.2691857711256,1202.9425916626965
"41.177.98.43",37929,"41.177.26.155",8010,122,108072,46,5350,76,102722,203.346536,1.580030000000022,27088.09326405157,520101.5170597954
"41.177.98.43",37933,"41.177.26.155",8010,18,6464,10,2832,8,3632,207.915657,0.12982999999999834,174505.1220827258,223800.3543094845
"41.177.98.57",47467,"41.177.230.224",25,78,58325,48,55619,30,2706,116.669751,0.2620979999999946,1697655.0755824507,82595.05986310633
"41.177.98.57",47515,"82.242.98.77",80,10,1828,6,1130,4,698,122.438983,0.1651640000000043,54733.477028891066,33808.82032404068
"41.177.98.57",47822,"41.177.24.224",25,24,3402,12,2038,12,1364,168.991713,0.42318299999999454,38527.06748617078,25785.534863168275
"41.177.98.71",47354,"46.242.152.255",80,2,128,1,64,1,64,41.05597,0.0004029999999985989,0,0
"41.177.98.98",42932,"241.57.75.253",25,41,8295,19,3332,22,4963,8.083178,2.2714090000000002,11735.447028694523,17479.89904063953
"41.177.98.98",42170,"244.3.31.33",10000,4,256,2,128,2,128,15.568421,0.009751999999998873,105004.10172273568,105004.10172273568
"41.177.98.98",42171,"244.3.31.26",7900,4,256,2,128,2,128,15.568535,0.011075999999999198,92452.14879018365,92452.14879018365
"41.177.98.98",42173,"244.3.31.145",7400,4,256,2,128,2,128,15.568637,0.009703999999999269,105523.49546579526,105523.49546579526
"41.177.98.98",42174,"184.4.77.132",7000,4,256,2,128,2,128,15.56874,0.030058000000000362,34067.46955885248,34067.46955885248
"41.177.98.98",39463,"244.3.31.26",7930,4,442,2,314,2,128,25.49891,0.00017400000000122873,0,0
"41.177.98.98",42956,"244.3.31.26",7930,11,1776,6,708,5,1068,25.499287,1.9519410000000015,2901.727050151616,4377.181482432099
"41.177.98.98",41580,"244.3.31.33",10000,4,256,2,128,2,128,110.054223,0.0146220000000028,70031.459444659,70031.459444659
"41.177.98.98",41581,"47.167.160.79",7000,4,256,2,128,2,128,110.056725,0.05275500000000477,19410.482418726326,19410.482418726326
"41.177.98.98",41582,"244.3.31.94",7300,4,256,2,128,2,128,110.058953,0.018637999999995714,54941.51733019828,54941.51733019828
"41.177.98.98",41583,"244.3.31.224",7600,4,256,2,128,2,128,110.06122,0.017423999999991224,58769.51331499746,58769.51331499746
"41.177.98.98",41584,"244.3.31.26",7900,4,256,2,128,2,128,110.063408,0.014475000000004457,70742.65975818202,70742.65975818202
"41.177.98.98",41585,"244.3.31.203",7100,4,256,2,128,2,128,110.065546,0.022767999999999233,44975.40407589751,44975.40407589751
"41.177.98.98",41586,"244.3.31.41",7700,4,256,2,128,2,128,110.06764,0.026718000000002462,38326.22202260295,38326.22202260295
"41.177.98.98",41587,"244.3.31.43",7000,4,256,2,128,2,128,110.069688,0.036369000000007645,28155.847012559727,28155.847012559727
"41.177.98.98",41588,"244.3.31.145",7400,4,256,2,128,2,128,110.071745,0.03709499999999366,27604.7984903673,27604.7984903673
"41.177.98.98",41589,"184.4.77.132",7000,4,256,2,128,2,128,110.073782,0.048344000000000165,21181.53235148098,21181.53235148098
"41.177.98.98",41590,"244.3.31.144",7500,4,256,2,128,2,128,110.075835,0.052565000000001305,19480.64301341148,19480.64301341148
"41.177.98.98",41591,"244.3.31.224",7200,4,256,2,128,2,128,110.077834,0.051040999999997894,20062.302854568723,20062.302854568723
"41.177.98.98",41592,"244.3.31.184",7800,4,256,2,128,2,128,110.079915,0.03632500000000505,28189.951823808882,28189.951823808882
"41.177.98.98",41604,"244.3.31.26",7900,4,256,2,128,2,128,110.083643,0.04126600000000735,24814.61736053452,24814.61736053452
"41.177.98.98",43031,"41.177.230.224",25,245,218832,158,212702,87,6130,123.7194,0.31034700000000726,5482946.508263203,158016.67166107247
"41.177.98.98",43081,"244.3.31.144",7500,27,3581,16,2085,11,1496,196.641354,12.039169999999984,1385.477570297622,994.0884629089892
"41.177.98.98",43082,"244.3.31.224",7200,26,3469,14,1972,12,1497,197.281256,11.400810999999976,1383.7612078649522,1050.4515862950473
"41.177.98.121",6389,"244.3.47.239",2991,10,2346,5,1687,5,659,19.703395,0.010518000000001138,1283133.675603588,501235.97642131866
"41.177.98.121",6389,"244.3.47.145",3571,10,1007,5,408,5,599,95.939984,0.011994000000001392,272136.0680339854,399533.0998832286
"41.177.98.121",6389,"244.3.47.239",3069,10,2346,5,1687,5,659,112.78302,0.011664000000010333,1157064.4718782618,451989.02606269973
"41.177.98.121",65235,"41.177.230.224",25,85,62090,52,59414,33,2676,116.778173,0.4086199999999991,1163212.7649160614,52390.974499535136
"41.177.98.121",6389,"244.3.47.145",3661,10,1007,5,408,5,599,186.939484,0.013529000000005453,241259.51659388604,354202.0844111219
"41.177.98.139",58254,"142.41.168.0",53298,2,146,1,64,1,82,16.301301,0.0003410000000023672,0,0
"41.177.98.142",58690,"41.177.230.224",25,90,74401,56,71412,34,2989,117.963001,5.365981999999988,106466.25352079103,4456.220688030644
"41.177.98.142",58691,"48.82.218.224",443,24,7947,14,4867,10,3080,177.708284,0.4881689999999992,79759.26369761305,50474.32344126735
"41.177.98.143",8001,"82.181.188.253",1305,266,102881,125,88092,141,14789,0.189562,189.60566500000002,3716.8509706711557,623.9897948196854
"41.177.98.143",8001,"244.110.40.40",2085,106,8254,53,4862,53,3392,1.9531269999999998,208.152108,186.86334898899992,130.36620316139195
"41.177.98.143",8001,"203.105.176.71",4101,53,11482,26,8459,27,3023,17.635171,30.090896,2248.919407384878,803.6982348415281
"41.177.98.143",8001,"194.120.155.106",4435,3,298,1,140,2,158,19.663313,0.1627950000000027,6879.8181762338,7764.36622746386
"41.177.98.143",8001,"244.145.41.106",4252,3,298,1,140,2,158,55.826517,0.16636599999999646,6732.14478919986,7597.706262096985
"41.177.98.143",8001,"244.163.184.188",3424,4,362,2,204,2,158,61.622876,0.2805190000000053,5817.787743432599,4505.933644423288
"41.177.98.143",8001,"83.94.193.68",2966,13,13933,13,13933,0,0,64.753449,120.771777,922.9308599143988,0
"41.177.98.143",8001,"244.138.41.17",3702,3,298,1,140,2,158,74.098473,0.17633800000000122,6351.438714287291,7168.052263267085
"41.177.98.143",8001,"194.47.193.89",2447,3,298,1,140,2,158,77.339541,0.1842670000000055,6078.1366169741,6859.61132487077
"41.177.98.143",8001,"186.45.149.108",4665,7,1058,4,863,3,195,83.803151,0.42990600000000256,16059.324596539613,3628.7002274915694
"41.177.98.143",8001,"244.239.193.77",4670,3,298,1,140,2,158,91.834361,0.18646800000000496,6006.392517750875,6778.642984318845
"41.177.98.143",8001,"194.143.194.43",1570,3,298,1,140,2,158,93.448132,0.20784600000000353,5388.605024874094,6081.425670929335
"41.177.98.143",8001,"194.31.194.116",4146,3,298,1,140,2,158,174.089693,0.20691499999998086,5412.850687480867,6108.788633014121
"41.177.98.143",8001,"244.56.67.116",3589,3,298,1,140,2,158,174.208766,0.2009390000000053,5573.830864092935,6290.466260904885
"41.177.98.143",8001,"186.45.149.67",1919,3,298,1,140,2,158,174.889855,0.16752799999997592,6685.4495964863245,7545.007401748852
"41.177.98.143",8001,"153.103.26.253",4168,3,298,1,140,2,158,179.667231,0.2484190000000126,4508.511828805136,5088.177635365797
"41.177.98.143",8001,"244.239.193.90",2048,7,914,4,719,3,195,190.237488,0.11345099999999775,50700.30233316687,13750.429700928427
"41.177.98.143",8001,"194.46.94.159",3038,3,298,1,140,2,158,201.187889,0.2243299999999806,4992.644764410007,5634.556234119865
"41.177.98.151",9076,"181.51.224.13",1723,2,130,1,64,1,66,30.750463,0.00043600000000054706,0,0
"41.177.98.156",39035,"41.177.230.224",25,93,75099,58,72038,35,3061,122.349942,5.161850999999999,111646.77167163488,4744.034649585973
"41.177.98.156",39036,"41.177.230.224",25,80,66825,50,64114,30,2711,122.500774,5.155651999999989,99485.38031659256,4206.64544464988
"41.177.98.156",39046,"41.177.230.224",25,27,11215,15,9768,12,1447,148.728706,5.073246000000012,15403.156085866884,2281.773838682369
"41.177.98.220",7030,"244.3.164.145",1387,14,2561,7,1743,7,818,0.726,25.489734000000002,547.0437627948569,256.7308077832432
"41.177.98.220",7020,"244.3.79.66",1244,622,137436,314,99412,308,38024,1.114084,211.212296,3765.386840925208,1440.219181178732
"41.177.98.220",7010,"244.3.79.3",1162,15,4663,6,3613,9,1050,1.737181,18.634309000000002,1551.1173502596741,450.781405417287
"41.177.98.220",7030,"244.3.79.26",3125,31,7030,15,4801,16,2229,1.780023,87.529338,438.80144506519633,203.72597814003805
"41.177.98.220",7030,"41.177.211.208",2231,39,7660,19,4752,20,2908,3.289712,148.612539,255.80614028806815,156.5412996543986
"41.177.98.220",7010,"244.3.79.176",1689,1523,464073,749,244276,774,219797,5.444837,206.699266,9454.353843714181,8506.929095723059
"41.177.98.220",7020,"244.3.142.41",1103,50,14711,25,11930,25,2781,6.103013,13.455562,7092.97761029974,1653.4426432727223
"41.177.98.220",7010,"244.3.79.163",1180,136,64463,60,37582,76,26881,6.21817,86.53112899999999,3474.5415144184703,2485.2096867937553
"41.177.98.220",7010,"244.3.79.176",1531,253,107195,107,86617,146,20578,6.874772,206.08503,3362.37911118532,798.8159062305497
"41.177.98.220",7010,"244.3.142.22",1125,49,16968,22,9589,27,7379,7.230199,159.664045,480.45882841061683,369.72632128917945
"41.177.98.220",7030,"41.177.168.68",1416,27,4796,13,3053,14,1743,9.700917,132.100881,184.88900161082196,105.55569269821903
"41.177.98.220",7010,"244.3.90.47",1265,110,47579,59,41637,51,5942,14.662692,38.36695,8681.847266983692,1238.9830309680597
"41.177.98.220",7010,"244.3.185.209",1266,58,24181,28,12788,30,11393,17.545526,154.00957300000002,664.2703957110509,591.8073677147329
"41.177.98.220",7030,"41.177.110.39",1758,40,6724,20,4324,20,2400,19.051833,160.993714,214.86553195486874,119.25931468355341
"41.177.98.220",7030,"244.3.90.67",1723,4,256,2,128,2,128,20.17471,0.1854300000000002,5522.2995200345085,5522.2995200345085
"41.177.98.220",7010,"244.3.142.138",2387,106,33637,48,27264,58,6373,22.118067,174.99390400000001,1246.3977030879887,291.3472917319451
"41.177.98.220",7010,"244.3.185.235",2799,493,401591,304,373261,189,28330,22.318004,153.823352,19412.449157914594,1473.3783723553236
"41.177.98.220",7020,"244.3.79.0",1135,19,5320,11,4345,8,975,22.906351,0.3981749999999984,87298.29848684659,19589.37653042012
"41.177.98.220",7010,"244.3.79.202",1231,37,13702,18,9924,19,3778,25.005042,46.59321299999999,1703.9391552585141,648.6781669252989
"41.177.98.220",7030,"41.177.92.225",1198,6,1314,3,933,3,381,25.49017,2.074147,3598.587756798337,1469.5197592070379
"41.177.98.220",7010,"244.3.79.218",3604,52,15814,23,12693,29,3121,26.331942,168.251414,603.5253884998554,148.3969697871306
"41.177.98.220",7010,"244.3.185.214",1173,77,26868,37,21048,40,5820,29.247616,180.640046,932.1521098372616,257.7501557987867
"41.177.98.220",7010,"41.177.199.156",1274,21,3148,8,1483,13,1665,29.24766,164.637829,72.06120289644976,80.9048569268974
"41.177.98.220",7010,"244.3.185.119",2486,24,3231,12,1824,12,1407,31.662586,157.655037,92.5565099451913,71.39638678337947
"41.177.98.220",7030,"41.177.194.177",1120,35,7374,15,5201,20,2173,32.27311,124.48251099999999,334.24775629726815,139.65013928743775
"41.177.98.220",7010,"244.3.79.121",1156,28,8284,13,6164,15,2120,33.966075000000004,29.746179999999995,1657.7590803256085,570.1572437200341
"41.177.98.220",7020,"244.3.177.117",2317,67,22351,36,18815,31,3536,37.468632,74.707114,2014.8014284155054,378.6520250266929
"41.177.98.220",7010,"244.3.185.201",2175,44,9313,21,6729,23,2584,40.716283,131.995374,407.8324744926288,156.6115491289869
"41.177.98.220",7030,"41.177.75.188",1597,33,5943,16,3562,17,2381,45.041673,72.181913,394.7803378389265,263.88882212085457
"41.177.98.220",7010,"244.3.185.118",2127,61,28588,31,16279,30,12309,50.760969,96.30448,1352.2943065577012,1022.5069487940748
"41.177.98.220",7010,"244.3.79.103",3437,26,7472,13,6124,13,1348,55.457447,23.052764999999994,2125.211444267098,467.7963793063436
"41.177.98.220",7010,"244.3.185.39",2294,3,585,1,391,2,194,55.551842,0.17953800000000086,17422.495516269453,8644.40954004162
"41.177.98.220",7010,"244.3.84.219",1897,46,10930,21,5441,25,5489,56.753364,81.83928,531.871736897001,536.563860288116
"41.177.98.220",7010,"244.3.199.164",1347,25,6185,12,4715,13,1470,60.430559,21.764034999999993,1733.1345037811238,540.3409799699368
"41.177.98.220",7030,"41.177.2.71",1183,33,7142,16,4780,17,2362,62.390025,15.192469999999993,2517.036400269345,1243.7740538569442
"41.177.98.220",7010,"41.177.176.25",4116,227,204948,144,198700,83,6248,68.25696,3.3832109999999886,469849.50096225314,14774.13025672953
"41.177.98.220",7030,"41.177.168.66",1196,11,2139,5,1404,6,735,69.112558,83.764354,134.09045093334095,70.19692409971908
"41.177.98.220",7020,"244.3.79.120",1122,223,44435,114,27963,109,16472,70.465197,130.332469,1716.4103597239457,1011.0757588732552
"41.177.98.220",7010,"244.3.185.141",1413,13,4169,6,3400,7,769,87.805643,119.880789,226.89206691824495,51.31764690003834
"41.177.98.220",7010,"244.3.185.121",1131,20,12051,10,5827,10,6224,119.105387,5.430790000000002,8583.649892557065,9168.463520040359
"41.177.98.220",7020,"244.3.93.229",1501,317,196495,183,183966,134,12529,120.509097,53.34446199999999,27589.14318041112,1878.9579319405268
"41.177.98.220",7030,"244.3.79.48",1163,12,2285,5,1504,7,781,132.11843,1.9977750000000185,6022.700254032556,3127.479320744299
"41.177.98.220",7010,"244.3.185.188",2031,291,247014,193,238907,98,8107,142.907992,64.80700099999999,29491.505092173615,1000.7560757208934
"41.177.98.220",7010,"244.3.90.143",1120,40,11162,19,8387,21,2775,144.659354,46.484140999999994,1443.417013987631,477.5822360576697
"41.177.98.220",7080,"41.177.168.251",1359,3,316,1,128,2,188,146.346279,0.2653760000000034,3858.6759918002645,5667.430362956638
"41.177.98.220",7010,"244.3.185.203",1299,18,3120,8,2021,10,1099,152.695448,39.43492699999999,409.99188359090925,222.9495695528992
"41.177.98.220",7030,"41.177.176.181",1141,31,5963,13,3528,18,2435,156.747152,52.439593,538.2192802297302,371.47504176853545
"41.177.98.220",7010,"244.3.185.0",1286,110,48880,46,20242,64,28638,162.217829,48.956249000000014,3307.769759893164,4679.770298578225
"41.177.98.220",7010,"244.3.185.176",1335,24,13411,12,6143,12,7268,170.912332,4.144693000000018,11857.090501033439,14028.542041593852
"41.177.98.220",7010,"244.3.79.66",1623,20,6490,9,5302,11,1188,189.912514,8.268989000000005,5129.526717232297,1149.354534151635
"41.177.98.220",7030,"244.3.79.219",1620,22,3857,10,2333,12,1524,191.909465,20.963843999999995,890.2947379306966,581.5727306499706
"41.177.98.220",7030,"244.3.79.4",1541,50,8380,23,5063,27,3317,195.540488,17.305926999999997,2340.469828631544,1533.3475057418193
"41.177.98.220",7010,"244.3.79.120",1126,4,1724,2,1528,2,196,201.760159,0.00987100000000396,1238375.0379895752,158849.15408766802
"41.177.98.220",7030,"41.177.202.141",1437,12,1987,6,1225,6,762,203.131766,2.959111000000007,3311.8054713053943,2060.078178885478
"41.177.98.220",7010,"244.3.3.249",1075,6,2024,4,1743,2,281,212.729996,0.23484999999999445,59374.068554397825,9572.067276985535
"41.177.98.244",1024,"15.123.218.235",53,1,64,0,0,1,64,64.318222,0,0,0
"41.177.98.251",43753,"46.242.152.255",80,1,64,0,0,1,64,128.901803,0,0,0
"41.177.116.106",1521,"244.3.153.13",1203,2,132,1,68,1,64,79.14959,0.18251200000000267,2980.62593144556,2805.2949943017034
"41.177.117.153",35443,"244.3.41.84",1522,30,10109,15,4848,15,5261,210.936575,1.6381859999999904,23674.96731140434,25691.832307198478
"41.177.117.203",1632,"244.3.153.177",1554,127,18082,43,5902,84,12180,3.39441,207.36660700000002,227.69336241297518,469.8924354778105
"41.177.127.225",3123,"244.3.41.84",23,4,256,2,128,2,128,139.522741,0.19767799999999625,5180.141442143382,5180.141442143382
"41.177.132.22",20702,"244.3.41.84",23,4,256,2,128,2,128,18.484133,0.19835099999999883,5162.565351321678,5162.565351321678
"41.177.132.22",9589,"244.3.160.239",80,10,2020,5,981,5,1039,182.784844,0.009103000000010297,862133.3626267299,913105.5695914092
"41.177.132.22",13172,"244.3.160.239",80,10,1999,5,1041,5,958,182.794225,0.008069999999975153,1031970.2602262257,949690.2106596775
"41.177.132.22",15802,"244.3.160.239",80,83,54612,29,2533,54,52079,182.819142,0.4983100000000036,40665.44921835776,836089.9841464089
"41.177.132.22",7602,"244.3.160.239",80,62,39051,22,1932,40,37119,183.318879,0.16537599999998065,93459.75232199236,1795617.2600621297
"41.177.132.22",3280,"244.3.160.239",80,161,111437,54,3957,107,107480,183.488345,0.23863499999998794,132654.47231127706,3603159.6371028703
"41.177.132.22",4371,"244.3.160.239",80,32,17471,12,1281,20,16190,183.782669,0.1225819999999942,83601.18125010593,1056598.8481180444
"41.177.132.22",12985,"244.3.160.239",80,157,109507,53,3900,104,105607,183.7836,0.2402490000000057,129865.2647877796,3516584.876523856
"41.177.132.22",15586,"244.3.160.239",80,31,16572,12,1278,19,15294,183.784197,0.1143730000000005,89391.72706845107,1069762.9685327783
"41.177.132.22",13548,"244.3.160.239",80,17,6831,7,967,10,5864,184.07516,0.08668999999997595,89237.5129773001,541146.6143732035
"41.177.132.22",12710,"244.3.160.239",80,77,50638,27,2220,50,48418,184.16389,0.17153399999997987,103536.32516003873,2258117.9241435835
"41.177.132.22",5467,"244.3.160.239",80,33,19193,12,1329,21,17864,184.354426,0.12036299999999756,88332.79330026849,1187341.6249179805
"41.177.132.22",9331,"244.3.160.239",80,12,3232,6,903,6,2329,184.354662,0.06405900000001452,112771.03919821356,290856.8663262895
"41.177.132.22",14192,"244.3.160.239",80,40,23384,15,1489,25,21895,184.35476,0.13763700000001222,86546.49549175688,1272622.9138965863
"41.177.132.22",8729,"244.3.160.239",80,13,2927,6,893,7,2034,184.501281,0.11076399999998898,64497.490159263936,146906.93727205246
"41.177.132.22",14952,"244.3.160.239",80,12,1586,6,893,6,693,184.506406,0.10672199999999066,66940.27473248838,51948.0519480565
"41.177.132.22",8448,"244.3.160.239",80,12,1854,6,892,6,962,184.511247,0.09699100000000271,73573.83674773743,79347.56833108005
"41.177.132.22",11900,"244.3.160.239",80,12,1675,6,893,6,782,184.5138,0.10049200000000269,71090.23603868774,62253.71173824615
"41.177.132.22",8604,"244.3.160.239",80,13,3725,6,893,7,2832,184.517353,0.0978799999999751,72987.33142625478,231467.10257464
"41.177.132.22",3759,"244.3.160.239",80,15,5404,7,957,8,4447,184.521811,0.0944019999999739,81099.97669543143,376856.4225335251
"41.177.132.22",3813,"244.3.160.239",80,12,1631,6,892,6,739,184.526035,0.07977099999999382,89456.06799464158,74112.1460179822
"41.177.132.22",6626,"244.3.160.239",80,40,24620,14,1405,26,23215,184.526874,0.13467400000001817,83460.80163950342,1379033.8149900867
"41.177.132.22",9687,"244.3.160.239",80,15,4492,7,957,8,3535,184.527466,0.07918000000000802,96691.08360696166,357160.8992169378
"41.177.132.22",14375,"244.3.160.239",80,11,2767,5,830,6,1937,184.528048,0.014400999999992337,461079.09172998636,1076036.3863626309
"41.177.132.22",9319,"244.3.160.239",80,12,1578,6,893,6,685,184.528831,0.08123800000001324,87939.14178092562,67456.11659567083
"41.177.132.22",10260,"244.3.160.239",80,78,51528,27,2302,51,49226,184.606269,0.1980299999999886,92996.01070545403,1988627.985658853
"41.177.132.22",8045,"244.3.160.239",80,12,1755,6,893,6,862,184.615532,0.100876999999997,70818.91808836715,68360.47860265676
"41.177.132.22",3174,"244.3.160.239",80,13,4230,6,893,7,3337,184.615649,0.10163500000001591,70290.74629801625,262665.42037679756
"41.177.132.22",3794,"244.3.160.239",80,12,1910,6,893,6,1017,184.616103,0.10191799999998352,70095.56702448199,79828.88204243917
"41.177.132.22",11215,"244.3.160.239",80,13,3224,6,904,7,2320,184.616112,0.10715200000001346,67492.90727190432,173211.88591904647
"41.177.132.22",2270,"244.3.160.239",80,13,3522,6,903,7,2619,184.616445,0.0987609999999961,73146.28243942736,212148.52016485078
"41.177.132.22",6451,"244.3.160.239",80,13,3962,6,906,7,3056,184.61645,0.10738000000000625,67498.6030918195,227677.40733841105
"41.177.132.22",4223,"244.3.160.239",80,12,3195,6,1546,6,1649,184.94782,0.179947999999996,68730.9667237217,73310.06735279244
"41.177.132.22",8084,"244.3.160.239",80,10,2094,5,719,5,1375,184.955004,0.05771400000000426,99663.85972207047,190595.00294554507
"41.177.132.22",4440,"244.3.160.239",80,12,1655,6,756,6,899,184.96055,0.26593399999998724,22742.484977476706,27044.30422586185
"41.177.132.22",5381,"244.3.160.239",80,12,2015,6,956,6,1059,185.253434,0.19328400000000556,39568.71753481809,43831.874340347655
"41.177.132.22",7146,"244.3.160.239",80,10,1730,5,897,5,833,186.669402,0.06026200000002291,119080.01725792825,110583.78414253537
"41.177.132.22",11248,"244.3.160.239",80,10,1741,5,898,5,843,186.932118,0.06916200000000572,103872.06847690069,97510.1934588277
"41.177.132.22",2436,"244.3.160.239",80,10,1726,5,899,5,827,187.123013,0.057444000000003825,125200.19497248661,115173.03808926189
"41.177.132.22",5591,"244.3.160.239",80,10,1785,5,901,5,884,187.369436,0.060207999999988715,119718.30985917737,117459.47382409855
"41.177.132.22",11241,"244.3.160.239",80,12,2309,6,1103,6,1206,189.946249,0.2517469999999946,35051.06317056485,38324.19055639275
"41.177.132.22",14128,"244.3.160.239",80,91,60383,32,4109,59,56274,189.952488,0.8055630000000065,40806.24358367966,558853.8699021633
"41.177.132.22",12418,"244.3.160.239",80,6,968,4,838,2,130,190.629748,0.01898199999999406,353176.6937099409,54788.74723423904
"41.177.132.22",4347,"244.3.160.239",80,83,55357,28,2389,55,52968,190.702307,0.1928259999999966,99115.26453901619,2197545.97409067
"41.177.132.22",6751,"244.3.160.239",80,11,3189,5,809,6,2380,190.702763,0.06153000000000475,105184.46286363564,309442.54835037433
"41.177.132.22",5330,"244.3.160.239",80,92,62259,31,2555,61,59704,190.702837,0.19646500000001765,104038.88733361242,2431130.226757728
"41.177.132.22",9268,"244.3.160.239",80,12,1776,6,865,6,911,190.930996,0.2089239999999961,33122.09224407023,34883.498305604604
"41.177.132.22",4366,"244.3.160.239",80,12,2204,6,857,6,1347,190.931791,0.20813400000000115,32940.31729558824,51774.337686297964
"41.177.132.22",12057,"244.3.160.239",80,12,2009,6,857,6,1152,190.933098,0.206830999999994,33147.83567260323,44558.11749689489
"41.177.132.22",10455,"244.3.160.239",80,13,3705,6,1754,7,1951,191.082811,0.18852400000000102,74430.84169654752,82790.52003988838
"41.177.132.22",6634,"244.3.160.239",80,12,2323,6,877,6,1446,191.254394,0.23267400000000293,30153.777388104867,49717.630676396395
"41.177.132.22",12934,"244.3.160.239",80,16,6154,7,937,9,5217,191.257559,0.22903000000002294,32729.336768105703,182229.4022616942
"41.177.132.22",10037,"244.3.160.239",80,12,1977,6,919,6,1058,191.39311,0.20349600000000123,36128.474269764294,41592.95514408121
"41.177.132.22",15107,"244.3.160.239",80,10,1754,5,931,5,823,194.52087,0.05881700000000478,126630.05593619862,111940.42538720887
"41.177.132.22",10773,"244.3.160.239",80,12,2295,6,1110,6,1185,194.77445,0.21322499999999422,41646.14843475315,44460.07738304728
"41.177.132.22",5705,"244.3.160.239",80,181,127327,62,6819,119,120508,194.781255,1.4074310000000025,38759.981839251726,684981.3596545751
"41.177.132.22",6268,"244.3.160.239",80,6,996,4,866,2,130,195.971983,0.019076000000012527,363178.8634931563,54518.7670370789
"41.177.132.22",14465,"244.3.160.239",80,100,67680,34,2915,66,64765,196.044545,0.21147899999999709,110270.99617456259,2449983.213463309
"41.177.132.22",2963,"244.3.160.239",80,136,93017,46,3633,90,89384,196.045759,0.24179699999999116,120200.00248142476,2957323.705422425
"41.177.132.22",3903,"244.3.160.239",80,12,1874,6,921,6,953,196.316935,0.19120399999999904,38534.75868705695,39873.642810820056
"41.177.132.22",6578,"244.3.160.239",80,12,1669,6,921,6,748,196.347225,0.27099699999999416,27188.49286154518,22081.425255630613
"41.177.132.22",15664,"244.3.160.239",80,12,1603,6,921,6,682,196.348219,0.2706359999999961,27224.759455505202,20159.919596801898
"41.177.132.22",6961,"244.3.160.239",80,15,3913,7,1887,8,2026,196.514388,0.5391639999999995,27998.90200384301,30061.35424471963
"41.177.132.22",6438,"244.3.160.239",80,12,2041,6,983,6,1058,197.121539,0.09199699999999211,85481.04829506043,92003.00009783717
"41.177.132.22",7902,"244.3.160.239",80,10,1758,5,935,5,823,202.370967,0.058676999999988766,127477.54656852655,112207.50890470305
"41.177.132.22",3673,"244.3.160.239",80,10,1759,5,936,5,823,202.759048,0.06453099999998813,116037.25341310963,102028.48243481755
"41.177.132.22",10383,"244.3.160.239",80,10,1760,5,937,5,823,203.054114,0.06761099999999942,110869.53306414731,97380.60374791168
"41.177.132.22",8851,"244.3.160.239",80,10,1762,5,939,5,823,203.280083,0.059371999999996206,126524.28754295762,110894.02411912047
"41.177.132.22",9946,"244.3.160.239",80,10,1764,5,941,5,823,203.525533,0.0690969999999993,108948.29008495415,95286.33659927445
"41.177.132.22",15655,"244.3.160.239",80,10,1765,5,942,5,823,203.759776,0.05877700000002051,128213.4168126541,112016.60513462244
"41.177.132.22",9431,"244.3.160.239",80,10,1766,5,943,5,823,203.849613,0.06654100000000085,113373.70944229729,98946.51417922658
"41.177.132.22",12617,"244.3.160.239",80,10,1767,5,944,5,823,204.131509,0.061192000000005464,123414.82546737033,107595.76415216715
"41.177.132.22",6606,"244.3.160.239",80,10,1768,5,945,5,823,204.196014,0.06368900000001076,118701.81664021609,103377.3493067702
"41.177.132.22",4769,"244.3.160.239",80,12,2298,6,1113,6,1185,204.369796,0.24795999999997775,35909.01758348443,38231.97289885808
"41.177.132.22",5876,"244.3.160.239",80,184,127797,67,9861,117,117936,204.38097,1.2691640000000177,62157.45167685098,743393.2888105768
"41.177.132.22",3061,"244.3.160.239",80,6,999,4,869,2,130,205.453818,0.01825900000000047,380743.7428117543,56958.21238840973
"41.177.132.22",15584,"244.3.160.239",80,15,3940,7,1902,8,2038,205.826747,0.46764899999999443,32537.223430393697,34863.75465359745
"41.177.132.22",8027,"244.3.160.239",80,12,2044,6,986,6,1058,206.353545,0.23290900000000647,33867.304397854015,36340.37327883321
"41.177.138.80",54849,"41.177.98.176",80,49,26620,25,3585,24,23035,185.550581,22.18715500000002,1292.6398179487176,8305.706612677464
"41.177.138.80",54852,"41.177.98.176",80,50,33835,24,3861,26,29974,207.014151,2.958223000000004,10441.40350473915,81059.47388009615
"41.177.138.80",54854,"41.177.98.176",80,10,1873,5,1383,5,490,207.768697,0.0025829999999871234,0,0
"41.177.142.13",2643,"244.3.41.84",23,4,256,2,128,2,128,18.478222,0.16448199999999957,6225.605233399416,6225.605233399416
"41.177.142.75",1094,"244.3.41.84",23,4,256,2,128,2,128,18.491504,0.1845390000000009,5548.96254992167,5548.96254992167
"41.177.142.149",4952,"244.3.41.84",23,153,77389,75,5362,78,72027,3.403438,162.40251,264.133848670196,3548.0732409862385
"41.177.142.161",4397,"244.3.41.84",23,4,838,2,201,2,637,64.487872,0.16336499999999887,9842.989624460632,31193.9521929424
"41.177.142.209",1113,"244.3.41.84",23,4,256,2,128,2,128,18.49074,0.12284999999999968,8335.368335368357,8335.368335368357
"41.177.151.142",1286,"244.3.41.84",23,4,256,2,128,2,128,18.49237,0.16188299999999956,6325.556111512653,6325.556111512653
"41.177.153.142",1833,"244.3.41.84",23,4,256,2,128,2,128,18.485866,0.19391499999999695,5280.664208545064,5280.664208545064
"41.177.154.102",2149,"244.3.41.84",23,4,256,2,128,2,128,18.475906,0.19894999999999996,5147.021864790149,5147.021864790149
"41.177.154.154",9494,"244.3.160.239",80,21,11511,12,9995,9,1516,90.205316,0.2250670000000099,355271.98567536107,53886.176116442955
"41.177.154.154",11294,"244.3.160.239",80,120,84753,38,3883,82,80870,90.4416,1.0327750000000009,30078.187407712205,626428.7962044002
"41.177.154.154",11269,"244.3.160.239",80,10,1823,5,1418,5,405,91.214981,0.08358000000001198,135726.25029909518,38765.2548456513
"41.177.154.154",6360,"244.3.160.239",80,10,1822,5,1417,5,405,91.329167,0.08345699999999567,135830.4276453813,38822.38757683799
"41.177.154.154",10947,"244.3.160.239",80,10,1829,5,1424,5,405,91.415931,0.08291199999999321,137398.6877653528,39077.5762253988
"41.177.154.154",2820,"244.3.160.239",80,10,1828,5,1423,5,405,91.502454,0.08257500000000562,137862.5491976897,39237.05722070578
"41.177.154.154",10691,"244.3.160.239",80,10,1827,5,1422,5,405,91.61349,0.08347899999999697,136273.7934091258,38812.15635070039
"41.177.154.154",10825,"244.3.160.239",80,10,1843,5,1438,5,405,91.716706,0.08325299999999913,138181.2066832441,38917.516485892804
"41.177.154.154",13971,"244.3.160.239",80,10,1847,5,1442,5,405,91.860978,0.08277400000000057,139367.43421847344,39142.72597675572
"41.177.154.154",12198,"244.3.160.239",80,10,1841,5,1436,5,405,91.999486,0.08245599999999342,139322.7903366755,39293.683904145946
"41.177.154.154",8030,"244.3.160.239",80,10,1834,5,1429,5,405,92.088528,0.08322499999999877,137362.5713427476,38930.60979273113
"41.177.154.154",14100,"244.3.160.239",80,10,1844,5,1439,5,405,92.176227,0.0840390000000042,136984.01932435448,38553.5287188072
"41.177.154.154",4897,"244.3.160.239",80,10,1837,5,1432,5,405,92.280569,0.08254999999999768,138776.49909146363,39248.94003634271
"41.177.154.154",11827,"244.3.160.239",80,10,1844,5,1439,5,405,92.368494,0.08309500000000014,138540.22504362452,38991.51573500204
"41.177.154.154",15143,"244.3.160.239",80,10,1856,5,1451,5,405,92.456093,0.08398499999999842,138215.1574685982,38578.31755670728
"41.177.154.154",13472,"244.3.160.239",80,10,1857,5,1452,5,405,92.545183,0.08322800000000541,139568.41447588845,38929.206517035
"41.177.154.154",15786,"244.3.160.239",80,10,1840,5,1435,5,405,92.632746,0.08316600000000562,138037.1786547294,38958.22812206648
"41.177.154.154",10061,"244.3.160.239",80,10,1820,5,1415,5,405,92.721364,0.0826680000000124,136933.2752697332,39192.916243280524
"41.177.154.154",15899,"244.3.160.239",80,10,1838,5,1433,5,405,92.727685,0.08520000000000039,134553.99061032804,38028.169014084335
"41.177.154.154",16142,"244.3.160.239",80,10,1830,5,1425,5,405,92.743498,0.08426400000000456,135289.09142693656,38450.583879234604
"41.177.154.154",7901,"244.3.160.239",80,10,1828,5,1423,5,405,92.746085,0.08325400000001082,136738.17474233694,38917.04903067215
"41.177.154.154",7036,"244.3.160.239",80,10,1833,5,1428,5,405,92.750069,0.08302799999999877,137592.13759213962,39022.98019945137
"41.177.154.154",2628,"244.3.160.239",80,10,2103,5,1633,5,470,92.7624,0.007214000000004717,1810923.204878217,521208.7607426589
"41.177.154.154",9640,"244.3.160.239",80,10,1828,5,1423,5,405,92.765501,0.08283500000000288,137429.83038570176,39113.90112874856
"41.177.154.154",5666,"244.3.160.239",80,10,1835,5,1430,5,405,92.784005,0.08458500000000413,135248.56653070214,38304.66394750655
"41.177.154.154",13648,"244.3.160.239",80,10,1825,5,1420,5,405,92.795174,0.08240499999999429,137855.71263880574,39318.00254839178
"41.177.154.154",14404,"244.3.160.239",80,10,1826,5,1421,5,405,92.823277,0.08443099999999504,134642.4891331462,38374.530681860815
"41.177.154.154",12017,"244.3.160.239",80,10,1828,5,1423,5,405,92.829179,0.08311199999999985,136971.79709307945,38983.54028299169
"41.177.154.154",6693,"244.3.160.239",80,10,1827,5,1422,5,405,92.833067,0.08226200000000006,138289.85436775172,39386.350927524225
"41.177.154.154",6848,"244.3.160.239",80,10,1829,5,1424,5,405,92.835019,0.0836529999999982,136181.60735419227,38731.426248910015
"41.177.154.154",11887,"244.3.160.239",80,10,1828,5,1423,5,405,92.836765,0.08392600000000527,135643.30481613905,38605.43812405925
"41.177.154.154",11162,"244.3.160.239",80,10,1828,5,1423,5,405,92.844955,0.08262000000000569,137787.46066326817,39215.686274507105
"41.177.154.154",10566,"244.3.160.239",80,10,1832,5,1427,5,405,92.856063,0.08536499999999592,133731.62303052243,37954.66526094014
"41.177.154.154",2416,"244.3.160.239",80,10,1828,5,1423,5,405,92.858553,0.08369600000000332,136016.05811507776,38711.52743261173
"41.177.154.154",8274,"244.3.160.239",80,10,1826,5,1421,5,405,92.869589,0.08353299999998853,136089.92853125784,38787.0661894155
"41.177.154.154",12256,"244.3.160.239",80,10,1820,5,1415,5,405,92.87867,0.08288500000000454,136574.77227483116,39090.305845446375
"41.177.154.154",7471,"244.3.160.239",80,10,1818,5,1413,5,405,92.909044,0.08223500000001138,137459.71909768877,39399.28254392353
"41.177.154.154",6911,"244.3.160.239",80,10,1836,5,1431,5,405,92.913665,0.08280900000001168,138245.84284314973,39126.18193674049
"41.177.154.154",16296,"244.3.160.239",80,10,1827,5,1422,5,405,92.916475,0.08644799999999009,131593.55913382964,37479.17823431857
"41.177.154.154",8063,"244.3.160.239",80,10,1827,5,1422,5,405,92.920563,0.08325200000000166,136645.3658770933,38917.983952336705
"41.177.154.154",8558,"244.3.160.239",80,10,1832,5,1427,5,405,92.921658,0.08370000000000744,136391.87574670234,38709.6774193514
"41.177.154.154",14443,"244.3.160.239",80,10,1832,5,1427,5,405,92.928828,0.08243500000000381,138484.86686479617,39303.69381937102
"41.177.154.154",13841,"244.3.160.239",80,10,1830,5,1425,5,405,92.945903,0.08343599999999185,136631.6697828409,38832.15878038636
"41.177.154.154",10729,"244.3.160.239",80,10,1827,5,1422,5,405,93.046783,0.08329999999999416,136566.62665066984,38895.55822329204
"41.177.154.154",12728,"244.3.160.239",80,10,1832,5,1427,5,405,93.050655,0.0822599999999909,138779.47969853226,39387.308533921205
"41.177.154.154",14223,"244.3.160.239",80,10,1827,5,1422,5,405,93.05909,0.0835129999999964,136218.31331649554,38796.35505849556
"41.177.154.154",7890,"244.3.160.239",80,10,1862,5,1457,5,405,93.172282,0.08303000000000793,140382.9940985052,39022.04022642046
"41.177.154.154",4401,"244.3.160.239",80,15,5073,7,2110,8,2963,96.161955,0.09167300000000012,184132.7326475623,258571.2259880223
"41.177.154.154",2936,"244.3.160.239",80,12,3471,6,2058,6,1413,96.254374,0.11234699999999975,146545.96918475826,100616.83890090545
"41.177.154.154",3217,"244.3.160.239",80,65,42519,24,2550,41,39969,96.374483,1.6981290000000087,12013.221610372295,188296.6488411648
"41.177.154.154",11008,"244.3.160.239",80,10,2101,5,1631,5,470,98.059962,0.007709000000005517,1692567.129328144,487741.6007260746
"41.177.154.154",10155,"244.3.160.239",80,10,2101,5,1631,5,470,98.082,0.007279000000011138,1792553.9222393234,516554.47176730965
"41.177.154.154",6477,"244.3.160.239",80,10,2100,5,1630,5,470,98.112684,0.0074479999999965685,1750805.5853928581,504833.51235254196
"41.177.154.154",9081,"244.3.160.239",80,10,1891,5,1470,5,421,98.134724,0.008902999999989447,1320903.066383684,378299.4496241707
"41.177.154.154",6652,"244.3.160.239",80,10,1884,5,1463,5,421,98.146592,0.017013000000005718,687944.5130192245,197966.26109439065
"41.177.154.154",10274,"244.3.160.239",80,10,1889,5,1468,5,421,98.166297,0.0083230000000043,1411029.6767985022,404661.7806077448
"41.177.154.154",14577,"244.3.160.239",80,10,1888,5,1467,5,421,98.177982,0.024781000000004383,473588.6364552651,135910.57665144283
"41.177.154.154",4851,"244.3.160.239",80,10,1890,5,1469,5,421,98.207063,0.024715000000000487,475500.70807201165,136273.51810641043
"41.177.154.154",9348,"244.3.160.239",80,10,2102,5,1632,5,470,98.235675,0.0064480000000060045,2024813.8957797522,583126.5508679433
"41.177.154.154",7344,"244.3.160.239",80,10,2100,5,1630,5,470,98.277425,0.0063829999999995835,2042926.5235783882,589064.7031176947
"41.177.154.154",4159,"244.3.160.239",80,10,2108,5,1638,5,470,98.29139,0.006624999999999659,1977962.2641510451,567547.16981135
"41.177.154.154",3879,"244.3.160.239",80,10,2098,5,1628,5,470,98.300822,0.0061210000000073705,2127756.902464355,614278.7126279158
"41.177.154.154",8779,"244.3.160.239",80,10,2098,5,1628,5,470,98.311829,0.0076650000000029195,1699151.9895623012,490541.4220480845
"41.177.154.154",9359,"244.3.160.239",80,10,2112,5,1642,5,470,98.322323,0.007533000000009338,1743793.9731824927,499137.129960884
"41.177.154.154",14459,"244.3.160.239",80,10,2101,5,1631,5,470,98.323798,0.01440900000000056,905545.1453952038,260948.0185994763
"41.177.154.154",10300,"244.3.160.239",80,10,2117,5,1647,5,470,98.325427,0.007702999999992244,1710502.4016634126,488121.5111000631
"41.177.154.154",4067,"244.3.160.239",80,10,1892,5,1471,5,421,98.327902,0.014020999999999617,839312.4598816291,240211.11190357976
"41.177.154.154",7504,"244.3.160.239",80,10,1898,5,1477,5,421,98.332807,0.006771999999998002,1744831.6597760613,497341.99645614205
"41.177.160.197",57800,"244.3.41.84",23,5,359,3,213,2,146,18.490299,0.011669999999998737,146015.42416454022,100085.68980292429
"41.177.164.13",1485,"244.3.41.84",23,4,256,2,128,2,128,18.479978,0.1776660000000021,5763.623878513547,5763.623878513547
"41.177.164.68",8628,"244.3.160.239",80,35,20598,14,1896,21,18702,159.357296,0.39683500000001004,38222.43501707162,377023.19603864633
"41.177.164.68",6256,"244.3.160.239",80,16,6738,7,1255,9,5483,159.759078,0.21805700000001593,46043.007103643846,201158.41270858902
"41.177.164.68",11856,"244.3.160.239",80,19,9115,8,1335,11,7780,159.764731,0.2130109999999945,50138.25577083003,292191.483068957
"41.177.164.68",10952,"244.3.160.239",80,18,8006,8,1332,10,6674,159.766754,0.21133299999999622,50422.792464973245,252643.9316150386
"41.177.164.68",10937,"244.3.160.239",80,13,4410,6,1206,7,3204,159.781152,0.19728900000001204,48902.878518312784,129921.08024268172
"41.177.164.68",7201,"244.3.160.239",80,12,1814,6,1200,6,614,159.782223,0.19657300000000077,48836.81889170925,24988.172332924565
"41.177.164.68",9430,"244.3.160.239",80,12,2991,6,1200,6,1791,159.785588,0.19366700000000492,49569.62208326538,73982.66095927358
"41.177.164.68",8795,"244.3.160.239",80,25,14954,11,1532,14,13422,159.88776,0.19928100000001336,61501.09644170381,538817.0472849534
"41.177.164.68",9079,"244.3.160.239",80,13,4092,6,1205,7,2887,159.912571,0.17508499999999572,55058.97135677092,131913.0707941889
"41.177.164.68",6299,"244.3.160.239",80,12,2887,6,1206,6,1681,159.913161,0.18724800000001096,51525.249935910855,71819.19166025385
"41.177.164.68",9916,"244.3.160.239",80,12,2404,6,1206,6,1198,159.914729,0.17332700000000045,55663.57232283473,55294.32806198674
"41.177.164.68",6008,"244.3.160.239",80,12,2692,6,1205,6,1487,159.915287,0.21688599999998814,44447.313335118575,54849.09122765255
"41.177.164.68",9444,"244.3.160.239",80,12,2876,6,1203,6,1673,159.915499,0.24141099999999938,39865.6233560195,55440.72142528731
"41.177.164.68",5416,"244.3.160.239",80,13,4021,6,1211,7,2810,160.171399,0.11701199999998835,82794.92701604079,192117.04782417393
"41.177.164.68",6927,"244.3.160.239",80,13,3335,6,1207,7,2128,160.17529,0.1152540000000215,83780.17248857478,147708.5393999065
"41.177.164.68",11565,"244.3.160.239",80,13,3227,6,1206,7,2021,160.175926,0.11682400000000825,82585.77004724473,138396.21995479404
"41.177.164.68",15423,"244.3.160.239",80,12,2737,6,1206,6,1531,160.191882,0.06685500000000388,144312.31770248208,183202.4530700664
"41.177.164.68",2657,"244.3.160.239",80,12,2075,6,1201,6,874,160.19254,0.2289920000000052,41957.79765231878,30533.81777529277
"41.177.164.68",5156,"244.3.160.239",80,12,2395,6,1198,6,1197,160.192718,0.23088099999998235,41510.56171794445,41475.91183337187
"41.177.164.68",5336,"244.3.160.239",80,12,2370,6,1208,6,1162,160.288105,0.3689489999999864,26193.322112271224,25195.894283492682
"41.177.164.68",14465,"244.3.160.239",80,12,3009,6,1200,6,1809,160.436514,0.22110800000001518,43417.69632939261,65452.17721655936
"41.177.164.68",9272,"244.3.160.239",80,41,24055,16,2475,25,21580,167.007061,1.9470990000000086,10168.974458925773,88665.23992873462
"41.177.164.68",4748,"244.3.160.239",80,12,2459,6,1339,6,1120,169.014749,0.15208499999999958,70434.29661044829,58914.4228556401
"41.177.164.68",16014,"244.3.160.239",80,12,3212,6,1341,6,1871,169.016759,0.15052799999998,71269.13265307069,99436.64965987715
"41.177.164.68",14910,"244.3.160.239",80,44,26749,18,3466,26,23283,171.202662,0.08510899999998855,325793.9818351024,2188534.7025581906
"41.177.164.68",10415,"244.3.160.239",80,13,3801,6,1337,7,2464,171.295993,0.37500599999998485,28522.21031130284,52564.49230145863
"41.177.164.68",12432,"244.3.160.239",80,12,3117,6,1331,6,1786,171.298772,0.4300879999999836,24757.724000670576,33221.10823831529
"41.177.164.68",7625,"244.3.160.239",80,12,3016,6,1334,6,1682,171.346639,0.40767599999998083,26177.65087962132,33006.6032830008
"41.177.164.68",2100,"244.3.160.239",80,12,2297,6,1333,6,964,171.370744,0.14715000000001055,72470.26843356599,52409.10635405673
"41.177.164.68",3785,"244.3.160.239",80,12,2213,6,1328,6,885,171.376566,0.28621200000000613,37119.33811300635,24736.908305730885
"41.177.164.68",16264,"244.3.160.239",80,12,2518,6,1337,6,1181,171.38351,0.28383999999999787,37683.20180383343,33286.358511837905
"41.177.164.68",11338,"244.3.160.239",80,12,3071,6,1330,6,1741,171.789268,0.2276990000000012,46728.35629493298,61168.472413141586
"41.177.164.68",9768,"244.3.160.239",80,35,17993,14,2651,21,15342,173.217524,0.1621110000000101,130823.9416202397,757110.8684789579
"41.177.164.68",12565,"244.3.160.239",80,14,4834,6,1327,8,3507,173.374604,0.060489999999987276,175500.08265832753,463812.20036379405
"41.177.168.118",1414,"41.177.98.176",80,3,192,2,128,1,64,11.203511,0.02564899999999959,39923.583765449584,19961.791882724792
"41.177.176.106",11013,"244.3.160.239",80,12,1919,6,1203,6,716,105.055337,0.24163100000001236,39829.32653508659,23705.567580317536
"41.177.176.156",2546,"244.3.160.239",80,72,42626,27,3026,45,39600,10.103404,1.099915000000001,22008.973420673396,288022.25626525655
"41.177.176.156",13194,"244.3.160.239",80,10,2583,5,1466,5,1117,10.836039,0.4021480000000004,29163.392581835513,22220.674975382175
"41.177.176.156",6861,"244.3.160.239",80,10,2610,5,1544,5,1066,19.743847,0.25560700000000125,48324.18517489717,33363.71852101061
"41.177.176.156",11538,"244.3.160.239",80,151,100260,54,4703,97,95557,20.248259,3.1829149999999977,11820.610980814765,240174.80831250615
"41.177.176.156",7754,"244.3.160.239",80,10,2635,5,1518,5,1117,21.530505,0.7579639999999976,16021.869112517266,11789.478128248871
"41.177.176.156",4660,"244.3.160.239",80,16,7624,7,1661,9,5963,22.295471,1.1094779999999993,11976.803505792823,42996.7966917776
"41.177.176.156",14557,"244.3.160.239",80,16,6726,7,1460,9,5266,23.485635,1.2657280000000029,9227.890984476897,33283.612276887216
"41.177.176.156",10114,"244.3.160.239",80,149,100800,52,5238,97,95562,35.054765,1.7879229999999993,23437.25093306592,427588.88386132976
"41.177.176.156",14328,"244.3.160.239",80,10,1857,5,1306,5,551,36.256485,3.860984000000002,2706.0459199002107,1141.677872790977
"41.177.176.156",8518,"244.3.160.239",80,10,1858,5,1307,5,551,39.628254,0.2427640000000011,43070.636502940935,18157.552190604787
"41.177.176.156",12751,"244.3.160.239",80,10,1862,5,1311,5,551,39.886641,0.48228399999999993,21746.522795697143,9139.842914133582
"41.177.176.156",5269,"244.3.160.239",80,10,1859,5,1308,5,551,40.450996,0.36043299999999334,29031.74792541247,12229.734791209688
"41.177.176.156",3892,"244.3.160.239",80,10,2635,5,1518,5,1117,41.051898,0.2487819999999985,48813.82093559853,35918.997355114334
"41.177.176.156",5032,"244.3.160.239",80,10,1860,5,1309,5,551,41.087354,0.22045200000000165,47502.40415147026,19995.282419755626
"41.177.176.156",9760,"244.3.160.239",80,10,1865,5,1314,5,551,41.482033,0.20974999999999966,50116.80572109662,21015.494636472024
"41.177.176.156",7866,"244.3.160.239",80,10,1859,5,1308,5,551,41.893751,0.37342599999999493,28021.616063156132,11804.212882873875
"41.177.176.156",8501,"244.3.160.239",80,18,7750,8,1725,10,6025,42.485953,3.9167190000000005,3523.3571772700566,12306.218546696864
"41.177.176.156",8303,"244.3.160.239",80,16,6726,7,1460,9,5266,46.479467,0.43211000000000155,27030.154358843716,97493.6937353911
"41.177.176.156",2817,"244.3.160.239",80,21,10200,9,1635,12,8565,80.301306,0.2826700000000102,46273.03923302625,242402.80185374297
"41.177.176.156",13103,"244.3.160.239",80,50,33684,19,2401,31,31283,88.621507,0.5536440000000056,34693.774338744406,452030.54670509836
"41.177.176.156",15368,"244.3.160.239",80,64,36782,24,2839,40,33943,111.895141,1.0543980000000062,21540.253300935576,257534.63113549002
"41.177.176.156",9184,"244.3.160.239",80,10,1806,5,1255,5,551,112.628414,0.5277239999999921,19025.096451933492,8352.85111156602
"41.177.176.156",15720,"244.3.160.239",80,10,2583,5,1466,5,1117,113.264779,0.5180620000000005,22638.217047380407,17248.900710725728
"41.177.176.156",3411,"244.3.160.239",80,10,1808,5,1257,5,551,113.739003,1.2537200000000013,8020.9297131735875,3515.936572759464
"41.177.176.156",7340,"244.3.160.239",80,10,2618,5,1548,5,1070,141.344639,0.5781589999999994,21419.713262268706,14805.615756219324
"41.177.176.156",11753,"244.3.160.239",80,10,2089,5,1567,5,522,142.091925,0.3614599999999939,34681.56919161238,11553.145576274195
"41.177.176.156",12007,"244.3.160.239",80,144,99854,52,4583,92,95271,142.518131,2.8982230000000015,12650.51032995045,262977.69357292366
"41.177.176.156",9405,"244.3.160.239",80,10,2639,5,1522,5,1117,143.785206,1.659273000000013,7338.153516630418,5385.49111568737
"41.177.176.156",9679,"244.3.160.239",80,18,7677,8,1729,10,5948,145.450668,3.0523769999999786,4531.550329464577,15589.162151333316
"41.177.176.156",11350,"244.3.160.239",80,26,14525,10,1635,16,12890,148.601599,1.4904750000000035,8775.725859205937,69185.9977523942
"41.177.176.156",8195,"244.3.160.239",80,10,2048,5,1548,5,500,188.560801,0.49227099999998813,25156.87497333846,8125.605611543431
"41.177.176.156",8148,"244.3.160.239",80,55,38007,20,2597,35,35410,188.715454,2.5106169999999963,8275.256640100832,112832.8215733425
"41.177.176.156",7900,"244.3.160.239",80,13,4755,6,1577,7,3178,192.088241,0.09635299999999347,130935.20699927199,263863.0867746902
"41.177.176.156",10771,"244.3.160.239",80,30,18616,12,1961,18,16655,192.192457,0.12657600000000002,123941.34749083553,1052648.211351283
"41.177.176.156",13935,"244.3.160.239",80,12,3618,6,1576,6,2042,192.347773,0.09614400000000956,131136.62839073417,169911.79896819746
"41.177.176.156",10229,"244.3.160.239",80,10,1854,5,1433,5,421,192.484468,0.07357300000001032,155818.03107115914,45777.66300136636
"41.177.176.156",4010,"244.3.160.239",80,15,5183,7,1504,8,3679,192.538692,0.21794299999999112,55207.09543321185,135044.48410823563
"41.177.176.156",12312,"244.3.160.239",80,10,1852,5,1431,5,421,192.766255,0.11098200000000702,103151.86246417685,30347.263520208566
"41.177.176.156",16148,"244.3.160.239",80,18,9083,8,1572,10,7511,192.895316,0.2539170000000013,49527.99536856507,236644.25776926987
"41.177.176.156",15076,"244.3.160.239",80,24,14880,10,1702,14,13178,193.1257,0.23112700000001496,58911.3344611366,456130.1795116675
"41.177.176.156",2124,"244.3.160.239",80,193,139187,66,5418,127,133769,193.372268,1.768743999999998,24505.52482439519,605034.9852776892
"41.177.176.156",14142,"244.3.160.239",80,57,38587,21,2536,36,36051,195.231194,0.31134700000001203,65162.02179561459,926323.3626789044
"41.177.176.156",4836,"244.3.160.239",80,15,6205,7,1648,8,4557,195.629955,0.06555800000001,201104.36559989612,556087.739101169
"41.177.176.156",6079,"244.3.160.239",80,34,21366,13,2022,21,19344,195.738192,0.4942829999999958,32726.191270992807,313083.8001711597
"41.177.176.156",14390,"244.3.160.239",80,10,2096,5,1510,5,586,196.292671,0.18755999999999062,64406.05672851676,24994.668372788623
"41.177.176.156",6586,"244.3.160.239",80,94,83856,34,3380,60,80476,196.490145,3.495339999999999,7736.014236097207,184190.37919057952
"41.177.176.156",4415,"244.3.160.239",80,12,3004,6,1577,6,1427,196.497037,1.244542999999993,10137.054324358476,9172.844972009858
"41.177.176.156",10519,"244.3.160.239",80,12,3091,6,2606,6,485,196.504192,1.7633179999999982,11823.165191984668,2200.397205722396
"41.177.176.156",10792,"244.3.160.239",80,12,2483,6,1454,6,1029,196.840515,2.0480409999999836,5679.573797594918,4019.4507824794846
"41.177.176.156",9766,"244.3.160.239",80,12,2639,6,1593,6,1046,197.748084,4.122293999999982,3091.482558012615,2029.9376997370969
"41.177.176.156",8079,"244.3.160.239",80,13,3304,6,1204,7,2100,201.814523,0.20325099999999452,47389.68073957944,82656.41989461529
"41.177.176.241",3949,"244.3.210.197",80,1,64,0,0,1,64,120.339106,0,0,0
"41.177.176.241",3951,"244.3.210.197",80,1,64,0,0,1,64,120.339152,0,0,0
"41.177.176.241",3954,"244.3.210.197",80,1,64,0,0,1,64,120.339156,0,0,0
"41.177.176.241",3953,"244.3.210.197",80,1,64,0,0,1,64,120.339171,0,0,0
"41.177.176.241",3952,"244.3.210.197",80,1,64,0,0,1,64,120.339208,0,0,0
"41.177.176.241",3950,"244.3.210.197",80,1,64,0,0,1,64,120.339213,0,0,0
"41.177.180.176",4635,"244.3.41.152",443,12,1712,12,1712,0,0,85.541714,0.02488599999999508,550349.5941494297,0
"41.177.181.136",1285,"244.3.41.84",23,4,256,2,128,2,128,139.528433,0.17220100000000116,5946.539218703684,5946.539218703684
"41.177.181.165",1687,"244.3.41.84",23,31,12916,13,1222,18,11694,94.037233,114.85507199999999,85.11596248879633,814.5221483993324
"41.177.181.177",1515,"244.3.41.84",23,4,256,2,128,2,128,139.520984,0.1509110000000078,6785.456328564168,6785.456328564168
"41.177.181.193",1812,"244.3.41.84",23,4,256,2,128,2,128,18.474733,0.140979999999999,7263.441622925289,7263.441622925289
"41.177.194.117",4076,"41.177.98.176",80,111,85141,41,9029,70,76112,38.663295,33.530576,2154.212918978785,18159.42559412042
"41.177.194.177",2008,"41.177.98.176",80,62,47355,24,5124,38,42231,1.525099,27.307035,1501.1516263116812,12372.196395544226
"41.177.194.186",2037,"41.177.98.176",80,63,46654,24,4310,39,42344,36.533838,33.83585099999999,1019.0374700491502,10011.629380919076
"41.177.194.186",2045,"41.177.98.176",80,69,52595,25,3433,44,49162,89.581039,25.788579999999996,1064.967516629454,15250.781547491179
"41.177.194.186",2047,"41.177.98.176",80,37,24572,15,2809,22,21763,132.12699,24.457133,918.8321460246383,7118.741186875829
"41.177.194.186",2053,"41.177.98.176",80,49,35525,19,3932,30,31593,156.588907,33.81186700000001,930.3242556821838,7475.008700347719
"41.177.202.202",1521,"244.3.153.13",1200,2,132,1,68,1,64,56.507761,0.1926379999999952,2823.9495841942585,2657.834902771067
"41.177.202.202",1521,"244.3.153.156",1513,2,132,1,68,1,64,93.116314,0.1927570000000003,2822.2061974402964,2656.1940681791025
"41.177.211.106",1950,"41.177.98.176",80,93,71511,40,11455,53,60056,36.812066,18.407973,4978.277619159916,26099.994822895493
"41.177.211.106",1952,"41.177.98.176",80,171,141495,66,11983,105,129512,39.408762,15.811225999999998,6063.0339481581,65529.137335713254
"41.177.211.106",1954,"41.177.98.176",80,83,62620,34,6469,49,56151,58.472925,26.73087900000001,1936.0380928737877,16804.834588492202
"41.177.211.106",1955,"41.177.98.176",80,160,132298,59,9710,101,122588,59.007453,56.493618999999995,1375.022549006818,17359.553474526037
"41.177.211.106",1957,"41.177.98.176",80,31,22285,13,2768,18,19517,118.885032,16.037891000000002,1380.7301720656412,9735.4446416926
"41.177.211.106",1959,"41.177.98.176",80,161,146095,58,9075,103,137020,142.16517,56.038831000000016,1295.5302368816363,19560.7221000024
"41.177.211.156",2155,"41.177.98.176",80,147,128773,48,5790,99,122983,11.2648,40.693624,1138.2618564520083,24177.350240420958
"41.177.211.156",2157,"41.177.98.176",80,40,32055,14,1608,26,30447,13.321185,18.631252,690.4527940473351,13073.517549974635
"41.177.211.156",2160,"41.177.98.176",80,11,2779,6,1083,5,1696,31.952633,20.00575,433.0754907963961,678.2050160578834
"41.177.211.208",1062,"41.177.98.176",80,353,315173,116,17639,237,297534,45.29593,40.464949000000004,3487.264990745447,58823.05696221191
"41.177.211.208",1065,"41.177.98.176",80,31,12994,16,10255,15,2739,47.308382,17.046327999999995,4812.766714332847,1285.438130722347
"41.177.211.208",1068,"41.177.98.176",80,10,1706,6,1286,4,420,65.770614,19.990319,514.6491159045536,168.08135978220258
"41.177.230.151",3389,"145.95.67.152",1865,1,64,0,0,1,64,142.826541,0,0,0
"41.177.230.224",34511,"41.177.98.57",113,2,134,1,70,1,64,116.687476,0.0002179999999896154,0,0
"41.177.230.224",34514,"244.3.160.254",113,2,134,1,70,1,64,116.752875,0.00026599999999632473,0,0
"41.177.230.224",34516,"41.177.98.121",113,2,134,1,70,1,64,116.796536,0.0003079999999897609,0,0
"41.177.230.224",34533,"41.177.98.43",113,2,134,1,70,1,64,117.437599,0.00011699999998882049,0,0
"41.177.230.224",34534,"41.177.98.31",113,2,134,1,70,1,64,117.506928,0.0002309999999994261,0,0
"41.177.230.224",34537,"244.3.31.46",113,3,204,3,204,0,0,117.957171,5.0065349999999995,325.9739520446776,0
"41.177.230.224",34538,"41.177.98.142",113,3,204,3,204,0,0,118.178463,5.005130000000008,326.0654568412803,0
"41.177.230.224",34545,"41.177.98.156",113,3,204,3,204,0,0,122.367647,5.006000999999998,326.0087243290604,0
"41.177.230.224",34546,"41.177.98.156",113,3,204,3,204,0,0,122.516125,5.007537999999997,325.9086601040274,0
"41.177.230.224",34548,"41.177.98.98",113,2,134,1,70,1,64,123.736687,0.00014799999999581814,0,0
"41.177.230.224",34587,"41.177.98.156",113,3,204,3,204,0,0,148.746626,5.007006000000018,325.9432882644826,0
"41.177.230.224",34651,"41.177.3.203",113,2,134,1,70,1,64,176.405767,0.00015999999999394277,0,0
"41.177.230.224",34674,"41.177.3.224",113,2,134,1,70,1,64,176.94638,0.00016700000000469117,0,0
"41.177.230.253",43368,"244.3.31.40",22,46,10743,25,6202,21,4541,59.989104,0.35528599999999955,139650.8728179553,102250.01829512011
"41.177.230.253",43369,"244.3.31.40",22,43,9059,23,4278,20,4781,60.387712,0.3432340000000025,99710.40165018545,111434.18192836293
"41.177.230.253",43370,"244.3.31.40",22,56,18531,29,6458,27,12073,60.797822,0.6130290000000045,84276.6002913396,157552.08970537983
"41.177.230.253",43372,"244.3.31.40",22,46,10551,25,6154,21,4397,61.460189,0.3525190000000009,139657.72057676286,99784.69245629288
"41.177.230.253",43373,"244.3.31.40",22,46,10551,25,6154,21,4397,61.853821,0.3589489999999955,137155.9748042218,97997.20851708861
"41.177.230.253",43374,"244.3.31.40",22,46,8877,24,4400,22,4477,62.271357,0.3791579999999968,92837.28683029317,94461.93934982331
"41.177.230.253",43375,"244.3.31.40",22,43,8643,23,4294,20,4349,62.696734,0.353904,97065.87097065871,98309.14598309145
"41.177.230.253",43376,"244.3.31.40",22,46,10567,25,6170,21,4397,63.203527,0.37914200000000164,130188.68919824179,92777.90379330132
"41.177.230.253",43377,"244.3.31.40",22,58,23591,29,6410,29,17181,63.689782,0.2759769999999975,185812.5858314297,498041.5034586261
"41.177.230.253",43378,"244.3.31.40",22,59,23809,29,6474,30,17335,64.206838,0.2802109999999942,184832.14434836988,494912.76216851897
"41.177.230.253",43384,"244.3.31.40",22,46,10791,25,6250,21,4541,89.507784,0.35591700000000515,140482.1910726357,102068.74074573419
"41.177.230.253",43385,"244.3.31.40",22,46,9245,24,4368,22,4877,89.906703,0.3936610000000087,88766.73076580923,99110.6561229056
"41.177.230.253",43386,"244.3.31.40",22,54,18265,28,6442,26,11823,90.367059,0.608815000000007,84649.68832896596,155357.53882542136
"41.177.230.253",43388,"244.3.31.40",22,46,10599,25,6202,21,4397,91.025764,0.3564720000000108,139186.2474472006,98678.15705020011
"41.177.230.253",43389,"244.3.31.40",22,46,10599,25,6202,21,4397,91.424904,0.3577839999999952,138675.8491156694,98316.30257362116
"41.177.230.253",43390,"244.3.31.40",22,46,8877,24,4400,22,4477,91.839368,0.39065900000001363,90104.1573341425,91680.98008748998
"41.177.230.253",43391,"244.3.31.40",22,43,8659,23,4310,20,4349,92.27376,0.35643699999999967,96735.18742442572,97610.51742664211
"41.177.230.253",43392,"244.3.31.40",22,46,10615,25,6218,21,4397,92.775364,0.3569520000000068,139357.67274030976,98545.46269526247
"41.177.230.253",43393,"244.3.31.40",22,58,22519,29,6458,29,16061,93.262067,0.2829019999999929,182621.54385618094,454178.4787665101
"41.177.230.253",43394,"244.3.31.40",22,58,23159,29,6538,29,16621,93.848763,0.2783549999999906,187903.9356217843,477692.1557004706
"41.177.230.253",43397,"244.3.31.40",22,54,18409,30,13500,24,4909,106.433077,0.3891980000000075,277493.71785054886,100904.93784654404
"41.177.230.253",43398,"244.3.31.40",22,43,8675,23,4310,20,4365,106.866527,0.3431139999999999,100491.38187308011,101773.75449559042
"41.177.230.253",43399,"244.3.31.40",22,43,8675,23,4310,20,4365,107.251499,0.3381040000000013,101980.45571776692,103281.83044270362
"41.177.230.253",43401,"244.3.31.40",22,77,35935,38,13996,39,21939,107.656194,0.5629870000000068,198882.03457628444,311751.42587661505
"41.177.230.253",43402,"244.3.31.40",22,54,17801,30,13196,24,4605,108.270098,0.40687299999999027,259461.79766168442,90544.22387329924
"41.177.230.253",43403,"244.3.31.40",22,54,17801,30,13196,24,4605,108.71975,0.3871719999999925,272664.34556218435,95151.50889010752
"41.177.230.253",43404,"244.3.31.40",22,43,8659,23,4310,20,4349,109.166404,0.3641099999999966,94696.65760347235,95553.54151218127
"41.177.230.253",43405,"244.3.31.40",22,43,8659,23,4310,20,4349,109.575019,0.36445899999999654,94605.97762711396,95462.04099775373
"41.177.230.253",43406,"244.3.31.40",22,57,20931,28,4928,29,16003,110.073733,0.5591529999999949,70506.64129495926,228960.58860455218
"41.177.230.253",43408,"244.3.31.40",22,58,18329,30,13468,28,4861,111.684418,0.5226750000000067,206139.5704787844,74401.87497010476
"41.177.230.253",43409,"244.3.31.40",22,142,100089,58,15228,84,84861,112.325406,0.4000219999999928,304543.2501212488,1697126.6580338387
"41.177.230.253",43410,"244.3.31.40",22,169,112911,67,15884,102,97027,113.073499,0.48419300000000476,262440.80356386554,1603112.8083222855
"41.177.230.253",43412,"244.3.31.40",22,46,10215,25,5770,21,4445,116.15421,0.3578279999999978,129000.5253920886,99377.35448316012
"41.177.230.253",43413,"244.3.31.40",22,49,13195,26,5818,23,7377,116.582955,0.2721990000000005,170992.5458947311,216811.96477577026
"41.177.230.253",43414,"244.3.31.40",22,46,10119,25,5722,21,4397,116.905998,0.35503200000000845,128934.85657630555,99078.39293359236
"41.177.230.253",43415,"244.3.31.40",22,46,10119,25,5722,21,4397,117.302768,0.34813300000000424,131489.97653195602,101041.843203602
"41.177.230.253",43416,"244.3.31.40",22,43,8659,23,4310,20,4349,117.70966,0.3396759999999972,101508.49633179937,102427.01868839802
"41.177.230.253",43417,"244.3.31.40",22,43,8659,23,4310,20,4349,118.094018,0.34524499999999136,99871.10602615784,100774.81208996761
"41.177.230.253",43418,"244.3.31.40",22,46,10135,25,5738,21,4397,118.584647,0.35629299999999375,128837.78238697028,98727.73251228797
"41.177.230.253",43419,"244.3.31.40",22,55,19859,28,5898,27,13961,119.0527,0.28103400000000534,167894.27613740368,397418.10599428497
"41.177.230.253",43420,"244.3.31.40",22,55,20035,28,5978,27,14057,119.597394,0.27692000000000405,172699.69666329373,406095.62328469724
"41.177.230.253",43421,"244.3.31.40",22,55,18355,29,9006,26,9349,120.009551,0.4330580000000026,166370.32452927684,172706.6582305362
"41.177.230.253",43422,"244.3.31.40",22,76,38395,35,9470,41,28925,120.540582,0.32853400000000477,230600.1814119662,704341.10320392
"41.177.230.253",43424,"244.3.31.40",22,49,13179,27,8670,22,4509,123.759407,0.3667520000000053,189119.62306953745,98355.29185934768
"41.177.230.253",43425,"244.3.31.40",22,58,22039,30,8862,28,13177,124.195791,0.4094220000000064,173161.1882116713,257475.17231609038
"41.177.230.253",43426,"244.3.31.40",22,49,13083,27,8622,22,4461,124.655347,0.36859699999999407,187131.20291266913,96821.18953762666
"41.177.230.253",43428,"244.3.31.40",22,49,13099,27,8638,22,4461,125.06595,0.3676020000000051,187985.91955429796,97083.25852416338
"41.177.230.253",43429,"244.3.31.40",22,43,8659,23,4310,20,4349,125.492578,0.35659100000000876,96693.41065814659,97568.36263393957
"41.177.230.253",43430,"244.3.31.40",22,46,8893,24,4416,22,4477,125.894692,0.39481399999999667,89480.10962124012,90716.13468620743
"41.177.230.253",43432,"244.3.31.40",22,49,13115,27,8654,22,4461,126.444717,0.3687589999999972,187743.21440290415,96778.6548938474
"41.177.230.253",43433,"244.3.31.40",22,80,44397,37,9262,43,35135,126.916224,0.3031299999999959,244436.38043084156,927258.9318114466
"41.177.230.253",43434,"244.3.31.40",22,91,50671,40,9534,51,41137,127.504235,0.33753600000000006,225967.00796359495,974995.2597648841
"41.177.230.253",43435,"244.3.31.40",22,46,9085,24,4496,22,4589,130.035312,0.3841409999999996,93632.2860616285,95569.07489697803
"41.177.230.253",43436,"244.3.31.40",22,43,9875,23,4278,20,5597,130.470916,0.3389190000000042,100979.88014835278,132114.16297109175
"41.177.230.253",43438,"244.3.31.40",22,57,17955,28,4736,29,13219,130.877827,3.088903000000016,12265.84324596784,34236.102590466406
"41.177.230.253",43439,"244.3.31.40",22,46,8909,24,4448,22,4461,134.023808,0.3855519999999899,92293.64651201636,92563.38963356677
"41.177.230.253",43440,"244.3.31.40",22,43,8691,23,4358,20,4333,134.452721,0.34646399999999744,100628.05948092806,100050.79892860516
"41.177.230.253",43442,"244.3.31.40",22,43,8659,23,4310,20,4349,134.857458,0.3514979999999923,98094.44150464797,98982.0710217434
"41.177.230.253",43443,"244.3.31.40",22,46,8877,24,4400,22,4477,135.253345,0.3956640000000107,88964.37381212102,90521.25035383314
"41.177.230.253",43444,"244.3.31.40",22,46,8925,24,4464,22,4461,135.788266,0.380786999999998,93784.71428909125,93721.68692733783
"41.177.230.253",43445,"244.3.31.40",22,45,8829,23,4368,22,4461,136.268743,0.38027999999999906,91890.18617860547,93846.6393183972
"41.177.230.253",43446,"244.3.31.40",22,49,12705,25,4576,24,8129,136.931701,0.2992759999999919,122321.87011320985,217297.74522514924
"41.177.230.253",43447,"244.3.31.40",22,49,13083,27,8574,22,4509,139.385477,0.3705400000000054,185113.61796297025,97349.81378528492
"41.177.230.253",43448,"244.3.31.40",22,61,22107,31,8814,30,13293,139.823638,0.3909140000000093,180377.26968079506,272039.37438924535
"41.177.230.253",43449,"244.3.31.40",22,48,12929,26,8468,22,4461,140.264889,0.3882949999999994,174465.29056516336,91909.5017963148
"41.177.230.253",43450,"244.3.31.40",22,48,12929,26,8468,22,4461,140.69632000000001,0.36666599999998084,184756.69955764522,97331.0860565252
"41.177.230.253",43454,"244.3.31.40",22,43,8659,23,4310,20,4349,141.122149,0.3467430000000036,99439.64261715347,100339.44448770312
"41.177.230.253",43456,"244.3.31.40",22,46,8877,24,4400,22,4477,141.514534,0.3942859999999939,89275.2976265973,90837.61533506276
"41.177.230.253",43457,"244.3.31.40",22,49,13005,27,8544,22,4461,142.061017,0.3921180000000106,174314.87460406855,91013.41942986303
"41.177.230.253",43458,"244.3.31.40",22,79,43955,36,9092,43,34863,142.565909,0.3062060000000031,237539.43423707984,910837.8020025643
"41.177.230.253",43459,"244.3.31.40",22,89,49913,40,9422,49,40491,143.143478,0.30996600000000285,243175.05790957494,1045043.6499486944
"41.177.241.61",3808,"244.3.41.84",23,4,256,2,128,2,128,18.473289,0.12442699999999718,8229.72505967373,8229.72505967373
"41.177.241.61",9149,"244.3.41.84",23,5,320,2,128,3,192,18.493933,0.2793680000000016,3665.4162251939883,5498.124337790982
"41.177.241.61",47031,"244.3.41.84",23,4,256,2,128,2,128,139.523366,0.1290029999999831,7937.799896127486,7937.799896127486
"41.177.241.61",56732,"244.3.41.84",23,4,256,2,128,2,128,139.532689,0.18789300000000253,5449.910321299815,5449.910321299815
"41.177.241.197",42823,"188.235.231.3",80,1,64,0,0,1,64,130.769211,0,0,0
"41.177.241.254",3389,"244.3.93.198",1904,12558,1497559,6191,671752,6367,825807,0,213.03009,25226.558370228355,31011.844383110387
"41.177.242.26",1218,"244.3.41.84",23,4,256,2,128,2,128,139.52612,0.21380600000000527,4789.38851108002,4789.38851108002
"41.177.242.57",1075,"244.3.41.84",23,5,2795,2,201,3,2594,10.236928,0.7076619999999991,2272.271225528574,29324.734124483195
"41.177.242.224",1872,"244.3.41.84",23,4,256,2,128,2,128,18.472034,0.15598400000000012,6564.775874448656,6564.775874448656
"41.177.244.77",3549,"244.3.210.90",445,2,130,1,66,1,64,86.869031,0.00013500000000021828,0,0
"41.177.244.77",3549,"244.3.210.90",445,2,130,1,66,1,64,93.428399,0.0003049999999973352,0,0
"41.177.244.77",3551,"244.3.210.90",445,2,130,1,66,1,64,206.884477,0.00012499999999704414,0,0
"41.177.244.117",52544,"244.3.210.254",19813,10,760,5,386,5,374,32.364067,160.25877599999998,19.26883554882511,18.669804391866816
"41.177.244.124",55919,"244.3.210.254",19813,10,760,5,374,5,386,18.326513,160.039841,18.69534474231326,19.295195375756467
"41.177.244.142",49225,"244.3.210.90",548,86,7126,43,3492,43,3634,0.620789,210.012491,133.0206592330739,138.42986129810726
"41.177.244.177",56182,"244.3.210.254",5900,1224,293735,598,41860,626,251875,0.171715,212.06053699999998,1579.1717060492024,9502.003666056926
"41.177.244.177",49192,"244.3.210.90",548,68,5330,34,2700,34,2630,0.620765,210.01251,102.85101587519715,100.18450805621056
"41.177.244.177",54781,"244.3.210.254",19813,25391,3215522,16498,1723735,8893,1491787,10.193198,202.73737400000002,68018.44044798567,58865.79156342431
"41.177.244.177",63123,"244.3.210.254",19813,10,760,5,374,5,386,23.426678,160.239609,18.672037573431673,19.2711403832744
"41.177.244.185",51175,"244.3.210.254",5900,1049,257919,510,35700,539,222219,0.182273,212.060646,1346.7845420031401,8383.224485697361
"41.177.244.188",52599,"244.3.210.254",19813,10,760,5,386,5,374,33.135718,160.087175,19.28949024180107,18.68981697003523
"41.177.244.197",50285,"244.3.210.197",80,116,100308,46,6429,70,93879,165.831886,10.220434000000012,5032.271623690339,73483.37653763032
"41.177.244.197",50287,"244.3.210.197",80,11,6934,6,2394,5,4540,167.069721,0.010380000000026257,1845086.705197645,3499036.6088543474
"41.177.244.197",50288,"244.3.210.197",80,77,69743,29,4249,48,65494,167.06999,15.213422000000008,2234.34280597751,34440.11478811274
"41.177.244.197",50289,"244.3.210.197",80,29,22211,13,2768,16,19443,167.070314,12.98915500000001,1704.8068176875233,11974.912917737904
"41.177.244.197",50290,"244.3.210.197",80,35,28259,15,3174,20,25085,167.070576,31.536157000000003,805.1710295582305,6363.48937506875
"41.177.244.197",50291,"244.3.210.197",80,10,5362,6,2328,4,3034,167.070862,13.729736000000003,1356.4718214538136,1767.841712324257
"41.177.244.224",63522,"244.3.210.254",19813,10,760,5,386,5,374,38.384023,160.23904700000003,19.27120797217422,18.672103061122172
"41.177.247.89",12681,"244.3.160.239",80,7,2005,3,192,4,1813,0.034007,0.010046,152896.67529364923,1443758.7099343024
"41.177.247.89",15402,"244.3.160.239",80,25,15358,8,512,17,14846,0.05624,0.14286700000000002,28670.02176849797,831318.6390139079
"41.177.247.89",6803,"244.3.160.239",80,12,3888,6,1519,6,2369,14.568028,2.5853710000000003,4700.292530549774,7330.47597424122
"41.177.247.89",11654,"244.3.160.239",80,31,17019,11,1973,20,15046,17.174161,0.4767969999999977,33104.23513570781,252451.25283925986
"41.177.247.89",5589,"244.3.160.239",80,89,59421,25,2776,64,56645,17.174675,0.5440690000000004,40818.35208401873,832909.0611668736
"41.177.247.89",11533,"244.3.160.239",80,293,204220,94,7092,199,197128,94.864002,1.7270010000000013,32852.326084350825,913157.5488375507
"41.177.247.89",11051,"244.3.160.239",80,12,2617,6,1176,6,1441,96.624373,0.2732369999999946,34431.64725128802,42190.47932747112
"41.177.247.89",11447,"244.3.160.239",80,12,3887,6,1518,6,2369,117.302847,2.2441689999999994,5411.357166060133,8444.99678945748
"41.177.247.89",9103,"244.3.160.239",80,32,17082,12,2037,20,15045,119.588382,0.47564800000000673,34260.629709364424,253044.26803013636
"41.177.247.89",13353,"244.3.160.239",80,203,138055,58,4888,145,133167,119.589793,0.7232790000000051,54064.89058855535,1472925.385639556
"41.177.247.224",4273,"244.3.160.239",80,12,3790,6,2678,6,1112,10.183727,0.11969999999999992,178980.7852965749,74319.13116123648
"41.177.247.224",6964,"244.3.160.239",80,112,74474,39,3461,73,71013,10.304072,0.6384100000000004,43370.24795977504,889873.2789273346
"41.177.253.188",3295,"41.177.98.176",80,2,128,1,64,1,64,7.188737,9.800000000037556e-5,0,0
"41.177.253.188",3298,"41.177.98.176",80,2,128,1,64,1,64,7.188777,8.300000000005525e-5,0,0
"41.194.13.186",1635,"41.177.26.46",80,284,256381,107,7625,177,248756,59.983448,0.13599699999999615,448539.306014116,14633028.669750482
"41.194.13.186",1636,"41.177.26.46",80,570,454815,218,20864,352,433951,60.116542,16.915394,9867.461556024058,205233.6469372218
"41.194.13.186",1637,"41.177.26.46",80,1399,1285355,519,38204,880,1247151,60.49183,17.059779,17915.35517546857,584838.0568118731
"41.194.123.57",50342,"41.177.98.143",8001,3,298,2,158,1,140,151.815689,0.20299199999999473,6226.846378182553,5517.458816111123
"41.194.210.239",59427,"41.177.98.143",8001,3,298,2,158,1,140,85.723583,0.20386599999999078,6200.151079631019,5493.804754103434
"41.197.164.47",1212,"244.3.41.84",23,9,4446,5,481,4,3965,75.836184,7.648983000000001,503.0734151193694,4146.956530038045
"41.203.225.103",1614,"244.3.210.197",80,59,49356,26,3574,33,45782,145.415615,47.585200999999984,600.8590780146124,7696.846757041126
"46.13.224.211",33203,"41.177.26.15",80,1,1518,0,0,1,1518,57.325682,0,0,0
"46.120.254.18",54771,"41.177.98.142",80,18,8917,9,843,9,8074,8.755282,19.081938,353.42322147781846,3384.981127179011
"46.164.57.210",54979,"41.177.26.176",80,4,280,2,140,2,140,10.045427,0.18280399999999908,6126.78059561063,6126.78059561063
"46.164.57.210",54980,"41.177.26.176",80,41,23390,13,2716,28,20674,10.885096,32.123369,676.3923173811564,5148.650504248169
"46.197.72.79",49296,"41.177.26.176",80,27,7785,14,1194,13,6591,49.076237,1.8983970000000028,5031.613513927796,27775.012286681827
"46.197.72.79",49297,"41.177.26.176",80,214,166683,84,19265,130,147418,49.086327,45.25701600000001,3405.4388384775516,26058.81041737263
"46.197.72.79",49299,"41.177.26.176",80,244,157742,102,20723,142,137019,51.204777,24.286931000000003,6826.058014493473,45133.40940442413
"47.3.161.225",1325,"244.3.41.84",23,5,320,2,128,3,192,18.489103,0.28407299999999935,3604.707240744465,5407.060861116697
"47.167.26.23",1613,"244.3.41.84",23,4,256,2,128,2,128,18.482101,0.19099900000000147,5361.284614055529,5361.284614055529
"47.167.26.139",4759,"244.3.41.84",23,4,256,2,128,2,128,18.473856,0.13613599999999693,7521.889874831221,7521.889874831221
"47.167.26.251",2688,"244.3.41.84",23,4,256,2,128,2,128,139.529621,0.12821800000000394,7986.398165623926,7986.398165623926
"47.167.92.67",4375,"244.3.41.84",23,4,838,2,201,2,637,64.488099,0.21692699999999832,7412.631899210391,23491.77373033343
"48.46.31.164",42964,"244.3.210.197",80,64,43572,28,10064,36,33508,23.397353,2.395633,33607.8188937955,111896.93913884138
"48.46.31.164",42969,"244.3.210.197",80,50,34846,21,9690,29,25156,23.864809,1.9205879999999986,40362.638941824094,104784.57639014725
"48.46.31.164",42991,"244.3.210.197",80,7,3806,4,864,3,2942,25.78604,0.18389099999999914,37587.48388991322,127988.86296773692
"48.46.31.164",42992,"244.3.210.197",80,64,44403,27,10298,37,34105,25.824824,2.8724890000000016,28680.353519195356,94983.82761430935
"48.46.31.164",42993,"244.3.210.197",80,37,26224,15,7634,22,18590,25.970556,2.716807000000003,22479.32959536689,54740.73057085021
"48.46.31.164",43001,"244.3.210.197",80,15,8506,8,1186,7,7320,28.688252,0.19272800000000245,49230.002905648784,303847.9100078829
"48.46.31.164",43004,"244.3.210.197",80,9,3357,6,1050,3,2307,28.703513,0.1196540000000006,70202.41696892673,154244.73899744186
"48.46.31.164",43005,"244.3.210.197",80,9,3224,6,1049,3,2175,28.82243,0.1194369999999978,70262.98383248202,145683.49841339217
"48.46.31.164",43006,"244.3.210.197",80,9,3591,6,1051,3,2540,28.881667,0.11464000000000141,73342.63782274857,177250.52337752748
"48.46.31.164",43007,"244.3.210.197",80,10,3282,6,1050,4,2232,28.943014,0.11645399999999739,72131.48539337583,153330.9289504903
"48.46.31.164",43008,"244.3.210.197",80,7,3288,4,917,3,2371,28.996477,0.11755700000000147,62403.770086000055,161351.51458441236
"48.46.31.164",43009,"244.3.210.197",80,10,3525,6,1050,4,2475,29.059542,0.11632999999999782,72208.3727327444,170205.45001289755
"48.46.31.164",43011,"244.3.210.197",80,10,6254,5,1603,5,4651,29.114348,0.21372699999999867,60001.77796909178,174091.24724531872
"48.46.31.164",43013,"244.3.210.197",80,84,65289,37,6601,47,58688,29.176353,6.064449000000003,8707.798515578244,77419.06972917073
"48.46.31.164",43048,"244.3.210.197",80,7,3846,4,904,3,2942,32.957516,0.17168800000000317,42122.9206467538,137085.8767065815
"48.46.31.164",43050,"244.3.210.197",80,7,3833,4,891,3,2942,33.129887,0.16065000000000396,44369.747899158574,146504.82415187938
"48.46.31.164",43051,"244.3.210.197",80,18,8999,11,2443,7,6556,33.2908,1.949577000000005,10024.738699728172,26902.24597438309
"48.46.31.164",43737,"244.3.210.197",80,70,51799,29,9566,41,42233,134.492583,1.9382360000000176,39483.32401214264,174315.20207033455
"48.46.31.164",43739,"244.3.210.197",80,50,28383,25,10514,25,17869,134.889306,1.5598190000000045,53924.20530843627,91646.53078337909
"48.46.31.164",43742,"244.3.210.197",80,67,44601,29,10431,38,34170,136.453696,5.958933000000002,14003.849346854542,45873.98448682002
"48.46.31.164",43741,"244.3.210.197",80,7,3806,4,864,3,2942,136.454214,0.11494799999999827,60131.53773880454,204753.45373560526
"48.46.31.164",43743,"244.3.210.197",80,45,30856,19,7889,26,22967,136.570735,5.830514999999991,10824.4297459144,31512.825196402082
"48.46.31.164",43761,"244.3.210.197",80,7,3860,4,918,3,2942,142.401799,0.11832199999997783,62067.91636383239,198914.82564531034
"48.46.31.164",43762,"244.3.210.197",80,9,3357,6,1050,3,2307,142.413315,0.11605999999997607,72376.35705670973,159021.19593317082
"48.46.31.164",43763,"244.3.210.197",80,9,3218,5,979,4,2239,142.52038,0.11488100000002532,68174.89402075429,155917.8628319396
"48.46.31.164",43764,"244.3.210.197",80,7,3457,4,917,3,2540,142.530968,0.11418299999999704,64247.74265871619,177959.94149742543
"48.46.31.164",43765,"244.3.210.197",80,11,4391,6,1685,5,2706,142.635474,0.17212200000000166,78316.54291723236,125771.25527242184
"48.46.31.164",43766,"244.3.210.197",80,9,3212,5,980,4,2232,142.64613,0.1149509999999907,68202.97344086293,155335.7517551082
"48.46.31.164",43767,"244.3.210.197",80,7,3327,4,916,3,2411,142.761178,0.11549800000000232,63446.98609499604,166998.5627456719
"48.46.31.164",43768,"244.3.210.197",80,48,38711,19,3213,29,35498,142.808854,1.1424519999999916,22498.975886952092,248574.11952537356
"48.46.31.164",43769,"244.3.210.197",80,7,3837,4,895,3,2942,142.878062,0.11595800000000622,61746.49442039028,202970.04087685831
"48.46.31.164",43772,"244.3.210.197",80,7,3846,4,904,3,2942,143.876729,0.11523399999998674,62759.255080972915,204245.27483210433
"48.46.31.164",43774,"244.3.210.197",80,7,3855,4,913,3,2942,143.959912,0.11585399999998458,63044.86681513778,203152.24334078352
"48.46.31.164",43775,"244.3.210.197",80,9,3317,6,1043,3,2274,143.992161,0.11571599999999194,72107.57371496233,157212.48574096293
"48.46.31.164",43776,"244.3.210.197",80,9,3314,6,1044,3,2270,144.077034,0.11436299999999733,73030.61304792804,158792.61649310024
"48.46.31.164",43779,"244.3.210.197",80,9,3426,5,974,4,2452,144.107881,0.11460500000001161,67990.052790011,171161.8166746478
"48.46.31.164",43781,"244.3.210.197",80,10,3261,6,1043,4,2218,144.192372,0.1144869999999969,72881.6372164545,154987.02909501063
"48.46.31.164",43782,"244.3.210.197",80,9,3565,6,1044,3,2521,144.222897,0.12339200000002393,67686.72199168811,163446.57676345378
"48.46.31.164",43785,"244.3.210.197",80,8,3163,5,903,3,2260,144.307528,0.11630600000000868,62112.0148573544,155451.9973174097
"48.46.31.164",43788,"244.3.210.197",80,35,27595,15,1539,20,26056,144.347854,0.429901000000001,28639.151804717767,484874.42457682005
"48.142.4.64",48769,"41.177.26.176",80,10,2197,5,1120,5,1077,95.707797,15.104433,593.2033330877101,570.428562263807
"48.142.83.204",32844,"244.3.210.197",80,14,7904,7,1017,7,6887,186.319431,0.35387899999997785,22990.909322114363,155691.63471130937
"48.142.224.41",5717,"244.3.160.239",80,70,45561,29,3054,41,42507,63.279533,0.2774000000000001,88074.98197548663,1225868.781542898
"48.142.224.41",14472,"244.3.160.239",80,110,69874,45,4643,65,65231,81.877605,3.194673999999992,11626.851440866922,163349.37461537588
"48.142.224.41",6672,"244.3.160.239",80,105,68753,42,4450,63,64303,114.273288,1.5839169999999996,22475.92519052451,324779.644387932
"48.244.75.47",14422,"244.3.210.197",80,1,64,1,64,0,0,56.465429,0,0,0
"48.244.75.47",14421,"244.3.210.197",80,1,64,1,64,0,0,61.465434,0,0,0
"55.161.39.39",39349,"41.177.26.176",80,19,9298,10,1742,9,7556,63.963057,21.568689,646.1217925669938,2802.581093361771
"55.161.39.98",24671,"41.177.26.176",80,4,256,2,128,2,128,0.215386,55.627486999999995,18.408165732886694,18.408165732886694
"55.161.39.98",39829,"41.177.26.176",80,21,8342,11,1458,10,6884,73.103816,70.750776,164.86038259142202,778.3942892725304
"57.136.253.249",56748,"41.177.26.91",80,390,429006,109,8273,281,420733,130.028403,0.5064820000000054,130673.94300290887,6645574.76869852
"57.136.253.249",56748,"41.177.26.91",8000,2,134,1,64,1,70,160.434762,0.03769399999998768,13583.063617556303,14856.475831702208
"66.82.230.128",49435,"41.177.98.142",80,18,8966,9,835,9,8131,46.330389,21.389888999999997,312.2970857866537,3041.0629994386604
"66.202.163.48",2650,"244.3.61.16",445,2,132,2,132,0,0,11.064297,2.873309000000001,367.5205138048152,0
"67.2.177.254",13992,"41.177.26.91",8000,2,128,0,0,2,128,9.812619,60.01075,0,17.0636094366426
"67.2.177.254",14324,"41.177.26.91",8000,1,64,1,64,0,0,9.974658,0,0,0
"67.2.177.254",14386,"41.177.26.91",8000,1,64,1,64,0,0,69.973615,0,0,0
"67.37.0.145",4349,"244.3.61.118",445,2,132,2,132,0,0,67.881478,2.920158999999998,361.6241444387106,0
"67.72.176.186",1259,"41.177.26.91",80,49,34325,24,3302,25,31023,104.007729,50.20894800000001,526.1213598819078,4943.023303336289
"67.72.176.186",1260,"41.177.26.91",80,41,27844,19,2819,22,25025,105.326381,48.89029099999999,461.27767985672256,4094.882560629472
"67.90.149.197",1641,"244.3.31.244",445,2,132,2,132,0,0,180.294252,2.8421789999999874,371.5459160031809,0
"67.91.230.210",53893,"41.177.98.57",25,20,2332,9,1383,11,949,157.002162,15.742214999999987,702.8235861344804,482.27012526509174
"67.249.18.71",3435,"244.3.31.40",445,2,132,2,132,0,0,22.213199,2.9497180000000007,358.00032409877815,0
"68.33.164.161",11522,"244.3.160.239",80,1806,1598144,664,46540,1142,1551604,1.065433,180.586213,2061.7299284082114,68736.32152638363
"68.33.164.161",8821,"244.3.160.239",80,18,5279,10,4323,8,956,200.623434,0.5968509999999867,57944.11000400564,12813.918381639924
"68.33.164.161",7024,"244.3.160.239",80,14,2042,8,1051,6,991,201.685553,0.6598879999999951,12741.5561428607,12014.159978663134
"68.33.164.161",2821,"244.3.160.239",80,23,10909,11,1381,12,9528,202.317423,1.0680270000000007,10344.3077749907,71368.98224483084
"68.33.164.161",4462,"244.3.160.239",80,14,5029,8,4034,6,995,202.321594,0.04634300000000735,696372.6992209153,171762.7257622238
"68.33.164.161",13354,"244.3.160.239",80,270,252248,92,7224,178,245024,203.337532,9.549915999999996,6051.571553090103,205257.51221267294
"68.33.164.254",2898,"244.3.160.239",80,13,4595,6,1434,7,3161,43.551766,0.0933470000000014,122896.29018607805,270903.1891758666
"68.33.164.254",3370,"244.3.160.239",80,64,48203,18,4686,46,43517,43.645057,2.380735999999999,15746.391032016998,146230.40941960813
"68.33.164.254",5759,"244.3.160.239",80,13,3545,6,1131,7,2414,45.976795,0.22405299999999784,40383.302165113106,86193.8916238577
"68.33.164.254",8560,"244.3.160.239",80,14,4803,6,1124,8,3679,45.9768,0.22901600000000144,39263.63223530209,128515.03825060176
"68.33.164.254",7381,"244.3.160.239",80,16,7424,7,1178,9,6246,45.976828,0.22899300000000267,41154.096413427,218207.54346202468
"68.33.164.254",9685,"244.3.160.239",80,17,8688,7,1177,10,7511,45.976833,0.22914200000000307,41092.423038988374,262230.40734565986
"68.33.164.254",5047,"244.3.160.239",80,32,20715,11,1371,21,19344,45.998869,0.1435770000000005,76391.06542134158,1077832.8005181851
"68.33.164.254",6862,"244.3.160.239",80,23,14485,9,1307,14,13178,46.107263,0.19538199999999506,53515.67698150426,539578.8762526879
"68.33.164.254",7217,"244.3.160.239",80,12,2506,6,1117,6,1389,46.285514,0.23207800000000134,38504.29596945832,47880.45398529777
"68.33.164.254",14893,"244.3.160.239",80,12,3079,6,1037,6,2042,46.426821,0.23357700000000392,35517.19561429362,69938.39290683469
"68.33.164.254",11999,"244.3.160.239",80,10,2233,5,1273,5,960,54.629732,1.3529340000000047,7527.344275478305,5676.551849535877
"68.33.164.254",6351,"244.3.160.239",80,10,2051,5,1115,5,936,55.98267,0.0437300000000036,203978.96181109687,171232.56345756652
"68.33.164.254",7394,"244.3.160.239",80,10,2019,5,1098,5,921,56.062469,0.23344099999999912,37628.35148924153,31562.578981412982
"68.33.164.254",7119,"244.3.160.239",80,10,2114,5,1184,5,930,56.295861,0.2006979999999956,47195.288443333804,37070.623523902395
"68.33.164.254",6161,"244.3.160.239",80,10,2225,5,1132,5,1093,56.528568,0.36854999999999905,24571.97123863797,23725.41039207712
"68.33.164.254",15800,"244.3.160.239",80,44,31903,14,1790,30,30113,56.901425,0.4633039999999937,30908.431612937064,519969.60958680103
"68.33.164.254",7487,"244.3.160.239",80,144,119965,34,3019,110,116946,57.360356,0.4162210000000002,58026.865535376615,2247767.4120238996
"68.33.164.254",6135,"244.3.160.239",80,15,6538,6,1226,9,5312,57.364497,0.18331100000000333,53504.69966341257,231824.60408813015
"68.33.164.254",13098,"244.3.160.239",80,11,3291,5,1169,6,2122,57.364501,0.12315900000000113,75934.36127282548,137838.07923091162
"68.33.164.254",15594,"244.3.160.239",80,115,92652,26,2512,89,90140,57.364506,0.3922489999999996,51232.76286236553,1838424.0622665721
"68.33.164.254",16077,"244.3.160.239",80,165,134660,39,3344,126,131316,57.487602,0.4350329999999971,61494.18549857178,2414823.703029441
"68.33.164.254",5099,"244.3.160.239",80,20,9794,8,1351,12,8443,57.804452,0.17948200000000014,60217.737711859634,376327.4311630133
"68.33.164.254",4160,"244.3.160.239",80,43,28363,13,1681,30,26682,57.812436,0.24819899999999961,54182.32950173055,860019.5810619717
"68.33.164.254",9308,"244.3.160.239",80,10,2897,5,1160,5,1737,57.828715,0.12439200000000028,74602.86835166231,111711.36407485987
"68.33.164.254",3693,"244.3.160.239",80,13,4621,6,1204,7,3417,57.828724,0.08244499999999988,116829.40141912807,331566.4988780404
"68.33.164.254",5102,"244.3.160.239",80,18,9911,7,1291,11,8620,57.962976,0.17012400000000127,60708.65956596319,405351.39075027325
"68.33.164.254",15730,"244.3.160.239",80,17,7649,7,1291,10,6358,57.967284,0.15525699999999887,66521.96036249622,327611.6374785058
"68.33.164.254",10758,"244.3.160.239",80,11,3584,5,1166,6,2418,57.986598,0.13193199999999905,70703.08947033371,146620.98656883955
"68.33.164.254",8796,"244.3.160.239",80,12,3356,5,1145,7,2211,58.068402,0.18027500000000174,50811.260574122374,98116.76605186427
"68.33.164.254",2133,"244.3.160.239",80,13,3473,6,1262,7,2211,58.118674,0.12989100000000064,77726.70931781224,136175.71656234775
"68.33.164.254",11722,"244.3.160.239",80,12,2426,6,1219,6,1207,58.12249,0.12608000000000175,77347.71573603954,76586.2944162426
"68.33.164.254",2193,"244.3.160.239",80,10,2865,5,1189,5,1676,58.164484,0.12150599999999656,78284.19995720597,110348.46015834922
"68.33.164.254",4546,"244.3.160.239",80,12,1887,6,1209,6,678,58.262412,0.13630300000000517,70959.55334805274,39793.69492967722
"68.33.164.254",10780,"244.3.160.239",80,11,1824,5,1163,6,661,58.266285,0.13267199999999946,70127.83405692263,39857.69416304889
"68.33.164.254",9200,"244.3.160.239",80,11,2598,5,1155,6,1443,58.271155,0.12780699999999712,72296.509580854,90323.6911906254
"68.33.164.254",9160,"244.3.160.239",80,11,2012,5,1152,6,860,58.320709,0.15795099999999707,58347.20894454718,43557.81223290848
"68.33.164.254",9821,"244.3.160.239",80,10,2292,5,1170,5,1122,58.398814,0.1276679999999999,73315.1611993609,70307.35971425891
"68.33.164.254",10579,"244.3.160.239",80,11,2354,5,1158,6,1196,58.404486,0.15067300000000472,61484.14115335667,63501.75545718012
"68.33.164.254",14295,"244.3.160.239",80,18,7587,8,1345,10,6242,58.408551,0.2120959999999954,50731.74411587316,235440.55522028272
"68.33.164.254",4577,"244.3.160.239",80,11,1830,5,1152,6,678,58.484362,0.1403230000000022,65677.04510308258,38653.67758671006
"68.33.164.254",3062,"244.3.160.239",80,11,2606,5,1154,6,1452,58.526521,0.16822399999999504,54879.20867415037,69050.78942362768
"68.33.164.254",10727,"244.3.160.239",80,10,1968,5,1166,5,802,58.555007,0.12631700000000023,73845.95897622633,50792.84656855362
"68.33.164.254",15747,"244.3.160.239",80,11,1920,5,1152,6,768,58.585373,0.19717299999999938,46740.6795048005,31160.453003200335
"68.33.164.254",2233,"244.3.160.239",80,10,2648,5,1171,5,1477,58.893608,0.18039600000000178,51930.19800882452,65500.34368832947
"68.33.164.254",15348,"244.3.160.239",80,10,2233,5,1273,5,960,86.507456,0.39307499999999607,25908.54162691624,19538.256058004394
"68.33.164.254",10610,"244.3.160.239",80,10,2051,5,1115,5,936,86.904363,0.05745000000000289,155265.44821583206,130339.4255874608
"68.33.164.254",14841,"244.3.160.239",80,10,2066,5,1145,5,921,86.964345,0.10772599999999954,85030.54044520394,68395.74475985399
"68.33.164.254",5041,"244.3.160.239",80,10,2161,5,1231,5,930,87.076324,0.23625499999999988,41683.77388838334,31491.397007470758
"68.33.164.254",9083,"244.3.160.239",80,10,2205,5,1151,5,1054,87.312501,0.4079399999999964,22571.946854929844,20669.706329362343
"68.33.164.254",7933,"244.3.160.239",80,44,31897,13,1726,31,30171,87.724477,0.5617380000000054,24580.85441967584,429680.740843592
"68.33.164.254",13584,"244.3.160.239",80,13,5334,7,4076,6,1258,96.290319,0.23822900000000402,136876.70266843855,42245.06672151514
"68.33.164.254",7462,"244.3.160.239",80,240,199208,53,4504,187,194704,96.53238,1.678687999999994,21464.38170761936,927886.539964547
"68.33.164.254",9777,"244.3.160.239",80,10,1705,5,1300,5,405,97.789627,0.12702600000000075,81873.00237746554,25506.58920221042
"68.33.164.254",10118,"244.3.160.239",80,10,1704,5,1299,5,405,97.789632,0.13092500000000484,79373.68722550785,24746.992552987438
"68.33.164.254",3773,"244.3.160.239",80,9,1647,4,1242,5,405,97.789672,0.15091600000000938,65837.9495878461,21468.896604732425
"68.33.164.254",8760,"244.3.160.239",80,10,1827,5,1305,5,522,97.794114,0.14651000000000636,71257.93461196878,28503.173844787514
"68.33.164.254",15243,"244.3.160.239",80,38,24370,12,1694,26,22676,97.828885,0.23416299999999524,57874.2158240212,774708.2160717265
"68.33.164.254",14318,"244.3.160.239",80,12,2992,6,1276,6,1716,97.970347,0.2440950000000015,41819.78328109931,56240.39820561632
"68.33.164.254",14111,"244.3.160.239",80,10,1687,5,1282,5,405,97.970414,0.1524789999999996,67261.72128621009,21248.827707422064
"68.33.164.254",14083,"244.3.160.239",80,12,1956,6,1268,6,688,97.970419,0.24402800000000013,41569.000278656524,22554.78879472846
"68.33.164.254",3568,"244.3.160.239",80,10,1747,5,1277,5,470,98.090666,0.1828919999999954,55858.10204929826,20558.581020493486
"68.33.164.254",7716,"244.3.160.239",80,60,44887,17,2001,43,42886,98.211044,0.34246500000000424,46743.46283561766,1001819.1640021484
"68.33.164.254",8525,"244.3.160.239",80,24,13144,9,1483,15,11661,98.268736,0.1901900000000012,62379.72553761988,490498.97470949794
"68.33.164.254",16281,"244.3.160.239",80,11,3125,5,1220,6,1905,98.273563,0.11519800000000657,84723.69311966738,132293.96343685768
"68.33.164.254",12059,"244.3.160.239",80,9,1647,4,1242,5,405,98.278736,0.11011900000001162,90229.66063984373,29422.715426035997
"68.33.164.254",13486,"244.3.160.239",80,17,7993,8,1415,9,6578,98.388689,0.27774800000000255,40756.3690827653,189466.7108313994
"68.33.164.254",15640,"244.3.160.239",80,13,4312,6,1294,7,3018,98.393756,0.14761900000000594,70126.47423434371,163556.18179231012
"68.33.164.254",16290,"244.3.160.239",80,10,2441,5,1242,5,1199,98.458875,0.11892799999999681,83546.34736983945,80653.84097941828
"68.33.164.254",6840,"244.3.160.239",80,12,3816,5,1243,7,2573,98.541322,0.11714500000000783,84886.25208074895,175713.85889281338
"68.33.164.254",10920,"244.3.160.239",80,12,3832,5,1226,7,2606,98.572335,0.15627400000001046,62761.559824406766,133406.70872953022
"68.33.164.254",7392,"244.3.160.239",80,12,2957,6,1285,6,1672,98.629783,0.2249970000000019,45689.49808219627,59449.68155130908
"68.33.164.254",2314,"244.3.160.239",80,10,1697,5,1292,5,405,98.658403,0.1121649999999903,92149.95765168185,28886.01613694361
"68.33.164.254",16092,"244.3.160.239",80,12,4092,5,1248,7,2844,98.866816,0.12978499999999826,76927.22579651064,175305.3126324329
"68.33.164.254",15685,"244.3.160.239",80,10,1687,5,1282,5,405,98.894453,0.11002500000000737,93215.17836854636,29447.852760734226
"68.33.164.254",4853,"244.3.160.239",80,10,1705,5,1300,5,405,98.902159,0.15068999999999733,69015.86037560678,21501.094963169802
"68.33.164.254",14623,"244.3.160.239",80,9,1633,4,1228,5,405,98.902164,0.14689199999999403,66879.06761430438,22057.02148517368
"68.33.164.254",9642,"244.3.160.239",80,9,1630,4,1225,5,405,99.000394,0.11004800000000614,89052.05001453414,29441.69816807047
"68.33.164.254",4279,"244.3.160.239",80,10,1700,5,1295,5,405,99.004437,0.11007299999999987,94119.3571538889,29435.01131067568
"68.33.164.254",4514,"244.3.160.239",80,9,1631,4,1226,5,405,99.052731,0.10814400000001001,90693.88962863489,29960.053262314137
"68.33.164.254",15000,"244.3.160.239",80,12,1954,6,1276,6,678,99.052744,0.3108139999999935,32842.79343916366,17450.95137284715
"68.33.164.254",9806,"244.3.160.239",80,12,1958,6,1278,6,680,99.110388,0.25316100000000574,40385.36741441126,21488.301910641356
"68.33.164.254",8360,"244.3.160.239",80,12,2061,6,1275,6,786,99.114565,0.24898899999999458,40965.66514986695,25254.127692388567
"68.33.164.254",3564,"244.3.160.239",80,12,2018,6,1282,6,736,99.165578,0.3129590000000064,32771.06585846641,18813.966046670263
"68.33.164.254",12590,"244.3.160.239",80,10,1694,5,1289,5,405,99.254435,0.11325399999999775,91051.97167429146,28608.261076872026
"68.33.164.254",4021,"244.3.160.239",80,10,1696,5,1291,5,405,99.254506,0.11325799999998765,91190.02631161707,28607.25070194029
"68.33.164.254",15918,"244.3.160.239",80,12,2727,6,1269,6,1458,99.25451,0.3259740000000022,31143.588138931114,35781.99488302724
"68.33.164.254",13096,"244.3.160.239",80,12,2075,6,1278,6,797,99.36757,0.3201839999999976,31931.639307398487,19913.549708917522
"68.33.164.254",9750,"244.3.160.239",80,12,1956,6,1278,6,678,99.367582,0.32017600000000357,31932.437159561883,16940.682624556306
"68.33.164.254",12824,"244.3.160.239",80,12,2733,6,1269,6,1464,99.372158,0.3182560000000052,31898.84872555375,36800.563068723946
"68.33.164.254",11108,"244.3.160.239",80,12,2079,6,1278,6,801,99.482395,0.3162900000000093,32324.765247082425,20259.888077396732
"68.33.164.254",9679,"244.3.160.239",80,12,2064,6,1278,6,786,99.584611,0.26988500000000215,37882.801934156836,23298.81245715749
"68.33.164.254",8785,"244.3.160.239",80,12,2987,6,1282,6,1705,99.584615,0.2698859999999996,38001.230149025934,50539.85756949237
"68.33.164.254",8561,"244.3.160.239",80,12,2730,6,1278,6,1452,99.69456,0.2556900000000013,39985.92045054538,45430.01290625343
"68.33.164.254",15801,"244.3.160.239",80,12,2018,6,1277,6,741,99.802833,0.2556079999999952,39967.450158055275,23191.762386154234
"68.33.164.254",7919,"244.3.160.239",80,12,2016,6,1277,6,739,99.806733,0.2517130000000094,40585.90537635966,23487.06661952215
"68.33.164.254",4191,"244.3.160.239",80,12,2561,6,1282,6,1279,99.810376,0.2524659999999983,40623.29184919977,40528.22954378043
"68.33.164.254",4280,"244.3.160.239",80,12,2191,6,1282,6,909,99.854762,0.2120610000000056,48363.442594346576,34292.01974903357
"68.33.164.254",11893,"244.3.160.239",80,13,3662,6,1279,7,2383,99.954696,0.22626599999999542,45221.111435214334,84254.81512909755
"68.33.164.254",6217,"244.3.160.239",80,12,2076,6,1276,6,800,99.959963,0.30244100000000174,33752.03758749621,21161.152092474113
"68.33.164.254",13455,"244.3.160.239",80,13,3761,6,1281,7,2480,99.964195,0.29821400000000153,34364.583822355584,66529.40505811229
"68.33.164.254",14910,"244.3.160.239",80,12,2275,6,1282,6,993,100.066733,0.3169369999999958,32359.743419039543,25064.918264513468
"68.33.164.254",11308,"244.3.160.239",80,12,2829,6,1270,6,1559,100.066738,0.31693599999999833,32056.945250776353,39351.79342201601
"68.33.164.254",2827,"244.3.160.239",80,13,4044,6,1276,7,2768,100.18589,0.2924019999999956,34910.84192310638,75731.35614667593
"68.33.164.254",11581,"244.3.160.239",80,12,2923,6,1278,6,1645,100.185898,0.2923990000000032,34965.91985608668,45006.9938679676
"68.33.164.254",15771,"244.3.160.239",80,9,1630,4,1225,5,405,100.266598,0.12220200000000148,80195.08682345528,26513.477684489295
"68.33.164.254",5235,"244.3.160.239",80,12,2789,6,1019,6,1770,100.388733,0.2696189999999916,30235.257900964894,52518.55395947778
"68.33.194.117",8886,"244.3.160.239",80,13,2029,7,1106,6,923,154.701112,0.053998000000007096,163857.92066370675,136745.80540018203
"68.33.194.117",8724,"244.3.160.239",80,15,2241,8,1137,7,1104,154.754987,0.061463000000003376,147991.4745456535,143696.20747440762
"68.33.214.48",7961,"244.3.160.239",80,12,3535,5,817,7,2718,32.958346,0.299906,21793.495295192493,72502.71751815568
"68.33.214.48",11019,"244.3.160.239",80,10,1498,5,940,5,558,33.26212,0.03624699999999592,207465.44541619573,123155.01972578427
"68.33.214.48",9717,"244.3.160.239",80,10,2823,5,1054,5,1769,33.335354,0.5869730000000004,14365.226339201283,24110.137945016195
"68.33.214.48",7626,"244.3.160.239",80,10,2276,5,1130,5,1146,33.954392,0.046244000000001506,195484.81965227285,198252.74630221655
"68.33.214.48",6704,"244.3.160.239",80,16,6106,7,1199,9,4907,34.008685,0.08955199999999763,107110.95229587561,438359.83562623995
"68.33.214.48",4079,"244.3.160.239",80,12,3698,5,970,7,2728,34.140689,0.3101429999999965,25020.716250246136,70367.54013471285
"68.33.214.48",15352,"244.3.160.239",80,10,2837,5,1062,5,1775,34.505506,0.3006780000000049,28256.14112106593,47226.601214587594
"68.33.214.48",15610,"244.3.160.239",80,10,2290,5,1138,5,1152,34.845146,0.03513300000000186,259129.5932598844,262317.47929295857
"68.33.214.48",13395,"244.3.160.239",80,55,38358,19,1975,36,36383,34.884139,0.268258000000003,58898.523063617205,1085015.1719613087
"68.33.214.48",6276,"244.3.160.239",80,10,1478,5,922,5,556,35.15234,0.05002599999999546,147443.32946868966,88913.76484229008
"68.33.214.48",2319,"244.3.160.239",80,10,1465,5,909,5,556,35.160246,0.038094999999998436,190891.19306996453,116760.72975456576
"68.33.214.48",3125,"244.3.160.239",80,10,1465,5,909,5,556,35.175947,0.03436299999999903,211622.9665628788,129441.55050490717
"68.33.214.48",7589,"244.3.160.239",80,10,1467,5,911,5,556,35.175951,0.04230400000000145,172276.8532526416,105143.72163388444
"68.33.214.48",10038,"244.3.160.239",80,12,3535,5,817,7,2718,35.665187,0.2934589999999986,22272.276536074995,74095.52952882722
"68.33.214.48",5975,"244.3.160.239",80,10,1498,5,940,5,558,35.97023,0.03603299999999621,208697.58277137045,123886.43743236671
"68.33.214.48",4066,"244.3.160.239",80,10,2823,5,1054,5,1769,36.043509,0.6067699999999974,13896.534106828018,23323.49984343336
"68.33.214.48",15797,"244.3.160.239",80,10,1298,5,810,5,488,36.340125,0.04854100000000017,133495.39564491826,80426.85564780261
"68.33.214.48",15916,"244.3.160.239",80,10,2276,5,1130,5,1146,36.987133,0.03784999999999883,238837.51651255693,242219.28665786746
"68.33.214.48",8992,"244.3.160.239",80,15,6042,6,1135,9,4907,37.024857,0.07744000000000284,117252.06611569818,506921.4876032872
"68.33.214.48",11189,"244.3.160.239",80,12,3698,5,970,7,2728,37.140256,0.29024599999999623,26735.94123605528,75191.3893731534
"68.33.214.48",4733,"244.3.160.239",80,10,2837,5,1062,5,1775,37.456294,0.29597100000000154,28705.515067354423,47977.6734882807
"68.33.214.48",14133,"244.3.160.239",80,15,5788,6,881,9,4907,37.486258,0.07212499999999977,97719.23743500897,544277.296360487
"68.33.214.48",12157,"244.3.160.239",80,10,1498,5,940,5,558,37.562123,0.03647800000000245,206151.65305114025,122375.13021546412
"68.33.214.48",11121,"244.3.160.239",80,12,3681,5,953,7,2728,37.618184,0.30221199999999726,25227.323865366263,72214.20724524572
"68.33.214.48",11004,"244.3.160.239",80,10,2290,5,1138,5,1152,37.764544,0.03567600000000226,255185.55891914517,258324.92431885345
"68.33.214.48",10308,"244.3.160.239",80,55,38358,19,1975,36,36383,37.804686,0.2679380000000009,58968.86593167056,1086311.0122490989
"68.33.214.48",12358,"244.3.160.239",80,10,2837,5,1062,5,1775,37.949003,0.6080120000000022,13973.408419570615,23354.802207851077
"68.33.214.48",2404,"244.3.160.239",80,10,2290,5,1138,5,1152,38.573185,0.03715099999999438,245053.96893761613,248068.6926328065
"68.33.214.48",8746,"244.3.160.239",80,54,38294,18,1911,36,36383,38.614101,0.28056800000000237,54489.464229704994,1037409.8257819763
"68.33.214.48",3064,"244.3.160.239",80,10,1298,5,810,5,488,39.994485,0.03430800000000289,188877.22980061368,113792.70141074009
"68.33.214.48",2932,"244.3.160.239",80,15,5788,6,881,9,4907,41.398948,0.08178200000000402,86180.33308062475,480007.82568288955
"68.33.214.48",15060,"244.3.160.239",80,10,1498,5,940,5,558,41.492848,0.03584199999999527,209809.7204397353,124546.62128231097
"68.33.214.48",2703,"244.3.160.239",80,12,3681,5,953,7,2728,41.564268,0.6363270000000014,11981.26120689517,34296.83166045123
"68.33.214.48",11618,"244.3.160.239",80,10,2837,5,1062,5,1775,42.244812,0.2854159999999979,29767.07682820887,49751.94102643196
"68.33.214.48",2933,"244.3.160.239",80,10,2290,5,1138,5,1152,42.550107,0.04021500000000344,226383.19035183938,229168.2208131098
"68.33.214.48",4519,"244.3.160.239",80,53,38230,17,1847,36,36383,42.598188,0.2560799999999972,57700.71852546142,1136613.5582630553
"68.33.214.48",2407,"244.3.160.239",80,10,1298,5,810,5,488,44.562582,0.03204099999999954,202240.87887394565,121843.88751911787
"68.33.214.48",3185,"244.3.160.239",80,12,3535,5,817,7,2718,46.604304,0.6721730000000008,9723.687205525946,32348.814962814595
"68.33.214.48",6063,"244.3.160.239",80,10,1498,5,940,5,558,47.282158,0.0344649999999973,218192.36907008817,129522.70419266935
"68.33.214.48",4210,"244.3.160.239",80,10,2823,5,1054,5,1769,47.340181,0.29508099999999615,28575.204774282687,47959.71275683688
"68.33.214.48",14565,"244.3.160.239",80,10,2276,5,1130,5,1146,47.658231,0.08619499999999647,104878.47322930994,106363.47815999044
"68.33.214.48",2348,"244.3.160.239",80,15,6042,6,1135,9,4907,47.748897,0.07008499999999884,129556.96654063137,560119.8544624477
"68.33.214.48",6169,"244.3.160.239",80,12,3698,5,970,7,2728,47.846077,0.6503650000000007,11931.761395524038,33556.541326793376
"68.33.214.48",7147,"244.3.160.239",80,12,3535,5,817,7,2718,48.459003,0.6514809999999969,10032.525891008381,33376.26116494588
"68.33.214.48",12679,"244.3.160.239",80,10,2837,5,1062,5,1775,48.540099,0.2885380000000026,29444.995113295034,49213.62177598746
"68.33.214.48",14402,"244.3.160.239",80,10,2290,5,1138,5,1152,48.855229,0.08726099999999803,104330.68610261405,105614.19190703989
"68.33.214.48",8133,"244.3.160.239",80,55,38358,19,1975,36,36383,48.946278,0.262515999999998,60186.80766124778,1108747.6572856598
"68.33.214.48",13289,"244.3.160.239",80,10,1498,5,940,5,558,49.116209,0.03406700000000029,220741.4800246554,131035.8998444231
"68.33.214.48",14416,"244.3.160.239",80,10,2823,5,1054,5,1769,49.170217,0.6122359999999958,13772.466826517973,23115.26927524696
"68.33.214.48",9868,"244.3.160.239",80,10,2276,5,1130,5,1146,49.812789,0.033414999999997974,270537.18389946275,274367.7988927295
"68.33.214.48",4735,"244.3.160.239",80,15,6042,6,1135,9,4907,49.857762,0.07658500000000146,118561.0759287044,512580.79258339433
"68.33.214.48",9465,"244.3.160.239",80,12,3698,5,970,7,2728,49.954846,0.6100389999999933,12720.498197656354,35774.76194145004
"68.33.214.48",3519,"244.3.160.239",80,10,1298,5,810,5,488,50.345495,0.030776000000003023,210553.67819077734,126852.09253962882
"68.33.214.48",8484,"244.3.160.239",80,10,2837,5,1062,5,1775,51.238086,0.5884,14439.15703602991,24133.242692046224
"68.33.214.48",8932,"244.3.160.239",80,10,2290,5,1138,5,1152,52.080314,0.04600899999999797,197874.32893565178,200308.63526702183
"68.33.214.48",7894,"244.3.160.239",80,55,38358,19,1975,36,36383,52.126267,0.2610430000000008,60526.42668066162,1115004.0414797529
"68.33.214.48",3209,"244.3.160.239",80,10,1298,5,810,5,488,54.320408,0.03974099999999936,163055.7862157496,98236.07860899481
"68.41.105.164",50754,"41.177.98.176",80,214,179415,81,10949,133,168466,52.382558,30.909188,2833.8499219067157,43602.8277417058
"68.55.106.246",2693,"41.177.98.142",80,18,8986,9,840,9,8146,10.41217,19.363899,347.0375465189113,3365.4379213607754
"68.67.211.164",18085,"244.3.210.197",80,15,9045,8,944,7,8101,128.515168,60.38654300000002,125.06097591975083,1073.2192435655736
"68.67.211.164",18086,"244.3.210.197",80,12,2834,7,1709,5,1125,128.515606,65.38576,209.09751603407224,137.64464923249344
"68.80.156.163",3677,"41.177.98.127",210,14,1161,7,629,7,532,21.249625,1.5012439999999998,3351.8868351846872,2834.9821881053317
"68.80.156.163",3693,"41.177.98.127",210,14,1181,7,649,7,532,107.471879,1.5723059999999975,3302.156196058533,2706.852228510231
"68.83.39.204",1338,"244.3.210.197",80,330,322531,121,21017,209,301514,109.527175,65.087323,2583.2372918456026,37059.6283396077
"68.83.39.204",1339,"244.3.210.197",80,333,314760,126,25588,207,289172,110.008652,64.60592000000001,3168.502205370653,35807.49256414892
"68.122.18.43",45820,"41.177.26.176",80,11,5008,5,851,6,4157,18.088141,4.393630999999999,1549.5156511778075,7569.138145647645
"68.122.18.43",1675,"41.177.26.176",80,46,30264,18,2156,28,28108,22.305626,20.24318,852.0400450917297,11108.136172281233
"68.122.18.43",25099,"41.177.26.176",80,59,47631,22,1860,37,45771,26.622752,15.926375,934.2992363296732,22991.295884970685
"68.122.18.43",27779,"41.177.26.176",80,19,5397,9,1991,10,3406,26.623232,15.925502999999999,1000.1567925358465,1710.9663663370634
"68.122.18.43",10838,"41.177.26.176",80,45,14581,18,2553,27,12028,26.623656,30.926204000000002,660.4108283059893,3111.406753961786
"68.122.18.43",31263,"41.177.26.176",80,18,5190,9,1544,9,3646,26.62371,15.924968000000003,775.6373513591988,1831.589237730336
"68.122.18.43",28944,"41.177.26.176",80,46,14902,11,2081,35,12821,26.623871,0.43168700000000015,38564.97879250474,237598.07453085214
"68.122.18.43",61862,"41.177.26.176",80,37,23975,15,1848,22,22127,108.684047,23.86692699999999,619.4345841004167,7416.790607353853
"68.122.18.43",48952,"41.177.26.176",80,130,113498,46,3900,84,109598,109.454418,23.096362999999997,1350.8620383217915,37961.994275895304
"68.122.18.43",44321,"41.177.26.176",80,527,486504,176,19580,351,466924,154.579777,52.96935499999998,2957.1815628111776,70519.86946037009
"68.122.18.43",20265,"41.177.26.176",80,161,136040,58,7608,103,128432,165.636729,41.912739999999985,1452.1598921950706,24514.1692001048
"68.122.18.43",36909,"41.177.26.176",80,149,127106,53,7496,96,119610,165.636789,41.912435000000016,1430.792555956245,22830.455925550486
"68.122.18.43",65458,"41.177.26.176",80,127,104430,46,6796,81,97634,165.636933,41.912262,1297.1860120553742,18635.882739996236
"68.122.18.43",37903,"41.177.26.176",80,276,252258,91,11252,185,241006,165.682922,41.86662000000001,2150.0660908379987,46052.15324284596
"68.122.18.43",4538,"41.177.26.176",80,344,308659,119,13127,225,295532,165.683754,41.86562700000002,2508.4062398014476,56472.48517262142
"68.122.18.43",8253,"41.177.26.15",80,182,164056,63,5029,119,159027,165.925506,26.62435499999998,1511.0976397362501,47783.918145622716
"68.122.18.43",33150,"41.177.26.15",80,198,175655,68,6469,130,169186,165.925511,26.62453099999999,1943.7713287794636,50836.12552649286
"68.122.18.43",2128,"41.177.26.15",80,95,86541,31,2472,64,84069,165.925516,26.624229000000014,742.7820726752309,25260.900512837372
"68.122.18.43",46909,"41.177.26.15",80,269,242142,94,8555,175,233587,165.925519,26.624256000000003,2570.5882635743883,70187.72656032153
"68.122.18.43",16073,"41.177.26.15",80,62,53863,20,1754,42,52109,165.925542,26.624539,527.0325995128029,15657.435420759773
"68.122.18.43",25306,"41.177.26.15",80,53,43992,18,1644,35,42348,165.925968,26.624021999999997,493.9899764205424,12724.749100643023
"68.157.15.43",36447,"41.177.26.46",80,17,7271,9,966,8,6305,153.177453,6.565912999999995,1176.987876628887,7682.099960812768
"68.157.15.122",53682,"41.177.26.46",80,15,1957,8,1123,7,834,25.237361,6.903654000000003,1301.3398411913454,966.4447262275886
"68.157.15.122",37983,"41.177.26.46",80,11,1280,6,749,5,531,143.473295,6.380866999999995,939.0573412672611,665.7402512856016
"68.157.145.13",51014,"244.3.210.255",443,30,21694,13,1516,17,20178,210.612057,1.235322999999994,9817.675215308109,130673.51615731334
"68.157.145.118",49569,"244.3.210.255",80,31,17734,16,1465,15,16269,125.02371,6.893649000000011,1700.1155701428927,18879.986491914486
"68.157.168.13",63960,"41.177.26.176",80,77,26207,39,3422,38,22785,50.655181,11.474491999999998,2385.8136813377014,15885.670581320726
"68.157.168.23",36268,"41.177.26.176",80,77,26526,39,3439,38,23087,43.932454,10.323566,2664.970611899028,17890.717219224443
"68.157.168.23",34105,"41.177.26.176",80,47,15479,23,1939,24,13540,61.253579,6.3877489999999995,2428.398485914209,16957.46028843651
"68.157.168.23",46511,"41.177.26.176",80,69,26806,35,3465,34,23341,81.253754,17.188519999999997,1612.7042933306652,10863.529844337967
"68.157.168.23",44194,"41.177.26.176",80,35,13421,18,1614,17,11807,149.22267,7.120350000000002,1813.394004508205,13265.64003174001
"68.157.168.23",53956,"41.177.26.176",80,29,13504,15,1446,14,12058,159.892417,7.056978000000015,1639.2285763112732,13669.307173693867
"68.157.168.23",40528,"41.177.26.176",80,33,13158,17,1544,16,11614,203.877507,6.80306299999998,1815.6527434774653,13657.377566546167
"68.157.168.38",33092,"41.177.26.91",80,4,280,2,140,2,140,2.13711,0.04243500000000022,26393.307411334845,26393.307411334845
"68.157.168.38",63851,"41.177.26.91",80,25,13267,13,1172,12,12095,4.210418,5.429386,1726.8987690320785,17821.536357886507
"68.157.168.38",50017,"41.177.26.91",80,25,13425,13,1172,12,12253,12.045949,5.531175000000001,1695.1190298625515,17722.093406916247
"68.157.168.38",64467,"41.177.26.91",80,25,13533,13,1172,12,12361,19.36996,5.390420000000002,1739.3820889652375,18345.138226705887
"68.157.168.38",62574,"41.177.26.91",80,31,17434,16,1392,15,16042,26.949694,5.656970999999999,1968.544650485216,22686.345749341835
"68.157.168.38",34501,"41.177.26.91",80,27,14988,14,1242,13,13746,42.328592,5.685491999999996,1747.606011933533,19341.861706955187
"68.157.168.38",37070,"41.177.26.91",80,29,16245,15,1311,14,14934,49.700026,5.370061,1953.0504402091524,22247.791971078168
"68.157.168.38",57038,"41.177.26.91",80,27,14555,14,1242,13,13313,64.874276,5.785054000000002,1717.5293437191763,18410.199801073588
"68.157.168.38",50689,"41.177.26.91",80,27,14111,14,1242,13,12869,72.454559,5.730423999999999,1733.9031108343818,17965.86081588378
"68.157.168.38",59220,"41.177.26.91",80,25,12413,13,1172,12,11241,133.113151,5.74386800000002,1632.3494899255984,15656.348648680589
"68.157.168.38",37568,"41.177.26.91",80,25,13452,13,1172,12,12280,155.867313,5.986329000000012,1566.2353338748974,16410.725170634592
"68.157.168.38",51432,"41.177.26.91",80,49,30637,25,2266,24,28371,171.280847,13.026224000000013,1391.6542506869205,17423.9288377046
"68.157.168.38",56559,"41.177.26.91",80,27,14890,14,1242,13,13648,186.330893,5.639417000000009,1761.8842515103927,19360.866557660098
"68.157.168.38",54343,"41.177.26.91",80,27,15126,14,1242,13,13884,193.852995,5.497738999999996,1807.288414382714,20203.214448703384
"68.157.168.38",60928,"41.177.26.91",80,21,12226,11,1032,10,11194,208.992926,0.22899499999999762,36053.188934256585,391065.3071027792
"68.157.168.39",34491,"41.177.26.176",80,77,27225,39,3481,38,23744,58.596012,10.564483999999993,2636.0019097951226,17980.24399487946
"68.157.168.39",53690,"41.177.26.176",80,228,89058,114,10462,114,78596,177.221207,29.993104000000017,2790.5081114645536,20963.752201172632
"68.157.168.41",64111,"41.177.26.176",80,70,26203,35,3185,35,23018,33.275028,8.069226,3157.6758415243294,22820.52826380126
"68.157.168.41",8377,"244.3.160.239",80,10,1469,5,556,5,913,70.15855,0.08707899999998858,51080.05374430785,83877.85803696595
"68.157.168.41",37168,"41.177.26.176",80,35,12541,18,1619,17,10922,106.57577,7.096210999999997,1825.199391618993,12313.049879717506
"68.157.168.41",14787,"244.3.160.239",80,10,1469,5,556,5,913,129.811778,0.087569000000002,50794.23083511172,83408.51214470684
"68.157.168.41",32900,"41.177.26.176",80,166,60721,82,7705,84,53016,146.140717,24.982473,2467.3297955730804,16977.022250759564
"68.157.168.41",42732,"41.177.26.176",80,43,16793,22,1897,21,14896,181.212986,7.166913999999991,2117.5083166897243,16627.51918050086
"68.157.168.43",59093,"41.177.26.176",80,37,15343,19,1707,18,13636,9.276973,6.063337000000001,2252.2251360925507,17991.412979354434
"68.157.168.43",56137,"41.177.26.176",80,33,12784,17,1546,16,11238,98.573708,7.099361999999999,1742.128377169667,12663.67315823591
"68.157.168.43",50324,"41.177.26.176",80,33,12315,17,1552,16,10763,197.205682,6.235631000000012,1991.1377052298278,13808.386031822574
"68.157.168.46",60298,"41.177.98.79",80,16,6814,9,911,7,5903,63.303842,5.53147899999999,1317.5499717164275,8537.318861736632
"68.157.168.46",61995,"41.177.98.79",80,14,4670,8,892,6,3778,71.977627,5.624905999999996,1268.6434226634196,5373.2453484556045
"68.157.168.51",36320,"41.177.26.176",80,58,24734,29,2756,29,21978,2.617737,9.964559,2212.641823888042,17644.93541560645
"68.157.168.51",36511,"41.177.26.176",80,46,13381,23,1975,23,11406,3.948543,5.949509,2655.6813343756603,15337.063949310776
"68.157.168.51",44012,"41.177.26.176",80,29,12826,15,1423,14,11403,22.607242,6.585936,1728.5318290369053,13851.334115606345
"68.157.168.51",37195,"41.177.26.176",80,103,40048,52,4700,51,35348,70.58613,14.518590000000003,2589.7831676491996,19477.37349150296
"68.157.168.51",51158,"41.177.26.176",80,40,13256,20,1724,20,11532,85.248303,6.278946999999988,2196.5466502583995,14692.909495811986
"68.157.168.51",59416,"41.177.26.176",80,95,42144,48,4827,47,37317,134.563248,16.848263000000003,2291.987013735481,17719.096621414323
"68.157.168.51",60083,"41.177.26.176",80,33,12953,17,1517,16,11436,166.558388,6.760828000000004,1795.046405558608,13532.07033221374
"68.157.168.51",33322,"41.177.26.176",80,98,37566,47,4393,51,33173,189.217549,13.025644999999997,2698.0621688983547,20373.962287472143
"68.157.168.82",48489,"244.3.210.197",80,56,40708,27,2227,29,38481,0.47326,5.868676000000001,3035.778427706692,52456.12468638582
"68.157.168.82",51190,"244.3.210.197",80,25,13523,13,1228,12,12295,22.008132,5.884775999999999,1669.3923439056987,16714.315039348996
"68.157.168.82",37091,"244.3.210.197",80,23,12129,12,1215,11,10914,109.933071,6.233737000000005,1559.2573122671026,14006.365684019062
"68.157.168.82",57371,"244.3.210.197",80,29,15667,15,1430,14,14237,197.844714,6.088160999999985,1879.0567463639723,18707.783844743968
"68.157.168.98",58775,"41.177.26.176",80,103,46814,51,4660,52,42154,1.576837,18.178496,2050.774717556392,18551.149666066984
"68.157.168.98",56091,"41.177.26.176",80,35,13280,18,1636,17,11644,30.605834,6.310094999999997,2074.136760223104,14762.376794644146
"68.157.168.98",53484,"41.177.26.176",80,101,41162,51,4687,50,36475,63.922808,12.213719999999995,3069.9901422334897,23891.165017701413
"68.157.168.98",41912,"41.177.26.176",80,33,12319,17,1551,16,10768,126.564043,6.0917460000000005,2036.8544584754518,14141.101746527185
"68.157.168.98",34133,"41.177.26.176",80,35,13262,18,1632,17,11630,133.238092,6.590666999999996,1980.9831083864512,14116.93232263139
"68.157.168.98",48921,"41.177.26.176",80,35,13251,18,1617,17,11634,142.566793,7.182085999999998,1801.1480230116993,12958.90915257768
"68.157.168.98",39553,"41.177.26.176",80,35,13249,18,1617,17,11632,154.554568,7.167337000000003,1804.854438963871,12983.343743987474
"68.157.168.98",40744,"41.177.26.176",80,66,24411,33,3031,33,21380,191.875751,12.65440799999999,1916.170238860642,13516.238768340656
"68.157.168.106",57789,"41.177.26.176",80,35,13199,18,1632,17,11567,110.574358,6.591949999999997,1980.5975470080941,14037.72783470749
"68.157.168.106",53627,"41.177.26.176",80,39,14676,20,1759,19,12917,147.897083,7.0735540000000015,1989.3818581154533,14608.780819373116
"68.157.168.106",37850,"41.177.26.176",80,35,13237,18,1617,17,11620,158.557445,7.305023000000006,1770.8363135886075,12725.490392022028
"68.157.168.106",48806,"41.177.26.176",80,75,26926,38,3381,37,23545,169.220092,9.838951000000009,2749.0735546909395,19144.31731594149
"68.157.168.106",56666,"41.177.26.176",80,69,26373,35,3172,34,23201,201.211682,10.481979999999993,2420.9166588755193,17707.341551882386
"68.157.168.110",61097,"41.177.26.176",80,17,8985,9,907,8,8078,209.206846,2.9552559999999914,2455.2864455735885,21867.47950092993
"68.157.168.111",38042,"41.177.26.176",80,151,66922,76,7257,75,59665,35.93616,23.612656,2458.681479965659,20214.583230281252
"68.157.168.111",48170,"41.177.26.176",80,34,10939,17,1469,17,9470,99.909934,8.642393999999996,1359.8084049396505,8766.089581197066
"68.157.168.111",59570,"41.177.26.176",80,42,12967,20,1761,22,11206,101.248214,6.393491999999995,2203.4906745797152,14021.758375548146
"68.157.168.111",45928,"41.177.26.176",80,21,9676,11,1052,10,8624,174.556297,8.706615,966.6213562905906,7924.089901758606
"68.157.168.121",54062,"41.177.26.176",80,35,12475,18,1621,17,10854,57.260004,6.254405999999996,2073.418323019006,13883.332805705299
"68.157.168.121",38365,"41.177.26.176",80,105,38794,53,4822,52,33972,65.262514,14.673817,2628.9001696014066,18521.15233548299
"68.157.168.121",61825,"41.177.26.176",80,69,26328,35,3156,34,23172,105.24117,9.823465999999996,2570.1722793156723,18870.73259071697
"68.157.168.121",60348,"41.177.26.176",80,34,12375,17,1548,17,10827,173.214215,6.407847000000004,1932.6304139284214,13517.176674162156
"68.157.168.121",51187,"41.177.26.176",80,17,8981,9,907,8,8074,207.871894,2.9393230000000017,2468.5956596127735,21975.128286343475
"68.157.168.121",49546,"41.177.26.176",80,31,12537,16,1472,15,11065,210.540802,1.5445169999999848,7624.39001966318,57312.41546710128
"68.157.168.135",54806,"244.3.210.197",80,86,59313,44,3328,42,55985,32.002514,5.377934000000003,4950.599988768919,83281.05179423915
"68.157.168.139",54396,"41.177.26.176",80,21,8166,11,1143,10,7023,37.364486,6.205330000000004,1473.571913177864,9054.151833987873
"68.157.168.139",41558,"41.177.26.176",80,35,13190,18,1640,17,11550,86.586832,6.531041000000002,2008.8681115307645,14147.82115132947
"68.157.168.142",10862,"244.3.160.239",80,10,1448,5,549,5,899,198.373009,0.0876790000000085,50091.81217850995,82026.48296626676
"68.157.168.142",5732,"244.3.160.239",80,10,1619,5,606,5,1013,205.256679,0.08615299999999593,56271.98124267558,94065.20956902699
"68.157.168.142",4420,"244.3.160.239",80,10,1544,5,581,5,963,209.38766,0.08786999999998102,52896.32411518157,87674.97439401006
"68.157.168.156",60605,"41.177.26.176",80,4,280,2,140,2,140,1.23282,0.04277500000000001,26183.51841028638,26183.51841028638
"68.157.168.156",60190,"41.177.26.176",80,4,280,2,140,2,140,2.35503,0.04302899999999976,26028.957214901722,26028.957214901722
"68.157.168.156",52872,"41.177.26.176",80,73,26100,37,3340,36,22760,17.280326,9.448817000000002,2827.8672345966693,19270.137203419217
"68.157.168.156",49787,"41.177.26.176",80,70,25571,34,3083,36,22488,83.923408,10.862255000000005,2270.6150794655427,16562.30681382456
"68.157.168.156",46521,"41.177.26.176",80,34,12339,17,1548,17,10791,121.240302,6.471361000000002,1913.6623656136626,13340.006839365007
"68.157.168.156",56666,"41.177.26.176",80,34,12804,17,1543,17,11261,130.567645,7.023464999999987,1757.5370561396721,12826.717296946757
"68.157.168.156",43486,"41.177.26.176",80,35,12546,18,1621,17,10925,139.89335,6.431158000000011,2016.4331213756493,13590.087508346063
"68.157.168.156",33184,"41.177.26.176",80,31,12560,16,1494,15,11066,206.54596,6.092089999999985,1961.8882846445194,14531.630360024265
"68.157.168.160",61203,"41.177.26.176",80,39,13610,20,1805,19,11805,21.271797,6.119605,2359.629420526325,15432.36859241732
"68.157.168.160",41196,"41.177.26.176",80,5,716,3,564,2,152,211.869196,0.043302000000011276,104198.42039625942,28081.84379473658
"68.157.168.164",52083,"41.177.26.176",80,39,14931,20,1760,19,13171,11.944643,7.114734000000002,1978.99176553895,14809.829854496313
"68.157.168.164",62602,"41.177.26.176",80,35,13303,18,1634,17,11669,29.271607,6.400864000000002,2042.2242997195372,14584.281122048518
"68.157.168.164",45330,"41.177.26.176",80,72,25605,36,3227,36,22378,54.596599,12.002801000000005,2150.83129346225,14915.185213851328
"68.157.168.164",38758,"41.177.26.176",80,67,26360,34,3127,33,23233,74.592223,8.012744999999995,3122.0262219751176,23196.04579953563
"68.157.168.164",52629,"41.177.26.176",80,27,11916,14,1342,13,10574,95.906992,6.301074,1703.8365205677635,13425.012942238101
"68.157.168.164",42884,"41.177.26.176",80,33,12109,17,1552,16,10557,135.893388,6.529323000000005,1901.5754006962115,12934.878547132672
"68.157.168.192",40107,"41.177.26.176",80,103,45670,52,4736,51,40934,5.275722,15.712943999999998,2411.2604232535928,20840.906707234495
"68.157.168.192",59893,"41.177.26.176",80,68,26187,34,3102,34,23085,27.938806,10.400615000000002,2386.0127502075593,17756.642275480823
"68.157.168.192",50000,"41.177.26.176",80,74,25818,37,3301,37,22517,118.571216,11.996120000000005,2201.3784456974413,15016.188567636864
"68.157.168.192",39112,"41.177.26.176",80,44,13172,21,1842,23,11330,155.886513,6.591973999999993,2235.445710192427,13750.054232616829
"68.157.168.192",62543,"41.177.26.176",80,101,37359,50,4557,51,32802,167.888467,15.145722000000006,2407.016317875106,17326.080592262282
"68.157.168.192",53004,"41.177.26.176",80,37,13390,19,1702,18,11688,202.538229,6.548194999999993,2079.35163812318,14279.354845113821
"68.157.168.194",47365,"41.177.26.91",80,4470,3606691,2101,195185,2369,3411506,0.304103,211.775541,7373.278295627161,128872.52168558975
"68.157.168.194",45416,"41.177.26.91",80,87,63324,42,3645,45,59679,39.943392,10.096998999999997,2887.9868166769165,47284.544645394155
"68.157.168.194",41140,"41.177.26.91",80,33,19779,17,1539,16,18240,57.285066,5.615482,2192.5099216772487,25985.30277543406
"68.157.168.194",57101,"41.177.26.91",80,59,39460,30,2781,29,36679,82.232258,7.123526999999996,3123.171990504144,41191.954491082884
"68.157.168.194",58454,"41.177.26.91",80,58,41255,28,2315,30,38940,111.082429,6.088967999999994,3041.566321255099,51161.379071133284
"68.157.168.194",37033,"41.177.26.91",80,124,88975,61,5317,63,83658,117.950881,13.772552000000005,3088.4617462326505,48594.04415390843
"68.157.168.194",33478,"41.177.26.91",80,35,20416,18,1617,17,18799,140.104436,5.6770779999999945,2278.6370030498106,26491.09277695324
"68.157.168.194",62105,"41.177.26.91",80,58,39310,29,2385,29,36925,156.828996,7.807630000000017,2443.763344318309,37834.78469138514
"68.157.168.194",36876,"41.177.26.91",80,61,39728,31,2874,30,36854,174.003436,7.286788999999999,3155.299268305972,40461.16883582056
"68.157.168.197",57255,"41.177.26.176",80,41,18673,21,1853,20,16820,26.608348,6.098013000000002,2430.9557883854945,22066.204188151118
"68.157.168.197",38727,"41.177.26.176",80,39,14954,20,1779,19,13175,71.926951,6.370038999999991,2234.2092411051203,16546.209528701496
"68.157.168.197",43881,"41.177.26.176",80,31,13619,16,1492,15,12127,91.913328,5.841876999999997,2043.1789303335224,16606.991211899884
"68.157.168.197",36621,"41.177.26.176",80,201,84762,100,9098,101,75664,111.911509,26.578501000000017,2738.4539105497315,22774.497327746198
"68.157.168.197",56964,"41.177.26.176",80,31,15015,16,1399,15,13616,113.246103,8.644302999999994,1294.7255550852403,12601.13163548294
"68.157.168.197",58669,"41.177.26.176",80,77,25117,39,3455,38,21662,178.547814,12.368074000000007,2234.786111402631,14011.559115833224
"68.157.168.197",56961,"41.177.26.176",80,35,13287,18,1632,17,11655,185.217951,6.3698909999999955,2049.642607699254,14637.613108293386
"68.157.168.203",52086,"41.177.26.176",80,121,50757,59,5234,62,45523,38.605081,10.030504,4174.466208278268,36307.64715312411
"68.157.168.203",42798,"41.177.26.176",80,39,16378,20,1811,19,14567,49.263534,6.084980000000002,2380.9445552820216,19151.41873925633
"68.157.168.204",45131,"41.177.26.176",80,20,7460,10,700,10,6760,0.566419,5.408734,1035.3624341666646,9998.642935666647
"68.157.168.204",37531,"41.177.26.176",80,37,13976,19,1723,18,12253,25.270015,6.7616080000000025,2038.5683405485788,14497.143283077037
"68.157.168.204",43877,"41.177.26.176",80,35,13166,18,1640,17,11526,79.919195,6.487625999999992,2022.3113971119817,14212.903148239451
"68.157.168.204",42220,"41.177.26.176",80,35,12410,18,1610,17,10800,97.241401,6.785482000000002,1898.1702405223382,12733.067451951089
"68.157.168.204",34030,"41.177.26.176",80,33,12382,17,1554,16,10828,127.898958,6.52677700000001,1904.7686170371658,13272.094327720997
"68.157.168.204",46781,"41.177.26.176",80,75,27750,38,3362,37,24388,137.233214,14.26377500000001,1885.6158345178596,13678.286428382378
"68.157.168.204",57685,"41.177.26.176",80,44,13082,21,1820,23,11262,187.883201,6.278798999999992,2318.9148115746366,14349.240993381076
"68.157.168.209",35997,"41.177.26.176",80,99,40605,50,4571,49,36034,15.947393,15.215770999999998,2403.2958960804553,18945.60584540869
"68.157.168.209",57448,"41.177.26.176",80,38,14633,19,1690,19,12943,45.261712,7.230072,1869.9675466579033,14321.295832185351
"68.157.168.209",54241,"41.177.26.176",80,74,26594,37,3298,37,23296,89.247079,12.664708000000005,2083.2695076743967,14715.538644870448
"68.157.168.209",58712,"41.177.26.176",80,42,12944,20,1759,22,11185,151.892315,6.45189400000001,2181.0649709992103,13868.795736569737
"68.157.168.224",52941,"41.177.26.15",80,520,513510,165,12157,355,501353,0.356552,14.059318,6917.5474941245375,285278.70270805457
"68.157.168.224",57041,"41.177.26.15",80,45,27436,23,1940,22,25496,17.655885,5.7920729999999985,2679.524239421707,35215.02577747208
"68.157.168.224",58288,"41.177.26.15",80,58,38493,29,2359,29,36134,26.532747,5.810783999999998,3247.754519872018,49747.50395127406
"68.157.168.224",53071,"41.177.26.15",80,105,90592,39,3324,66,87268,34.386187,7.053972999999999,3769.7904429177715,98971.74259101928
"68.157.168.224",64902,"41.177.26.15",80,158,148332,54,4110,104,144222,44.299939,8.301034000000001,3960.952334371838,138991.84125736624
"68.157.168.224",47602,"41.177.26.15",80,95,74105,42,3329,53,70776,53.177307,5.804143000000003,4588.446563084332,97552.38628682989
"68.157.168.224",55786,"41.177.26.15",80,741,689376,266,20135,475,669241,62.071654,16.638350999999993,9681.247859237978,321782.36893788347
"68.157.168.224",56073,"41.177.26.15",80,399,410951,115,8381,284,402570,79.833653,6.692374999999998,10018.565905227966,481228.26350884413
"68.157.168.224",53272,"41.177.26.15",80,479,462789,156,11854,323,450935,88.717695,14.823185999999993,6397.545035190144,243367.3840428098
"68.157.168.224",57126,"41.177.26.15",80,1022,1016396,324,23385,698,993011,106.478993,16.427730999999994,11388.060834451213,483577.9207731124
"68.157.168.224",56410,"41.177.26.15",80,37,20577,19,1559,18,19018,125.014802,5.91233299999999,2109.488758498552,25733.327266918197
"68.157.168.224",40681,"41.177.26.15",80,180,164138,65,4880,115,159258,131.844022,6.195065999999997,6301.789198048902,205657.8573981295
"68.157.168.224",52261,"41.177.26.15",80,879,884626,271,19624,608,865002,138.279875,13.249902999999989,11848.539570440638,522269.18189514335
"68.157.168.224",45101,"41.177.26.15",80,11,1273,6,708,5,565,151.891352,5.578638999999981,1015.3014023671399,810.233463753438
"68.157.168.224",62691,"41.177.26.15",80,2629,2425223,980,69947,1649,2355276,157.519571,19.90250899999998,28115.852126985625,946725.2596142535
"68.157.168.224",38694,"41.177.26.15",80,15,3003,8,1233,7,1770,177.536139,8.642207000000013,1141.3751140189056,1638.4703583239766
"68.157.168.224",63325,"41.177.26.15",80,262,249357,89,6561,173,242796,186.416984,6.020900999999981,8717.632128480467,322604.20824059495
"68.157.168.224",36670,"41.177.26.15",80,190,171828,70,5230,120,166598,195.302357,5.790642999999989,7225.4497471179075,230161.6590765486
"68.157.168.224",52151,"41.177.26.15",80,330,301759,120,8943,210,292816,204.191818,8.684195999999986,8238.413780619429,269746.0996965066
"68.157.168.224",64140,"41.177.26.15",80,2,160,1,78,1,82,213.070516,0.00034099999999170905,0,0
"68.157.168.253",38395,"41.177.26.176",80,35,13427,18,1664,17,11763,82.584385,6.256903000000008,2127.570141330301,15040.028589223753
"68.157.168.253",56907,"41.177.26.176",80,228,85649,114,10398,114,75251,93.247842,38.786117000000004,2144.68491393454,15521.22374095865
"68.157.168.253",55049,"41.177.26.176",80,37,14602,19,1686,18,12916,153.228559,7.087574000000018,1903.048913492821,14578.754310007873
"68.157.168.253",52758,"41.177.26.176",80,94,31789,42,3933,52,27856,163.88793,7.3472369999999785,4282.4261691844285,30330.857708823147
"68.157.168.254",52323,"244.3.210.197",443,34,20289,15,1989,19,18300,30.464466,5.824680000000001,2731.823894188178,25134.42798574342
"68.157.168.254",51950,"244.3.210.197",443,34,21710,15,1626,19,20084,63.316355,6.217581999999993,2092.131635738783,25841.557055459853
"68.157.168.254",41680,"244.3.210.197",443,29,16741,13,1484,16,15257,96.223819,5.866945999999999,2023.540015537897,20804.009445459364
"68.157.168.254",45990,"244.3.210.197",443,31,18610,14,1604,17,17006,129.091636,5.863555000000019,2188.433467410122,23202.306450608812
"68.157.168.254",47132,"244.3.210.197",443,32,20937,14,1533,18,19404,161.945549,5.997137000000009,2044.9757942831689,25884.351149556824
"68.157.168.254",43006,"244.3.210.197",443,32,19922,14,1616,18,18306,194.869121,6.3179250000000025,2046.2414479437466,23179.76234285781
"68.159.161.155",53734,"41.177.26.91",80,1370,1437046,427,27629,943,1409417,12.20768,2.5746769999999994,85848.43846432,4379320.59050514
"68.176.57.177",51848,"41.177.26.176",80,217,171256,70,9748,147,161508,115.435095,39.375128000000004,1980.5395934204962,32814.21713727508
"68.176.57.177",51850,"41.177.26.176",80,67,48388,25,6777,42,41611,116.187568,22.803352999999987,2377.5450917240123,14598.204044817452
"68.176.57.177",51849,"41.177.26.176",80,108,49634,47,7935,61,41699,116.187973,5.378735000000006,11802.031518563366,62020.53084972575
"68.176.57.177",51851,"41.177.26.176",80,58,45058,21,4783,37,40275,117.658886,21.37221199999999,1790.3621768303635,15075.650569066045
"68.176.57.177",51852,"41.177.26.176",80,58,43780,21,4778,37,39002,117.665846,21.406091999999987,1785.6598953232576,14576.037513059375
"68.176.57.177",51853,"41.177.26.176",80,62,45437,23,4937,39,40500,117.666279,21.324591999999996,1852.1339118703893,15193.725629076518
"68.210.71.0",45172,"244.3.210.197",80,1,64,1,64,0,0,47.95321,0,0,0
"68.210.71.0",14603,"244.3.210.197",80,1,64,1,64,0,0,47.953435,0,0,0
"71.161.57.144",57429,"41.177.26.91",8000,1,70,0,0,1,70,22.812858,0,0,0
"71.161.57.144",37884,"41.177.26.91",8000,3,210,0,0,3,210,23.692767,120.021657,0,13.997473805914877
"71.161.57.144",45431,"41.177.26.91",8000,3,210,0,0,3,210,53.423243,120.02155800000001,0,13.997485351756556
"75.13.211.68",21460,"41.177.26.91",80,106,90606,40,3279,66,87327,190.547771,4.186165999999986,6266.354463726496,166886.83630797305
"77.55.145.124",40084,"244.3.210.197",80,306,236875,116,17216,190,219659,91.218644,113.346737,1215.1033514092248,15503.507613104028
"77.71.145.77",53612,"41.177.26.176",80,10,2145,6,1153,4,992,6.012383,29.494804000000002,312.7330495228922,269.06434095985173
"77.71.145.77",53613,"41.177.26.176",80,54,27925,24,6086,30,21839,6.052787,29.454164999999996,1653.0090056873114,5931.656864148076
"77.71.145.77",53614,"41.177.26.176",80,96,64325,29,3599,67,60726,6.632676,0.22185200000000016,129780.2138362511,2189784.180444619
"77.84.188.198",12009,"41.177.98.127",210,14,1238,7,653,7,585,58.02962,1.8037409999999952,2896.2029470971797,2594.6075406613327
"77.139.113.224",2179,"41.177.241.46",443,44,3506,22,1909,22,1597,1.997121,208.42216000000002,73.27435815846069,61.29866421113762
"77.161.130.31",61473,"41.177.98.127",210,16,2537,8,727,8,1810,114.778221,1.7060809999999975,3408.9823402288685,8487.287532069124
"77.164.201.106",56112,"244.3.210.197",80,735,887348,165,49475,570,837873,42.825625,97.356124,4065.4864197346233,68850.15266219925
"77.164.201.106",56162,"244.3.210.197",80,75,66774,30,10395,45,56379,93.737647,62.558417000000006,1329.3175241310853,7209.773226838523
"77.164.201.106",56164,"244.3.210.197",80,4,268,3,198,1,70,94.637447,0.08001700000001222,19795.793393900774,6998.512816025525
"77.164.201.106",56166,"244.3.210.197",80,4,268,3,198,1,70,94.641659,0.08004599999999584,19788.621542614026,6995.977313045362
"77.164.201.106",56165,"244.3.210.197",80,4,268,3,198,1,70,94.641664,0.08004899999998827,19787.879923549728,6995.7151244872775
"77.164.201.106",56167,"244.3.210.197",80,37,29550,17,8664,20,20886,94.645654,61.650392999999994,1124.2750715311743,2710.2503628808986
"77.164.201.106",56168,"244.3.210.197",80,39,31638,18,8718,21,22920,94.645659,61.65044500000002,1131.2813719349467,2974.187777557809
"77.164.201.106",56169,"244.3.210.197",80,30,22197,15,9628,15,12569,94.649898,61.646197000000015,1249.4525818032212,1631.114405970574
"77.164.201.106",56172,"244.3.210.197",80,60,53186,25,10279,35,42907,94.649902,61.646197,1333.9346788902485,5568.161812155257
"77.164.201.106",56174,"244.3.210.197",80,33,25618,17,9658,16,15960,94.649906,61.64614999999999,1253.3467215714202,2071.1755721971285
"77.164.201.106",56175,"244.3.210.197",80,44,39778,18,5531,26,34247,94.64991,61.646142,717.7740336126793,4444.333272307616
"77.164.201.106",56171,"244.3.210.197",80,28,22957,14,7365,14,15592,94.649914,61.646146000000016,955.7775112170027,2023.419274256009
"77.164.201.106",56173,"244.3.210.197",80,32,25778,15,7516,17,18262,94.650108,61.646163999999985,975.3729364247225,2369.912262505093
"77.164.201.106",56170,"244.3.210.197",80,36,29344,17,7551,19,21793,94.650116,61.646152,979.9151778362419,2828.1408383770654
"77.164.201.106",56267,"244.3.210.197",80,89,83533,32,8057,57,75476,168.679866,29.650069000000002,2173.8903879110703,20364.472001734634
"77.164.201.106",56282,"244.3.210.197",80,16,12064,8,2755,8,9309,183.489875,6.687584999999984,3295.659045828958,11135.858460116795
"77.164.201.106",56284,"244.3.210.197",80,15,10633,8,3918,7,6715,183.48988,14.844900999999993,2111.432066808665,3618.7509771873874
"77.164.201.106",56283,"244.3.210.197",80,28,24743,12,2919,16,21824,183.490075,7.086613,3295.2272122098384,24636.87518988267
"77.164.201.106",56285,"244.3.210.197",80,41,37983,16,3170,25,34813,183.490079,6.977619000000004,3634.4776061862913,39913.9018625121
"77.164.201.106",56286,"244.3.210.197",80,11,6928,6,2625,5,4303,183.496699,6.658608999999984,3153.811854698188,5169.848537434783
"77.164.201.106",56287,"244.3.210.197",80,11,7014,6,2624,5,4390,183.496871,6.670636999999999,3146.925848311039,5264.864509941105
"77.164.201.106",56288,"244.3.210.197",80,30,26305,12,3102,18,23203,183.505547,14.644015999999993,1694.617105034576,12675.757797587772
"77.197.13.176",62071,"41.177.26.176",80,22,12780,9,871,13,11909,81.877777,0.4750280000000089,14668.609008310814,200560.8090470419
"77.197.13.176",64355,"41.177.26.176",80,11,4731,5,605,6,4126,84.242441,0.6605969999999957,7326.705994729058,49966.923858267925
"77.197.13.176",3716,"41.177.26.176",80,13,4998,6,697,7,4301,90.43857,0.5560100000000006,10028.596607974667,61883.77906872172
"77.197.106.40",49142,"244.3.210.197",80,10,4324,6,632,4,3692,123.826513,0.2586549999999903,19547.273395063654,114190.71736483388
"77.197.106.40",49163,"244.3.210.197",80,10,3926,6,634,4,3292,124.475159,0.24620299999999418,20600.886260525338,106968.63969976248
"77.197.106.128",41432,"41.177.26.91",80,24,19633,9,901,15,18732,1.3376299999999999,0.7169370000000002,10053.882000789468,209022.5500985442
"77.197.106.128",41554,"41.177.26.91",80,22,16539,9,908,13,15631,2.823998,0.38926499999999997,18660.809474265603,321241.3137579798
"77.197.106.128",41880,"41.177.26.91",80,22,17431,9,899,13,16532,6.178109,0.41135900000000003,17483.51196886418,321509.921990281
"77.197.106.128",41899,"41.177.26.91",80,26,20156,11,1026,15,19130,6.604057,0.5215730000000001,15737.01092656253,293420.0965157322
"77.197.106.128",41923,"41.177.26.91",80,24,18569,10,970,14,17599,7.797091,0.4261239999999997,18210.66168533104,330401.4793815887
"77.197.106.128",42891,"41.177.26.91",80,38,32904,14,1260,24,31644,71.495714,1.0949649999999878,9205.773700529344,231196.43093615124
"77.197.106.128",43966,"41.177.26.91",80,25,20544,10,960,15,19584,111.99581,0.5367929999999888,14307.19104012191,291866.697218487
"77.197.106.128",44062,"41.177.26.91",80,24,20029,9,898,15,19131,112.880363,0.5312139999999914,13523.739961672916,288109.87662223226
"77.197.106.128",44633,"41.177.26.91",80,22,17426,9,907,13,16519,141.563448,0.417018000000013,17399.728548887037,316897.5919504575
"77.197.106.128",44679,"41.177.26.91",80,23,17835,9,900,14,16935,142.039553,0.5559480000000008,12950.851518487323,243691.8560728698
"77.197.106.128",45391,"41.177.26.91",80,48,43330,17,1404,31,41926,201.69027,1.552932999999996,7232.765354332756,215983.56142860051
"77.197.127.51",41939,"41.177.26.176",80,21,13278,9,887,12,12391,51.446847,0.5356200000000015,13248.198349576154,185071.50591837443
"77.197.127.51",42370,"41.177.26.176",80,19,12518,7,759,12,11759,52.002973,0.6911190000000005,8785.751802511573,136115.48807079523
"77.197.127.51",42530,"41.177.26.176",80,20,12676,8,816,12,11860,52.813224,0.5671409999999995,11510.365147291426,167295.25814568176
"77.197.127.51",42584,"41.177.26.176",80,20,12813,9,872,11,11941,53.421907,0.6102200000000053,11431.942578086491,156546.81917996652
"77.197.127.51",42632,"41.177.26.176",80,21,12931,8,808,13,12123,54.234551,0.6003819999999962,10766.478675243496,161537.15467818925
"77.197.127.51",45106,"41.177.26.15",80,191,190913,58,4014,133,186899,83.151518,1.022974000000005,31390.82713734645,1461612.905117816
"77.197.127.110",49917,"41.177.26.176",80,20,12796,8,808,12,11988,171.960045,0.606047999999987,10665.82184909469,158244.89149374646
"77.197.127.110",50267,"41.177.26.15",80,119,112366,40,2863,79,109503,172.278029,1.0514239999999972,21783.790364305987,833178.6225157522
"77.197.127.117",33098,"41.177.26.176",80,20,12063,8,816,12,11247,21.656985,0.5835800000000013,11186.12700915039,154179.37557832652
"77.197.127.165",40072,"41.177.26.176",80,21,13253,8,862,13,12391,112.103907,0.5960629999999867,11569.246874911132,166304.5684768258
"77.197.127.165",40712,"41.177.26.15",80,187,176859,63,4335,124,172524,112.561492,1.073607999999993,32302.292829412807,1285564.191026901
"77.197.127.165",43217,"41.177.26.176",80,20,12567,8,815,12,11752,114.947732,0.4818250000000006,13531.883982773812,195124.7859700096
"77.197.127.165",44118,"41.177.26.176",80,18,12569,7,752,11,11817,116.011464,0.6255459999999999,9617.198415464252,151125.57669619823
"77.197.127.165",44401,"41.177.26.176",80,23,13076,9,872,14,12204,116.788041,0.5899939999999901,11823.849056092293,165479.64894558527
"77.197.127.165",45269,"41.177.26.176",80,36,25868,15,1248,21,24620,139.718893,0.7599369999999794,13137.93117061055,259179.37934329468
"77.197.127.165",6196,"41.177.26.176",80,21,12769,8,816,13,11953,202.966875,0.5616120000000251,11623.683254630792,170267.0170865219
"77.197.128.13",16887,"41.177.26.176",80,23,13004,10,944,13,12060,184.149106,1.12993400000002,6683.576208875798,85385.51809220565
"77.197.128.13",17485,"41.177.26.176",80,23,13753,10,936,13,12817,185.721118,0.8883620000000008,8428.996287549438,115421.4160443602
"77.197.128.13",17972,"41.177.26.176",80,20,13010,8,816,12,12194,186.825458,0.6970910000000003,9364.631016610452,139941.55712812237
"77.197.128.13",18391,"41.177.26.176",80,21,12744,9,887,12,11857,187.79414,0.7005460000000028,10129.242048345108,135402.9571220157
"77.197.128.13",18789,"41.177.26.176",80,24,12954,11,1005,13,11949,188.689832,0.5942000000000007,13530.79771120833,160875.1262201277
"77.197.128.13",19200,"41.177.26.176",80,23,13575,10,953,13,12622,189.488804,0.7049020000000041,10815.687854481836,143248.28132137432
"77.197.128.13",19651,"41.177.26.176",80,26,13286,12,1116,14,12170,190.303905,0.7077370000000087,12614.855518363305,137565.22550043138
"77.197.128.13",20102,"41.177.26.176",80,23,12888,10,944,13,11944,191.088456,0.6122429999999781,12334.971571745647,156068.75047979873
"77.197.128.13",20564,"41.177.26.176",80,27,12894,11,1007,16,11887,191.972464,1.734895999999992,4643.5060084293455,54813.660300098934
"77.197.128.13",21747,"41.177.26.176",80,22,12822,9,889,13,11933,193.97365,0.5985990000000072,11881.075644964181,159479.05024899615
"77.197.128.13",22164,"41.177.26.176",80,20,13065,9,924,11,12141,194.694275,0.6153390000000059,12012.8904555049,157844.70023840366
"77.197.128.13",22557,"41.177.26.176",80,22,12673,9,875,13,11798,195.490947,0.6316199999999981,11082.612963490741,149431.62027801573
"77.197.128.13",22869,"41.177.26.176",80,21,12941,9,924,12,12017,196.270841,0.6422490000000209,11509.554705417617,149686.49231060984
"77.197.128.13",23133,"41.177.26.176",80,19,12633,7,747,12,11886,196.951548,0.6386049999999841,9357.897291753352,148899.55449769789
"77.197.128.13",23400,"41.177.26.176",80,21,13033,8,823,13,12210,197.669098,0.6389039999999966,10305.147565205469,152886.81867698516
"77.197.128.13",23674,"41.177.26.176",80,20,12936,8,863,12,12073,198.363304,0.7507160000000113,9196.553690077068,128655.84322166911
"77.197.128.13",23970,"41.177.26.176",80,22,12980,9,926,13,12054,199.13059,0.5765399999999943,12849.065112568205,167259.86054740514
"77.197.128.13",24210,"41.177.26.176",80,19,12814,7,752,12,12062,199.734098,0.6465019999999981,9305.46231875542,149258.62565003708
"77.197.128.13",24439,"41.177.26.176",80,20,12714,8,825,12,11889,200.39667,0.6732959999999935,9802.52370428469,141263.2779639281
"77.197.128.13",24621,"41.177.26.176",80,22,13122,9,924,13,12198,201.07229,0.6731089999999824,10981.876635136647,144975.03376125198
"77.197.128.13",24791,"41.177.26.176",80,26,14595,11,1083,15,13512,201.747801,1.1138229999999965,7778.614735016271,97049.53120917807
"77.197.128.13",25070,"41.177.26.176",80,21,12750,8,823,13,11927,202.863236,0.6119889999999941,10758.363303915696,155911.29905929833
"77.197.128.13",25200,"41.177.26.176",80,18,12764,7,798,11,11966,203.478847,0.6549939999999879,9746.65416782462,146150.95710800675
"77.197.128.13",25331,"41.177.26.176",80,22,12834,9,889,13,11945,204.137032,0.595593000000008,11941.040274146782,160445.1361919947
"77.197.128.13",25512,"41.177.26.176",80,24,11623,9,858,15,10765,204.738233,2.179518999999999,3149.318725828957,39513.3054586815
"77.197.128.13",26168,"41.177.26.176",80,21,12720,8,814,13,11906,206.920513,0.6580299999999966,9896.20534018211,144747.19997568577
"77.197.128.13",26375,"41.177.26.176",80,22,13121,9,890,13,12231,207.584282,0.7146270000000072,9963.239564136155,136921.77877410036
"77.197.128.13",26549,"41.177.26.176",80,24,11858,9,899,15,10959,208.328262,1.0871219999999937,6615.632836057077,80645.96245867576
"77.197.128.13",26813,"41.177.26.176",80,20,12584,8,823,12,11761,209.432306,0.6409730000000025,10271.883527075204,146789.33434013545
"77.197.128.13",26962,"41.177.26.176",80,19,12684,7,796,12,11888,210.074469,0.6606000000000165,9639.721465334304,143966.0914320279
"77.197.128.18",7869,"41.177.26.176",80,20,12687,8,825,12,11862,0.002078,0.6621929999999999,9966.882766806657,143305.65258164916
"77.197.128.18",1395,"41.177.26.176",80,4,256,4,256,0,0,0.004159,0.00028800000000000006,0,0
"77.197.128.18",3031,"41.177.26.176",80,21,12708,8,815,13,11893,0.091722,0.547712,11904.066370647348,173711.73171301707
"77.197.128.18",3249,"41.177.26.176",80,19,12660,8,825,11,11835,0.711084,0.6752659999999999,9773.926126889257,140211.41298392043
"77.197.128.18",7945,"41.177.26.176",80,21,12273,9,886,12,11387,0.814503,0.5986130000000001,11840.705096615007,152178.4525227484
"77.197.128.18",10507,"41.177.26.176",80,36,25425,15,1279,21,24146,1.424145,2.125865,4813.099608865097,90865.60059081831
"77.197.128.18",3426,"41.177.26.176",80,20,12719,7,752,13,11967,1.533514,0.655848,9172.857125431503,145972.84736707286
"77.197.128.18",3535,"41.177.26.176",80,21,12902,9,890,12,12012,2.325805,1.242902,5728.52887838301,77315.83021026598
"77.197.128.18",3747,"41.177.26.176",80,20,12898,8,860,12,12038,3.895796,0.6425580000000002,10707.204641448707,149875.96450437154
"77.197.128.18",11303,"41.177.26.176",80,22,12593,9,879,13,11714,4.185349,0.5692749999999993,12352.553686706791,164616.3980501517
"77.197.128.18",11689,"41.177.26.176",80,21,13042,9,879,12,12163,4.793943,0.6355440000000003,11064.536837732709,153103.48300039014
"77.197.128.18",12057,"41.177.26.176",80,25,11997,10,954,15,11043,5.458925,1.6337380000000001,4671.495674337011,54074.76596614634
"77.197.128.18",12992,"41.177.26.176",80,25,11535,10,920,15,10615,7.343201,1.686293,4364.603304407953,50358.98269162002
"77.197.128.18",13775,"41.177.26.176",80,25,12356,10,957,15,11399,9.117792,1.2309110000000008,6219.783558681331,74084.9663379399
"77.197.128.18",14371,"41.177.26.176",80,20,12666,8,811,12,11855,10.536161,0.6455380000000002,10050.531494660265,146916.21562169844
"77.197.128.18",14669,"41.177.26.176",80,25,12397,10,962,15,11435,11.321765,2.0546670000000002,3745.6191197892404,44523.02976589393
"77.197.128.18",11974,"41.177.26.176",80,35,27090,14,1199,21,25891,12.670157,0.7235130000000005,13257.5364920879,286280.9652349023
"77.197.128.18",15419,"41.177.26.176",80,34,30372,12,1079,22,29293,13.589991,2.536053000000001,3403.7143545501604,92405.00888585528
"77.197.128.18",16228,"41.177.26.176",80,22,13556,9,926,13,12630,16.225538,0.7386300000000006,10029.37871464738,136793.79391576286
"77.197.128.18",16487,"41.177.26.176",80,22,12670,9,889,13,11781,17.050794,0.5686059999999991,12507.782190128159,165752.7356376826
"77.197.128.18",16678,"41.177.26.176",80,19,12681,8,812,11,11869,17.658181,0.6896030000000017,9419.912616389405,137690.81631025352
"77.197.128.18",14185,"41.177.26.176",80,18,11921,7,748,11,11173,17.719912,0.6204479999999997,9644.643870235706,144063.6443344165
"77.197.128.18",16872,"41.177.26.176",80,20,13097,8,862,12,12235,18.455538,0.715838999999999,9633.451097243948,136734.65681528967
"77.197.128.18",14952,"41.177.26.176",80,22,12795,9,879,13,11916,19.207064,0.5442290000000014,12921.031404059655,175161.5588290954
"77.197.128.18",17104,"41.177.26.176",80,21,12628,8,811,13,11817,19.283538,0.5428749999999987,11951.185816256073,174139.53488372135
"77.197.128.18",17231,"41.177.26.176",80,20,12681,8,816,12,11865,19.897444,0.6234220000000015,10471.237781149823,152256.4170016454
"77.197.128.18",15399,"41.177.26.176",80,19,12795,8,860,11,11935,20.007464,0.6372250000000008,10796.814312056167,149837.18466789575
"77.197.128.18",17385,"41.177.26.176",80,19,12794,8,815,11,11979,20.69915,0.6507870000000011,10018.63897096898,147255.55366041398
"77.197.128.18",15842,"41.177.26.176",80,22,12731,9,890,13,11841,20.799015,0.5852679999999992,12165.366977179701,161854.05660312902
"77.197.128.18",16141,"41.177.26.176",80,22,13016,9,926,13,12090,21.406369,0.6791869999999989,10907.158116984001,142405.5525208818
"77.197.128.18",17523,"41.177.26.176",80,20,12603,8,825,12,11778,21.525502,0.5564269999999993,11861.394217031178,169337.57707659784
"77.197.128.18",17643,"41.177.26.176",80,25,11886,10,970,15,10916,22.120739,1.0511759999999981,7382.208117384733,83076.47815399148
"77.197.128.18",16475,"41.177.26.176",80,19,12643,8,826,11,11817,22.192036,0.6701589999999982,9860.346574469668,141065.03083596617
"77.197.128.18",16727,"41.177.26.176",80,20,12500,8,823,12,11677,22.901438,0.5812530000000002,11327.253364713812,160714.86942863083
"77.197.128.18",17897,"41.177.26.176",80,19,12842,7,751,12,12091,23.35395,0.6183669999999992,9715.913041931422,156424.9062449971
"77.197.128.18",16923,"41.177.26.176",80,22,13928,9,889,13,13039,23.500145,0.6901960000000003,10304.31935276356,151133.88081066823
"77.197.128.18",18093,"41.177.26.176",80,19,12536,8,816,11,11720,23.976896,0.6494630000000008,10051.380910074926,144365.4218947036
"77.197.128.18",17162,"41.177.26.176",80,18,12447,7,752,11,11695,24.254412,0.6263719999999999,9604.516166112151,149368.10713122555
"77.197.128.18",18375,"41.177.26.176",80,21,12771,9,876,12,11895,24.761278,0.627478,11168.519055648167,151654.7193686472
"77.197.128.18",17491,"41.177.26.176",80,21,12638,8,814,13,11824,24.998856,0.6565790000000007,9918.075357268499,144067.96440336943
"77.197.128.18",18677,"41.177.26.176",80,19,12802,8,812,11,11990,25.565189,0.7289959999999986,8910.885656437089,131578.22539492697
"77.197.128.18",18001,"41.177.26.176",80,19,12795,7,748,12,12047,25.759871,0.6410079999999994,9335.296907370901,150350.6976511995
"77.197.128.18",18987,"41.177.26.176",80,20,12706,8,825,12,11881,26.456998,0.6232490000000013,10589.668013907742,152504.05536150048
"77.197.128.18",18460,"41.177.26.176",80,22,13260,9,887,13,12373,26.488982,0.6215140000000012,11417.281026654244,159262.70365591088
"77.197.128.18",19271,"41.177.26.176",80,24,11614,9,892,15,10722,27.270854,1.7219559999999987,4144.124472402318,49813.119498988395
"77.197.128.18",18733,"41.177.26.176",80,20,13104,8,823,12,12281,27.282126,0.6172709999999988,10666.303779053305,159165.0992837833
"77.197.128.18",19002,"41.177.26.176",80,19,12621,8,816,11,11805,28.129082,0.6999770000000005,9326.020712109106,134918.71875790195
"77.197.128.18",19210,"41.177.26.176",80,22,13133,9,913,13,12220,28.925802,2.9968739999999983,2437.206235564126,32620.657391668803
"77.197.128.18",19997,"41.177.26.176",80,20,12952,9,879,11,12073,29.083354,0.6388409999999993,11007.433774601204,151186.28892009138
"77.197.128.18",20317,"41.177.26.176",80,20,13184,8,825,12,12359,29.892547,0.6974090000000004,9463.600268995662,141770.46754486958
"77.197.128.18",20679,"41.177.26.176",80,20,12715,8,825,12,11890,30.709865,0.5497329999999998,12005.828283912377,173029.45247965836
"77.197.128.18",20892,"41.177.26.176",80,20,12705,8,825,12,11880,31.315591,0.5493159999999975,12014.942219050656,173015.16795432946
"77.197.128.18",19999,"41.177.26.176",80,25,11855,10,974,15,10881,31.926916,1.879995000000001,4144.691874180514,46302.2508038585
"77.197.128.18",21133,"41.177.26.176",80,20,12879,8,815,12,12064,31.927772,0.6450619999999994,10107.555552799586,149616.62599874137
"77.197.128.18",25058,"41.177.26.15",80,221,214525,72,4912,149,209613,36.997317,1.290352999999996,30453.68205444566,1299569.9626381348
"77.197.128.18",33478,"41.177.26.15",80,7,1028,4,637,3,391,47.31451,0.1689440000000033,30163.841272847218,18515.010891182515
"77.197.128.18",35790,"41.177.26.15",80,179,169845,61,4208,118,165637,50.728945,1.0661929999999984,31574.0208386287,1242829.393927743
"77.197.128.18",36858,"41.177.26.15",80,202,192408,68,4656,134,187752,52.20461,1.2653689999999997,29436.47268109145,1187018.1741452496
"77.197.128.31",55747,"41.177.26.176",80,25,12666,10,955,15,11711,17.764038,1.1778910000000025,6486.168923949655,79538.76886740777
"77.197.128.31",56048,"41.177.26.176",80,23,13819,10,1007,13,12812,18.97199,1.0645559999999996,7567.474139453447,96280.5150691932
"77.197.128.31",56301,"41.177.26.176",80,43,33702,16,1343,27,32359,20.248819,1.7704330000000006,6068.571925624972,146219.59712680453
"77.197.128.31",56654,"41.177.26.176",80,21,13136,8,860,13,12276,22.28104,0.6526229999999984,10542.074061134861,150481.97810987392
"77.197.128.31",56786,"41.177.26.176",80,18,12959,7,753,11,12206,23.183706,0.6564739999999993,9176.296395592219,148746.1803513926
"77.197.128.31",56884,"41.177.26.176",80,23,13720,10,953,13,12767,24.024154,0.7414179999999995,10282.99825469574,137757.64818226706
"77.197.128.31",57006,"41.177.26.176",80,20,13179,7,762,13,12417,25.04285,0.661915999999998,9209.627807758112,150073.42321382216
"77.197.128.31",57166,"41.177.26.176",80,21,12738,7,759,14,11979,25.812395,0.6059030000000014,10021.406066647609,158163.930530134
"77.197.128.31",57343,"41.177.26.176",80,19,13296,8,863,11,12433,26.670768,0.7567210000000024,9123.573946011777,131440.78200552077
"77.197.128.31",57552,"41.177.26.176",80,20,12702,8,817,12,11885,27.548177,0.6506080000000019,10045.987752994093,146140.22575805974
"77.197.128.31",57748,"41.177.26.176",80,21,12921,8,823,13,12098,28.251824,0.6486540000000005,10150.249593774177,149207.435705322
"77.197.128.31",57871,"41.177.26.176",80,20,12973,8,816,12,12157,29.049868,0.7041439999999994,9270.830966393245,138119.475561817
"77.197.128.31",57965,"41.177.26.176",80,21,12739,8,812,13,11927,29.852374,0.6382379999999976,10178.021365070748,149499.08968127932
"77.197.128.31",58046,"41.177.26.176",80,20,12993,8,826,12,12167,30.711147,0.6799600000000012,9718.218718748145,143149.59703511946
"77.197.128.31",58117,"41.177.26.176",80,21,12715,9,924,12,11791,31.49242,0.5939799999999984,12444.86346341631,158806.69382807545
"77.197.128.31",58156,"41.177.26.176",80,22,13856,9,924,13,12932,32.104853,0.6800740000000047,10869.405388237086,152124.62173233985
"77.197.128.31",58310,"41.177.26.176",80,20,13242,8,823,12,12419,32.974129,0.6140230000000031,10722.725370222233,161805.01381869978
"77.197.128.31",58435,"41.177.26.176",80,20,12704,9,880,11,11824,33.598332,0.6266859999999994,11233.695981719724,150940.0241907432
"77.197.128.31",59416,"41.177.26.176",80,19,13187,8,816,11,12371,38.37657,0.6646659999999969,9821.474244206911,148898.8454351516
"77.197.128.31",61923,"41.177.26.176",80,21,12791,9,880,12,11911,49.213589,0.6281540000000021,11207.442760851602,151695.28491420843
"77.197.128.31",62282,"41.177.26.176",80,25,11477,10,922,15,10555,50.596759,1.5670849999999987,4706.828283086116,53883.48430365939
"77.197.128.31",62689,"41.177.26.176",80,21,13018,9,889,12,12129,52.181297,0.8717979999999983,8157.853080644844,111301.01239048516
"77.197.128.31",62982,"41.177.26.176",80,20,12930,8,863,12,12067,53.278022,0.6600790000000032,10459.354107614341,146249.16108526333
"77.197.128.31",63223,"41.177.26.176",80,13,8400,6,741,7,7659,54.239505,2.1664169999999956,2736.3153077177717,28282.6436461679
"77.197.128.31",64099,"41.177.26.176",80,25,11251,10,931,15,10320,56.989627,1.7356419999999986,4291.20751860119,47567.413095557764
"77.197.128.31",64604,"41.177.26.176",80,19,12680,8,826,11,11854,58.908622,0.6473000000000013,10208.55862814767,146503.9394407536
"77.197.128.31",64834,"41.177.26.176",80,19,12656,8,825,11,11831,59.744523,0.6500440000000012,10153.158863092327,145602.45152635794
"77.197.128.31",65093,"41.177.26.176",80,21,13432,8,862,13,12570,60.553427,0.7498429999999985,9196.591819887648,134108.073290009
"77.197.128.31",1056,"41.177.26.176",80,22,13014,9,925,13,12089,61.596726,0.5794950000000014,12769.73916944923,166890.13710213162
"77.197.128.31",1208,"41.177.26.176",80,23,12954,9,887,14,12067,62.191199,0.6890250000000009,10298.610355212062,140105.22114582182
"77.197.128.31",1366,"41.177.26.176",80,23,16555,9,876,14,15679,63.051577,0.7408599999999979,9459.277056393948,169305.9417433798
"77.197.128.38",26642,"41.177.26.176",80,20,12803,8,821,12,11982,4.280012,0.6790880000000001,9671.795113446267,141154.01833046673
"77.197.128.38",28825,"41.177.26.176",80,21,12735,8,816,13,11919,7.131862,0.6119700000000003,10667.189568116079,155811.5593901661
"77.197.128.38",29699,"41.177.26.176",80,22,13344,8,878,14,12466,8.364291,1.1617879999999996,6045.8534603559365,85840.10163644317
"77.197.128.38",30726,"41.177.26.176",80,23,13563,9,926,14,12637,9.695801,0.7433270000000007,9966.004194654563,136004.7462287794
"77.197.128.38",31217,"41.177.26.176",80,22,12856,9,889,13,11967,10.466834,0.710229,10013.671646750556,134795.96017622485
"77.197.128.38",31631,"41.177.26.176",80,20,13405,8,816,12,12589,11.239721,0.5936610000000009,10996.174584485068,169645.63951480703
"77.197.128.38",32013,"41.177.26.176",80,22,12851,9,877,13,11974,11.851843,0.6450709999999997,10876.322141283677,148498.38234860974
"77.197.128.38",32552,"41.177.26.176",80,19,13033,8,817,11,12216,12.668520000000001,0.7007959999999986,9326.537251924972,139452.85075828087
"77.197.128.38",32956,"41.177.26.176",80,23,14570,10,1015,13,13555,13.445143,1.022164,7943.930719532286,106088.65113621688
"77.197.128.38",33600,"41.177.26.176",80,19,13009,8,861,11,12148,14.478926,0.6004129999999996,11472.103368847784,161861.91837951553
"77.197.128.38",33877,"41.177.26.176",80,21,12934,9,880,12,12054,15.093955,0.6443390000000004,10925.92563852257,149660.34959858077
"77.197.128.38",34246,"41.177.26.176",80,20,12688,8,825,12,11863,15.895569,0.6358900000000016,10379.153627199647,149245.93876299323
"77.197.128.38",34524,"41.177.26.176",80,22,13297,9,880,13,12417,16.623146,0.5867150000000017,11999.011445079776,169308.77853813133
"77.197.128.38",34877,"41.177.26.176",80,22,13517,9,926,13,12591,17.320591,0.7570529999999991,9785.312256869742,133052.7717346079
"77.197.128.38",35146,"41.177.26.176",80,25,13406,10,931,15,12475,18.162178,1.2828809999999997,5805.682678284269,77793.65350332574
"77.197.128.38",35790,"41.177.26.176",80,21,12853,9,924,12,11929,19.569685,0.5851010000000016,12633.716230189282,163103.46418823372
"77.197.128.38",36811,"41.177.26.176",80,19,12780,7,751,12,12029,20.165231,0.633655000000001,9481.500185432122,151868.13013390545
"77.197.128.38",37148,"41.177.26.176",80,21,12763,8,837,13,11926,20.965851,4.502292000000001,1487.2424978211095,21190.984503004245
"77.197.128.38",38613,"41.177.26.176",80,19,12972,8,863,11,12109,25.477777,0.7433970000000016,9287.096934746824,130309.91515973267
"77.197.128.38",38846,"41.177.26.176",80,20,12637,8,815,12,11822,26.289054,0.5232649999999985,12460.22569826,180742.07141696897
"77.197.128.38",38987,"41.177.26.176",80,23,14319,10,944,13,13375,26.901581,0.6859049999999982,11010.271101683207,155998.27964514078
"77.197.128.38",39140,"41.177.26.176",80,22,13610,9,875,13,12735,27.702562,0.6152049999999996,11378.321047455735,165603.33547354146
"77.197.128.38",39255,"41.177.26.176",80,24,11981,10,971,14,11010,28.333874,1.2085449999999973,6427.563723320205,72881.02635814156
"77.197.128.38",39460,"41.177.26.176",80,22,14009,9,955,13,13054,29.744086,1.1972079999999998,6381.514323325605,87229.62091800256
"77.197.128.38",39650,"41.177.26.176",80,20,12716,8,825,12,11891,30.95944,0.6230960000000003,10592.26828610679,152669.89356375253
"77.197.128.38",39742,"41.177.26.176",80,22,13217,9,926,13,12291,31.675817,0.7008880000000026,10569.449041786951,140290.60277818944
"77.197.128.38",39857,"41.177.26.176",80,21,12812,9,926,12,11886,32.383997,1.6875890000000027,4389.6944101911,56345.47274247453
"77.197.128.38",24818,"244.3.210.197",80,22,17362,9,904,13,16458,154.146542,0.7922949999999958,9127.913214143771,166180.5261928962
"77.197.128.41",36264,"41.177.26.91",80,23,19261,8,776,15,18485,0.199424,0.5363519999999999,11574.48839568045,275714.4561780324
"77.197.128.41",36827,"41.177.26.91",80,22,18361,8,831,14,17530,1.331482,0.6012419999999998,11057.111778618264,233250.50478842136
"77.197.128.41",52374,"244.3.210.197",80,23,16311,11,1035,12,15276,35.292186,0.9407369999999986,8801.609801676783,129906.6582902556
"77.197.128.41",63176,"41.177.26.176",80,23,12919,10,953,13,11966,64.853541,0.8409009999999881,9066.465612480075,113839.7980261664
"77.197.128.41",64643,"41.177.26.176",80,23,13005,10,944,13,12061,67.39427,0.6766859999999895,11160.272268083154,142589.02947600733
"77.197.128.41",65318,"41.177.26.176",80,17,12825,7,761,10,12064,68.599877,2.191236999999987,2778.3393580886213,44044.52827329977
"77.197.128.41",1880,"41.177.26.176",80,25,12090,10,963,15,11127,70.948747,1.1449649999999991,6728.589956898251,77745.6079443477
"77.197.128.41",3376,"41.177.26.176",80,19,12734,8,815,11,11919,72.378787,0.5971859999999936,10917.8714839264,159668.84689192486
"77.197.128.41",3632,"41.177.26.176",80,38,27480,15,1279,23,26201,73.126961,1.599059000000011,6398.763272649682,131082.09265574225
"77.197.128.41",4223,"41.177.26.176",80,25,16698,10,953,15,15745,74.99201,0.6497770000000003,11733.256178658212,193851.12123082217
"77.197.128.41",4456,"41.177.26.176",80,15,7450,7,716,8,6734,75.820393,0.8346350000000058,6862.880181156985,64545.579804345165
"77.197.128.41",4787,"41.177.26.176",80,19,13293,8,861,11,12432,76.829738,0.6300519999999921,10932.430973951494,157853.63747754353
"77.197.128.41",5002,"41.177.26.176",80,21,12767,8,816,13,11951,77.626469,0.6180530000000033,10562.20097629162,154692.2351319377
"77.197.128.41",5241,"41.177.26.176",80,21,12723,8,815,13,11908,78.41187,0.6030330000000106,10812.01194627804,157974.7708665999
"77.197.128.41",5404,"41.177.26.176",80,21,13127,9,887,12,12240,79.034303,0.6210050000000109,11426.639076979856,157679.8898559565
"77.197.128.41",5590,"41.177.26.176",80,19,12619,8,825,11,11794,79.798844,0.6375369999999947,10352.340334757127,147994.54776742493
"77.197.128.41",5752,"41.177.26.176",80,21,12791,8,825,13,11966,80.452877,0.6875710000000055,9599.008684193992,139226.34898795796
"77.197.128.41",5930,"41.177.26.176",80,22,13450,9,924,13,12526,81.271893,0.6081379999999967,12155.135840878287,164778.38911562925
"77.197.128.41",6100,"41.177.26.176",80,20,12800,8,808,12,11992,82.067138,0.6897900000000021,9370.96797576071,139080.00985807233
"77.197.128.41",6284,"41.177.26.176",80,21,12827,8,863,13,11964,82.881519,0.688005000000004,10034.810793526152,139115.26805764413
"77.197.128.41",6454,"41.177.26.176",80,19,12503,8,823,11,11680,83.695895,0.6303190000000001,10445.504577840742,148242.39789693788
"77.197.128.41",6650,"41.177.26.176",80,20,12910,8,826,12,12084,84.553099,0.6607389999999924,10000.923208710363,146308.90563445038
"77.197.128.41",7073,"41.177.26.176",80,20,12572,8,815,12,11757,85.473236,0.5324559999999963,12245.143260663877,176645.58198236223
"77.197.128.41",7242,"41.177.26.176",80,20,12888,8,826,12,12062,86.206512,0.7053889999999967,9367.880701286851,136798.27726261743
"77.197.128.41",7423,"41.177.26.176",80,19,12854,8,823,11,12031,87.009855,0.6156009999999981,10695.239286485923,156348.02412601718
"77.197.128.41",7572,"41.177.26.176",80,22,13108,10,936,12,12172,87.804694,0.6316610000000082,11854.459908083454,154158.63889016217
"77.197.128.41",7739,"41.177.26.176",80,21,12746,9,889,12,11857,88.621331,0.6162960000000055,11539.909394187105,153913.05476589035
"77.197.128.41",7926,"41.177.26.176",80,20,12741,8,825,12,11916,89.426493,0.6970560000000035,9468.392783363126,136758.02231097576
"77.197.128.41",10594,"41.177.26.176",80,19,13220,8,826,11,12394,90.240471,0.6436269999999951,10266.816028538347,154051.95866550153
"77.197.128.41",10799,"41.177.26.176",80,20,13261,8,825,12,12436,91.071592,0.6555370000000096,10068.081588071922,151765.65167183324
"77.197.128.41",10985,"41.177.26.176",80,27,13632,11,1011,16,12621,91.893551,2.1669029999999907,3732.5159455684147,46595.53288725911
"77.197.128.41",18548,"41.177.26.176",80,25,12653,10,971,15,11682,124.387117,1.210134999999994,6419.118528098137,77227.74731744843
"77.197.128.41",24137,"41.177.26.176",80,18,12444,7,751,11,11693,140.68492,0.6299829999999815,9536.765277793489,148486.5464623692
"77.197.128.41",25528,"41.177.26.176",80,24,11678,9,870,15,10808,143.716516,1.8174559999999929,3829.528747876167,47574.19161729381
"77.197.128.41",26543,"41.177.26.176",80,22,13069,9,924,13,12145,145.745562,0.5986900000000048,12346.957523927142,162287.66139404234
"77.197.128.41",26925,"41.177.26.176",80,19,12521,8,816,11,11705,146.619299,0.6334949999999822,10304.738001089487,147814.89988082406
"77.197.128.41",27276,"41.177.26.176",80,21,13057,9,872,12,12185,147.397638,0.6489630000000091,10749.457210965653,150208.87169222074
"77.197.128.41",27765,"41.177.26.176",80,35,24952,14,1215,21,23737,148.209531,1.6360940000000141,5940.9789413077215,116066.6807652851
"77.197.128.41",28431,"41.177.26.176",80,18,12436,7,747,11,11689,150.041993,0.6131150000000218,9746.947962453678,152519.51102158107
"77.197.128.41",28740,"41.177.26.176",80,19,12651,8,825,11,11826,150.842347,0.6961490000000197,9480.728981869992,135901.94053284187
"77.197.128.41",29038,"41.177.26.176",80,20,12782,8,825,12,11957,151.659949,0.6892699999999934,9575.347831764133,138778.70790836815
"77.197.128.41",29209,"41.177.26.176",80,19,12504,8,809,11,11695,152.463151,1.5469939999999838,4183.597350733143,60478.57974885551
"77.197.128.41",41064,"41.177.26.176",80,20,12792,8,813,12,11979,186.75917,0.6831029999999885,9521.258141158962,140289.23895810972
"77.197.128.41",46534,"41.177.26.176",80,37,27758,15,1248,22,26510,197.425389,0.7190229999999929,13885.508530325314,294955.7941818302
"77.197.128.41",48134,"41.177.26.176",80,26,12936,11,1043,15,11893,200.76004,1.1396609999999896,7321.47542119988,83484.47476925232
"77.197.128.41",48818,"41.177.26.176",80,20,13314,8,862,12,12452,202.31982,0.6509029999999996,10594.512546416294,153042.7728862827
"77.197.128.41",49183,"41.177.26.176",80,21,12950,9,925,12,12025,203.341805,0.5341270000000122,13854.382946377604,180106.97830290886
"77.197.128.41",49459,"41.177.26.176",80,21,13232,9,880,12,12352,204.149606,0.7783000000000015,9045.355261467283,126963.89567004985
"77.197.128.41",49748,"41.177.26.176",80,20,13134,9,879,11,12255,205.216097,0.6403410000000065,10981.648840227204,153105.92325026667
"77.197.128.41",50060,"41.177.26.176",80,20,13120,8,826,12,12294,206.018614,0.6432839999999942,10272.290310345135,152890.48072080276
"77.197.128.41",50351,"41.177.26.176",80,20,12980,8,815,12,12165,206.836804,0.6255150000000071,10423.411109245862,155583.7989496637
"77.197.128.41",50555,"41.177.26.176",80,35,27012,14,1176,21,25836,207.649108,0.6991629999999986,13456.089638610765,295622.0509380508
"77.197.128.41",50762,"41.177.26.176",80,35,24685,14,1216,21,23469,208.461452,1.6078849999999818,6050.1839372841405,116769.54508562623
"77.197.128.41",51214,"41.177.26.176",80,19,12766,8,817,11,11949,210.283101,0.6645570000000021,9835.123247516736,143843.1917803886
"77.197.128.41",51389,"41.177.26.176",80,19,12652,8,825,11,11827,211.101189,0.6808660000000089,9693.537348024302,138964.20147282837
"77.197.128.41",51594,"41.177.26.176",80,24,11950,9,876,15,11074,211.909157,1.062387000000001,6596.466259470412,83389.57460887596
"77.197.128.46",54088,"41.177.26.176",80,19,12496,8,814,11,11682,29.575032,0.6412109999999984,10155.783353685474,145749.21515694557
"77.197.128.46",54779,"41.177.26.176",80,25,12144,10,976,15,11168,32.967513,1.2319320000000005,6338.012163008995,72523.48343902096
"77.197.128.47",57174,"41.177.26.176",80,22,12864,9,880,13,11984,75.286853,0.5731950000000126,12282.033164978491,167258.96073761617
"77.197.128.47",61323,"41.177.26.176",80,20,12866,8,825,12,12041,97.70669,0.6829780000000056,9663.561637417231,141041.14627411016
"77.197.128.47",14191,"41.177.26.176",80,21,11740,9,877,12,10863,163.469325,1.8775029999999902,3736.878183417037,46287.00992754763
"77.197.128.55",1119,"41.177.26.176",80,21,12836,9,924,12,11912,69.637909,0.652275000000003,11332.643440266706,146097.88816066776
"77.197.128.55",13901,"41.177.26.176",80,25,12532,10,976,15,11556,129.856333,1.2295709999999929,6350.182299354852,75187.19943785315
"77.197.128.55",17869,"41.177.26.176",80,21,12798,9,889,12,11909,155.531719,0.6794029999999793,10468.013829789119,140228.99516193318
"77.197.128.55",23066,"41.177.26.176",80,22,13209,9,927,13,12282,184.944422,0.6477160000000026,11449.462418714329,151696.11372885585
"77.197.128.64",46962,"41.177.26.176",80,20,12963,9,889,11,12074,126.591178,0.8348820000000075,8518.569091200836,115695.39168409325
"77.197.128.64",48612,"41.177.26.176",80,20,12899,9,890,11,12009,131.089896,0.7140139999999917,9971.793270160084,134551.98357455333
"77.197.128.64",49466,"41.177.26.176",80,21,13049,9,881,12,12168,133.330377,0.7002520000000061,10064.948047274322,139012.81253034502
"77.197.128.64",49915,"41.177.26.176",80,24,14079,10,944,14,13135,134.551186,0.6347149999999999,11898.253546867494,165554.61900222936
"77.197.128.64",50356,"41.177.26.176",80,20,12753,8,813,12,11940,135.668078,0.6611749999999859,9837.032555677602,144470.0722199146
"77.197.128.64",50683,"41.177.26.176",80,26,12097,11,1042,15,11055,136.627455,1.3496120000000076,6176.590012536902,65529.94490268277
"77.197.128.64",51416,"41.177.26.176",80,22,13521,9,927,13,12594,138.538051,0.7504110000000139,9882.584343779425,134262.42419154054
"77.197.128.64",51797,"41.177.26.176",80,21,12857,9,925,12,11932,139.533383,0.6680240000000026,11077.446319293875,142893.06971006974
"77.197.128.64",52176,"41.177.26.176",80,21,13075,9,879,12,12196,140.426028,0.6233090000000061,11281.723831999749,156532.3138282923
"77.197.128.64",52459,"41.177.26.176",80,22,12783,10,942,12,11841,141.29891,0.6934860000000072,10866.837975099601,136596.84550228703
"77.197.128.64",52799,"41.177.26.176",80,23,13189,11,1008,12,12181,142.310088,0.6726500000000044,11988.40407344079,144871.77581208557
"77.197.128.64",53170,"41.177.26.176",80,20,13141,9,879,11,12262,143.239551,0.8511419999999816,8261.84114989056,115252.21408413886
"77.197.128.64",53552,"41.177.26.176",80,21,13048,9,880,12,12168,144.402924,0.7078619999999773,9945.441343086964,137518.32984395704
"77.197.128.64",53893,"41.177.26.176",80,21,12758,8,812,13,11946,145.450466,0.8072990000000004,8046.5849703765225,118379.93110359352
"77.197.128.64",54239,"41.177.26.176",80,24,13143,11,1017,13,12126,146.590979,0.9168430000000001,8873.929342319241,105806.55575709253
"77.197.128.64",54652,"41.177.26.176",80,25,11472,10,925,15,10547,147.89185,1.8094460000000083,4089.6495391406906,46630.84723169391
"77.197.128.64",55319,"41.177.26.176",80,21,12940,9,924,12,12016,150.135076,0.9238149999999905,8001.6020523590505,104055.46565059129
"77.197.128.64",55767,"41.177.26.176",80,22,12831,9,887,13,11944,151.516042,0.6627349999999979,10707.145389937188,144178.2914739682
"77.197.128.64",56058,"41.177.26.176",80,27,13603,11,1004,16,12599,152.482794,2.5180619999999863,3189.75466052863,40027.60853386475
"77.197.128.64",1054,"41.177.26.176",80,20,12733,9,883,11,11850,187.239702,0.7408169999999927,9535.418328683156,127966.82581528358
"77.197.128.64",7351,"41.177.26.176",80,22,12831,10,953,12,11878,198.322135,0.5715429999999913,13339.328799408122,166258.70669398707
"77.197.128.64",12524,"41.177.26.176",80,23,12644,10,941,13,11703,203.398923,0.554269000000005,13581.852854841118,168914.37190245016
"77.197.128.64",13836,"41.177.26.176",80,22,13294,9,880,13,12414,205.857315,0.6513349999999889,10808.570090660136,152474.5330743806
"77.197.128.64",14679,"41.177.26.176",80,20,12685,8,823,12,11862,207.538497,0.6469579999999837,10176.85846685591,146680.3100046717
"77.197.128.64",15136,"41.177.26.176",80,24,14387,10,990,14,13397,208.482352,0.7230270000000019,10953.947777883785,148232.3620003122
"77.197.128.64",15502,"41.177.26.176",80,22,12824,10,940,12,11884,209.502597,0.8955669999999998,8396.915027016406,106158.44487347125
"77.197.128.64",15828,"41.177.26.176",80,18,12544,7,751,11,11793,210.524275,0.6037500000000193,9951.138716355788,156263.3540372621
"77.197.128.64",16071,"41.177.26.176",80,21,12794,9,878,12,11916,211.426451,0.6277120000000025,11189.845024469776,151865.8238172914
"77.197.128.64",16327,"41.177.26.176",80,5,645,3,515,2,130,212.423769,0.07915099999999597,52052.40616037965,13139.442331746319
"77.197.128.72",4790,"41.177.26.176",80,20,12680,8,815,12,11865,64.99504,0.5756569999999925,11326.189032705386,164889.8562859502
"77.197.128.72",6029,"41.177.26.176",80,21,13159,9,885,12,12274,67.690841,0.6072339999999912,11659.426184963462,161703.72541722207
"77.197.128.72",6629,"41.177.26.176",80,20,12731,8,825,12,11906,69.001632,0.6258430000000033,10545.775857523318,152191.52407233045
"77.197.128.72",7376,"41.177.26.176",80,24,12062,9,884,15,11178,69.885918,1.8900569999999988,3741.6860972975974,47312.8588185436
"77.197.128.72",11004,"41.177.26.176",80,20,12583,7,751,13,11832,71.823289,0.6373660000000001,9426.29509575346,148511.21647530617
"77.197.128.72",11373,"41.177.26.176",80,22,12850,9,889,13,11961,72.624185,0.5381930000000068,13214.59030496478,177794.95459806945
"77.197.128.72",11670,"41.177.26.176",80,19,13090,8,825,11,12265,73.248969,0.697037999999992,9468.6372909369,140767.0743919286
"77.197.128.72",12061,"41.177.26.176",80,21,13328,8,816,13,12512,74.050421,0.6516170000000017,10018.154836353231,153611.70749074954
"77.197.128.72",12392,"41.177.26.176",80,21,13067,9,888,12,12179,74.718015,0.6332920000000115,11217.574199579138,153850.0407394981
"77.197.128.72",12721,"41.177.26.176",80,25,11827,10,937,15,10890,75.495037,1.1087180000000103,6760.961759437414,78577.23965877635
"77.197.128.72",13260,"41.177.26.176",80,19,12837,7,751,12,12086,76.739485,0.6410570000000035,9372.021520707156,150825.90159689303
"77.197.128.72",13647,"41.177.26.176",80,20,12714,8,825,12,11889,77.574448,0.6188879999999983,10664.288207236234,153682.08787373523
"77.197.128.72",13932,"41.177.26.176",80,20,12608,8,817,12,11791,78.196797,0.6511100000000027,10038.242386079115,144872.60217167545
"77.197.128.72",14347,"41.177.26.176",80,21,12780,8,816,13,11964,78.979535,0.6918059999999997,9436.171412216723,138350.9249702952
"77.197.128.72",14769,"41.177.26.176",80,22,12978,8,815,14,12163,79.818732,0.6358900000000034,10253.345704445683,153020.17644561085
"77.197.128.72",15264,"41.177.26.176",80,20,12722,8,825,12,11897,80.648521,0.6478359999999981,10187.763569792385,146913.7250785697
"77.197.128.72",15607,"41.177.26.176",80,20,12719,9,888,11,11831,81.434002,0.6345599999999934,11195.158850227046,149155.32022188758
"77.197.128.72",15909,"41.177.26.176",80,20,12707,8,816,12,11891,82.245212,0.6615680000000026,9867.466382896353,143791.71906742713
"77.197.128.72",16209,"41.177.26.176",80,21,12874,9,926,12,11948,83.039518,0.6532430000000033,11340.343486267686,146322.27211007162
"77.197.128.72",16507,"41.177.26.176",80,20,12892,8,816,12,12076,83.841193,0.615476000000001,10606.424945895516,156964.69074342435
"77.197.128.72",16710,"41.177.26.176",80,20,13079,8,816,12,12263,84.463863,0.7391480000000001,8831.790115105498,132725.7869871798
"77.197.128.72",16999,"41.177.26.176",80,35,27562,13,1135,22,26427,85.308294,0.8086619999999982,11228.424236578472,261439.26634366455
"77.197.128.72",17385,"41.177.26.176",80,22,13269,10,944,12,12325,86.307222,0.6441290000000066,11724.359561516283,153074.92753780528
"77.197.128.72",17640,"41.177.26.176",80,19,12657,7,752,12,11905,87.138975,0.7025139999999936,8563.530406511549,135570.25198074468
"77.197.128.72",17812,"41.177.26.176",80,25,12481,10,972,15,11509,87.964573,1.270539999999997,6120.232342153745,72466.82512947268
"77.197.128.72",18030,"41.177.26.176",80,19,12655,7,761,12,11894,89.374075,0.7110849999999971,8561.564369941743,133812.41342455597
"77.197.128.72",18176,"41.177.26.176",80,20,12982,8,825,12,12157,90.185918,0.714068999999995,9242.804266814617,136199.72299595794
"77.197.128.72",18285,"41.177.26.176",80,20,13259,8,825,12,12434,90.999994,0.6621140000000025,9968.071963438282,150233.94762835346
"77.197.128.72",18414,"41.177.26.176",80,21,12738,9,876,12,11862,91.809764,0.5229999999999961,13399.61759082228,181445.50669216196
"77.197.128.72",18526,"41.177.26.176",80,19,12497,8,815,11,11682,92.419827,1.085131000000004,6008.491140700962,86124.16381063637
"77.197.128.72",26054,"41.177.26.176",80,25,12523,10,981,15,11542,123.877708,1.6383809999999954,4790.094611692898,56358.075441548855
"77.197.128.72",27367,"41.177.26.176",80,20,12842,8,821,12,12021,125.574473,0.6115860000000026,10739.290958262569,157243.62558985912
"77.197.128.72",27679,"41.177.26.176",80,21,12897,9,875,12,12022,126.205718,0.5997759999999914,11671.023848903758,160353.19852745254
"77.197.128.72",27965,"41.177.26.176",80,21,12663,9,889,12,11774,126.823145,0.5487889999999993,12959.443429077493,171636.0932890421
"77.197.128.72",28816,"41.177.26.176",80,25,12347,10,970,15,11377,127.504656,1.4939940000000007,5194.130632385402,60921.26206664817
"77.197.128.72",30260,"41.177.26.176",80,20,12936,9,880,11,12056,129.132157,0.6303189999999859,11168.947786755845,153014.58467855508
"77.197.128.72",30666,"41.177.26.176",80,25,15845,11,1008,14,14837,129.919162,0.6758440000000121,11931.74756304688,175626.32796917317
"77.197.128.72",31068,"41.177.26.176",80,18,13026,7,759,11,12267,130.690421,0.6358010000000149,9550.157989685227,154350.18189653318
"77.197.128.72",31452,"41.177.26.176",80,22,12972,9,879,13,12093,131.511206,0.6371180000000152,11037.201899804797,151846.282792195
"77.197.128.72",31791,"41.177.26.176",80,23,12142,9,900,14,11242,132.341728,1.0867520000000184,6625.246606401349,82756.69149907106
"77.197.128.72",32420,"41.177.26.176",80,19,12778,8,860,11,11918,133.575348,0.6217270000000212,11065.95016783856,153353.48151197672
"77.197.128.72",32793,"41.177.26.176",80,21,12747,8,823,13,11924,134.340481,0.5311179999999922,12396.491928347556,179606.0385827658
"77.197.128.72",33064,"41.177.26.176",80,22,13539,9,876,13,12663,134.992654,0.6283370000000161,11153.250564585278,161225.58435998103
"77.197.128.72",33367,"41.177.26.176",80,21,13567,8,816,13,12751,135.751949,0.6065380000000005,10762.72220372012,168180.72404367066
"77.197.128.72",33600,"41.177.26.176",80,20,13068,8,816,12,12252,136.375098,0.7056409999999858,9251.163126859312,138903.49341946113
"77.197.128.72",33995,"41.177.26.176",80,21,12773,9,880,12,11893,137.214599,0.6679790000000025,10539.253479525514,142435.61549090562
"77.197.128.72",34393,"41.177.26.176",80,20,12652,8,814,12,11838,138.029252,0.5031639999999982,12942.102376163684,188216.96305777112
"77.197.128.72",34748,"41.177.26.176",80,20,12277,8,826,12,11451,138.651681,0.6904859999999928,9570.07093554405,132671.77031829892
"77.197.128.72",35175,"41.177.26.176",80,20,12991,8,816,12,12175,139.480319,0.6342159999999808,10293.023197144503,153575.4380211205
"77.197.128.72",35532,"41.177.26.176",80,19,12805,8,860,11,11945,140.250121,0.6355669999999805,10824.979899837801,150353.93593437504
"77.197.128.72",35945,"41.177.26.176",80,20,12690,9,889,11,11801,141.059576,0.6537580000000105,10878.643167655135,144408.17550224776
"77.197.128.72",36304,"41.177.26.176",80,19,12996,7,753,12,12243,141.875946,0.639915000000002,9413.750263706868,153057.8279927798
"77.197.128.72",36569,"41.177.26.176",80,22,13008,9,889,13,12119,142.688817,0.6389780000000087,11130.273655743864,151729.79351401562
"77.197.128.72",36833,"41.177.26.176",80,23,14302,10,944,13,13358,143.487467,0.6449029999999993,11710.28821388644,165705.54021302445
"77.197.128.72",37169,"41.177.26.176",80,21,13481,8,823,13,12658,144.321713,0.6201330000000098,10617.077304384537,163294.0030606312
"77.197.128.72",37520,"41.177.26.176",80,21,13496,9,927,12,12569,145.136152,0.7123159999999871,10411.109676042845,141162.06852015373
"77.197.128.72",37700,"41.177.26.176",80,20,12574,8,812,12,11762,145.933522,0.6090700000000027,10665.440753936282,154491.2735810327
"77.197.128.72",37851,"41.177.26.176",80,22,13048,9,926,13,12122,146.808286,0.5945639999999912,12459.550191400942,163104.3924623782
"77.197.128.72",38040,"41.177.26.176",80,22,12960,9,879,13,12081,147.624332,0.6068269999999814,11588.146209710867,159267.79790616265
"77.197.128.72",38187,"41.177.26.176",80,20,12590,8,825,12,11765,148.424466,0.6138480000000186,10751.847362864748,153327.85966558033
"77.197.128.72",39020,"41.177.26.176",80,20,12694,8,823,12,11871,153.88727,0.6164389999999855,10680.69995571363,154059.0390938961
"77.197.128.72",46026,"41.177.26.176",80,23,12673,9,898,14,11775,163.839661,1.7914989999999875,4010.0496846495867,52581.66485161346
"77.197.128.72",48441,"41.177.26.176",80,21,13229,9,879,12,12350,167.640986,0.6312969999999893,11138.972623028652,156503.19896974272
"77.197.128.72",49019,"41.177.26.176",80,19,12628,8,812,11,11816,168.383569,0.7183860000000095,9042.492476189562,131583.8560328274
"77.197.128.72",49473,"41.177.26.176",80,18,12527,7,759,11,11768,169.2021,0.618392,9819.014476254542,152240.0031048267
"77.197.128.72",49792,"41.177.26.176",80,20,12580,8,815,12,11765,170.011049,0.5621989999999926,11597.316964277927,167414.0295518157
"77.197.128.72",50011,"41.177.26.176",80,22,12717,9,887,13,11830,170.632677,0.5389069999999947,13167.392518560846,175614.71645386113
"77.197.128.72",50212,"41.177.26.176",80,19,12762,7,799,12,11963,171.246966,0.7610760000000028,8398.635615891155,125748.28269450049
"77.197.128.72",50452,"41.177.26.176",80,22,9970,8,804,14,9166,172.105998,0.25220500000000357,25503.062984476554,290747.60611406976
"77.197.128.72",50586,"41.177.26.176",80,21,12945,8,825,13,12120,172.516286,0.6950750000000028,9495.378196597452,139495.73787001346
"77.197.128.72",50792,"41.177.26.176",80,19,12769,8,816,11,11953,173.323665,0.6985469999999907,9345.112068336257,136889.85852061675
"77.197.128.72",50977,"41.177.26.176",80,19,12561,8,825,11,11736,174.152126,0.6336939999999913,10415.121493970419,148159.83739786284
"77.197.128.72",51164,"41.177.26.176",80,22,12897,9,880,13,12017,174.972797,0.6513669999999934,10808.039093168785,147591.14293478327
"77.197.128.72",51377,"41.177.26.176",80,21,12779,9,880,12,11899,175.776493,0.5367350000000215,13116.342329081797,177353.8151974367
"77.197.128.72",51582,"41.177.26.176",80,20,12608,8,812,12,11796,176.40157,0.6049440000000175,10738.184030257036,155994.60445925122
"77.197.128.72",51839,"41.177.26.176",80,21,12148,8,816,13,11332,177.186352,0.6478879999999947,10075.815573062093,139925.41920825935
"77.197.128.72",52055,"41.177.26.176",80,20,12229,9,876,11,11353,177.995071,0.6359970000000033,11018.919900565512,142805.70505835646
"77.197.128.72",52242,"41.177.26.176",80,25,12226,10,971,15,11255,178.839702,1.2072510000000136,6434.453150173338,74582.66756457355
"77.197.128.72",52518,"41.177.26.176",80,21,12684,8,816,13,11868,180.263016,0.6938800000000072,9407.966795411214,136830.57589208367
"77.197.128.72",52627,"41.177.26.176",80,20,12695,8,824,12,11871,181.041843,0.5665280000000052,11635.788522367719,167631.60867600387
"77.197.128.72",52685,"41.177.26.176",80,21,12950,9,877,12,12073,181.637669,0.69834800000001,10046.567041073935,138303.5392096757
"77.197.128.72",52798,"41.177.26.176",80,20,13146,8,826,12,12320,182.523778,0.9886429999999962,6683.9091562879885,99692.20436497338
"77.197.128.72",52953,"41.177.26.176",80,21,12893,9,879,12,12014,183.902403,0.5880980000000022,11957.19080833462,163428.54422222084
"77.197.128.72",59473,"41.177.26.176",80,20,12682,8,817,12,11865,197.232354,0.5720900000000029,11424.775821985993,165917.94997290554
"77.197.128.72",61597,"41.177.26.176",80,21,12696,8,825,13,11871,200.797818,0.6939099999999883,9511.319911804285,136859.2468763984
"77.197.128.72",62156,"41.177.26.176",80,25,12320,10,963,15,11357,201.740997,1.103418000000005,6981.941567021714,82340.5092177213
"77.197.128.72",62683,"41.177.26.176",80,22,13242,9,880,13,12362,202.862073,0.6785629999999969,10374.865708858326,145743.28396921206
"77.197.128.72",62953,"41.177.26.176",80,21,12742,9,875,12,11867,203.646421,0.6190650000000062,11307.37483139885,153353.84814195448
"77.197.128.72",63171,"41.177.26.176",80,20,12934,8,815,12,12119,204.481125,0.6002229999999997,10862.629389410275,161526.63260154982
"77.197.128.72",63359,"41.177.26.176",80,20,13357,8,863,12,12494,205.081944,0.6896080000000211,10011.484785559027,144940.31391746752
"77.197.128.72",63568,"41.177.26.176",80,22,13626,9,887,13,12739,205.870598,0.6206909999999937,11432.419674201934,164191.19980795766
"77.197.128.72",63753,"41.177.26.176",80,25,12251,10,967,15,11284,206.698672,1.0469610000000102,7389.004939056875,86222.887003431
"77.197.128.72",64043,"41.177.26.176",80,22,12915,9,879,13,12036,207.987367,0.6168720000000008,11399.447535307148,156090.72870871084
"77.197.128.72",64227,"41.177.26.176",80,20,12599,8,825,12,11774,208.777666,0.6353829999999903,10387.435609703283,148244.44468926842
"77.197.128.72",64382,"41.177.26.176",80,22,12743,9,881,13,11862,209.577446,0.5850020000000029,12047.822058727945,162214.8300347683
"77.197.128.72",64483,"41.177.26.176",80,22,13191,9,924,13,12267,210.186182,0.6533929999999941,11313.252514183756,150194.44652758888
"77.197.128.72",64599,"41.177.26.176",80,19,12665,8,823,11,11842,210.995742,0.6086599999999862,10817.205007722127,155646.83074294703
"77.197.128.72",64685,"41.177.26.176",80,20,12657,8,821,12,11836,211.608665,0.6547779999999932,10030.880695441918,144610.8452024976
"77.197.128.72",64773,"41.177.26.176",80,21,13376,8,860,13,12516,212.408855,0.6236010000000078,11032.695585799114,160564.20692076944
"77.197.128.82",37936,"41.177.26.176",80,20,12705,8,812,12,11893,64.490862,0.6930759999999907,9372.709486405656,137277.87428795872
"77.197.128.82",42959,"41.177.26.176",80,18,12830,7,747,11,12083,73.050461,0.6119560000000064,9765.407970507582,157959.06895266814
"77.197.128.82",44869,"41.177.26.176",80,19,12509,8,823,11,11686,76.855393,0.5892939999999953,11172.691390036302,158644.07239849845
"77.197.128.82",46109,"41.177.26.176",80,22,13455,9,879,13,12576,78.725145,0.6456440000000043,10891.451016349494,155825.8111281129
"77.197.128.82",46893,"41.177.26.176",80,23,12282,9,892,14,11390,79.926734,1.8676930000000027,3820.756409110057,48787.461322604875
"77.197.128.82",48332,"41.177.26.176",80,22,12839,9,880,13,11959,82.014066,0.6084079999999972,11571.182495956715,157249.74030584813
"77.197.128.82",48758,"41.177.26.176",80,22,13156,9,925,13,12231,82.786488,0.6030760000000015,12270.426944531007,162248.2075227662
"77.197.128.82",49087,"41.177.26.176",80,21,12738,8,815,13,11923,83.404462,0.512904000000006,12711.930497714822,185968.52432423783
"77.197.128.82",49370,"41.177.26.176",80,22,13811,9,889,13,12922,83.997693,0.7234849999999966,9830.19689419965,142886.16902907522
"77.197.128.82",49715,"41.177.26.176",80,21,12870,8,815,13,12055,84.816234,0.5990120000000019,10884.589958131022,160998.44410462512
"77.197.128.82",49969,"41.177.26.176",80,19,12918,8,824,11,12094,85.431251,0.6094499999999954,10816.309787513414,158752.97399294566
"77.197.128.82",50131,"41.177.26.176",80,20,12824,8,816,12,12008,86.042273,0.6909630000000107,9447.68388466517,139029.1520674747
"77.197.128.82",50349,"41.177.26.176",80,22,13683,10,944,12,12739,86.854698,0.6235080000000011,12112.114038633004,163449.38637515448
"77.197.128.82",50547,"41.177.26.176",80,26,14265,10,1086,16,13179,87.651742,1.6957340000000016,5123.445068625145,62174.845818978625
"77.197.128.82",51012,"41.177.26.176",80,25,12069,10,944,15,11125,89.48039,1.6034199999999998,4709.932519240125,55506.35516583304
"77.197.128.82",51245,"41.177.26.176",80,20,13250,8,860,12,12390,91.103736,0.6249130000000065,11009.532526927635,158614.07907980625
"77.197.128.82",51362,"41.177.26.176",80,21,13100,8,816,13,12284,91.973074,0.6209850000000046,10512.331215729771,158251.80962503003
"77.197.128.82",51514,"41.177.26.176",80,32,23902,12,1088,20,22814,92.780588,1.5888139999999993,5478.3001660358,114873.10660656319
"77.197.128.82",52955,"41.177.26.176",80,21,12746,9,890,12,11856,94.998281,0.6549469999999928,10871.108654593543,144817.82495377646
"77.197.128.82",53713,"41.177.26.176",80,20,13818,7,796,13,13022,96.012951,5.181530999999993,1228.9803920887493,20105.25460525087
"77.197.128.82",59407,"41.177.26.176",80,20,12798,8,825,12,11973,101.353236,0.670220999999998,9847.498064071433,142914.0537225785
"77.197.128.82",60004,"41.177.26.176",80,19,12611,8,825,11,11786,102.15338,0.6742550000000023,9788.581471401736,139840.2681478071
"77.197.128.82",60751,"41.177.26.176",80,24,12437,9,960,15,11477,103.266827,1.3157369999999986,5837.032780867307,69782.94294376468
"77.197.128.82",61897,"41.177.26.176",80,22,13575,9,890,13,12685,104.723578,0.6596529999999916,10793.55358044319,153838.45749204702
"77.197.128.82",62465,"41.177.26.176",80,19,11215,8,773,11,10442,105.666004,2.4462329999999923,2527.9685132201303,34148.83210225692
"77.197.128.82",64133,"41.177.26.176",80,19,13315,8,862,11,12453,108.152885,0.7161180000000087,9629.697898949498,139116.73774433654
"77.197.128.82",64946,"41.177.26.176",80,25,11801,10,949,15,10852,109.290267,1.8292859999999962,4150.253158882764,47458.95393065938
"77.197.128.82",1826,"41.177.26.176",80,26,13513,10,948,16,12565,111.193665,1.6228729999999985,4673.193774250978,61939.53562601639
"77.197.128.82",3797,"41.177.26.176",80,20,13097,8,906,12,12191,112.830465,1.1580019999999962,6259.056547398039,84220.9253524608
"77.197.128.82",4545,"41.177.26.176",80,21,12875,8,814,13,12061,114.062525,0.6534940000000091,9964.89638772492,147649.4045851969
"77.197.128.82",5147,"41.177.26.176",80,20,13077,8,862,12,12215,114.87231,0.6884309999999942,10016.980641487757,141945.9611783909
"77.197.128.82",5641,"41.177.26.176",80,22,14210,10,951,12,13259,115.732776,0.6445750000000032,11803.126090834987,164561.14494046383
"77.197.128.82",6010,"41.177.26.176",80,20,12501,8,823,12,11678,116.433856,0.5515119999999882,11938.090195680494,169396.13281307023
"77.197.128.82",6275,"41.177.26.176",80,18,12911,7,759,11,12152,117.100297,0.6491960000000034,9353.107536090745,149748.3040560932
"77.197.128.82",7040,"41.177.26.176",80,21,12816,9,875,12,11941,118.114965,0.6252470000000017,11195.575508558988,152784.4195973747
"77.197.128.82",7418,"41.177.26.176",80,20,12576,8,862,12,11714,118.932535,0.6606850000000009,10437.65183105412,141840.66537003242
"77.197.128.82",7812,"41.177.26.176",80,20,13193,8,815,12,12378,119.752632,0.6308879999999988,10334.639428868535,156959.71392703647
"77.197.128.82",10722,"41.177.26.176",80,21,12869,8,825,13,12044,120.590338,0.6446959999999962,10237.383200764452,149453.38578182674
"77.197.128.82",11122,"41.177.26.176",80,21,12966,8,862,13,12104,121.3602,0.5589719999999971,12336.932798065083,173232.29070508093
"77.197.128.82",11579,"41.177.26.176",80,19,12580,8,821,11,11759,122.153798,0.6477119999999985,10140.309273257273,145237.38945704297
"77.197.128.82",29784,"41.177.26.176",80,21,12621,9,879,12,11742,153.864954,0.5320289999999943,13217.324619522762,176561.803961816
"77.197.128.82",30405,"41.177.26.176",80,11,5458,5,792,6,4666,154.42933,0.9325440000000071,6794.317479925828,40028.13808249232
"77.197.128.82",31136,"41.177.26.176",80,20,12579,8,812,12,11767,155.506041,0.6048479999999756,10739.888368648424,155635.79610084483
"77.197.128.82",31449,"41.177.26.176",80,20,12954,8,860,12,12094,156.114014,0.63584800000001,10820.196021690548,152162.1519608436
"77.197.128.82",31881,"41.177.26.176",80,21,12633,8,825,13,11808,156.927594,0.5373629999999991,12282.200300355646,175791.78320799934
"77.197.128.82",32226,"41.177.26.176",80,21,12766,9,887,12,11879,157.608799,0.5302299999999889,13382.871584029854,179227.8822397865
"77.197.128.82",32499,"41.177.26.176",80,25,12702,10,939,15,11763,158.202997,1.6623149999999782,4518.999106667568,56610.20925636912
"77.197.128.82",33291,"41.177.26.176",80,21,12848,8,812,13,12036,160.043289,0.6843259999999987,9492.551795489302,140704.86873215425
"77.197.128.82",33619,"41.177.26.176",80,23,12097,9,873,14,11224,160.853184,1.7203149999999994,4059.72162074969,52195.09217788604
"77.197.128.82",34273,"41.177.26.176",80,21,12974,9,924,12,12050,162.733196,0.5227890000000173,14139.547695149966,184395.616587183
"77.197.128.82",34491,"41.177.26.176",80,33,19106,13,1178,20,17928,163.346614,1.0861380000000054,8676.613837283985,132049.5185694629
"77.197.128.82",34913,"41.177.26.176",80,20,12964,8,823,12,12141,164.558801,0.6072550000000092,10842.2326699655,159945.98644720673
"77.197.128.82",35230,"41.177.26.176",80,34,24727,13,1152,21,23575,165.19764,1.6430019999999956,5609.244541394365,114789.87852723278
"77.197.128.82",35894,"41.177.26.176",80,21,13056,8,816,13,12240,167.060134,0.6554099999999892,9960.177598755143,149402.66398132715
"77.197.128.82",36130,"41.177.26.176",80,20,13277,8,815,12,12462,167.804538,0.647691999999978,10066.51309573103,153925.0137411044
"77.197.128.82",36322,"41.177.26.176",80,21,12763,9,876,12,11887,168.618326,0.587173000000007,11935.153694055953,161955.67575484375
"77.197.128.82",36540,"41.177.26.176",80,25,11870,10,930,15,10940,169.399527,1.6728279999999813,4447.558266600083,52318.58864151065
"77.197.128.82",36921,"41.177.26.176",80,20,13020,8,812,12,12208,171.25883,0.7102580000000103,9145.972308653907,137504.96298527942
"77.197.128.82",37064,"41.177.26.176",80,22,12899,9,887,13,12012,172.073467,0.6261460000000056,11332.820140989379,153472.19338620568
"77.197.128.82",37163,"41.177.26.176",80,20,12890,9,924,11,11966,172.711889,0.6383989999999926,11578.965505898483,149950.1095709754
"77.197.128.82",37273,"41.177.26.176",80,22,13409,8,862,14,12547,173.500119,0.6338449999999796,10879.631455640136,158360.48245233967
"77.197.128.82",37379,"41.177.26.176",80,20,12694,8,825,12,11869,174.141934,0.5530050000000131,11934.79263297772,171701.88334643946
"77.197.128.82",37544,"41.177.26.176",80,20,12663,8,821,12,11842,174.762465,0.5875120000000038,11179.34612399399,161249.47235120198
"77.197.128.82",37704,"41.177.26.176",80,22,12737,9,880,13,11857,175.3898,0.5813109999999995,12110.556999609515,163175.99357314775
"77.197.128.82",37790,"41.177.26.176",80,21,12894,8,813,13,12081,176.15223,0.6950239999999894,9357.95022905698,139057.06853288732
"77.197.128.82",37856,"41.177.26.176",80,20,13074,8,824,12,12250,176.938835,0.6168419999999912,10686.691243462821,158873.74724808199
"77.197.128.82",37936,"41.177.26.176",80,22,12852,9,890,13,11962,177.558807,0.5931860000000029,12002.980515386347,161325.45272477693
"77.197.128.82",38031,"41.177.26.176",80,24,11596,9,883,15,10713,178.164981,1.1444379999999796,6172.461942018813,74887.41198736981
"77.197.128.82",38196,"41.177.26.176",80,25,11910,10,976,15,10934,179.388282,1.241753999999986,6287.879886032248,70442.29372323422
"77.197.128.82",38290,"41.177.26.176",80,19,12990,8,823,11,12167,180.823444,0.6094280000000083,10803.57318666013,159716.9805128722
"77.197.128.84",54903,"41.177.26.176",80,20,13265,9,872,11,12393,34.342652,0.7136980000000008,9774.442411215938,138915.9000025219
"77.197.128.84",55363,"41.177.26.176",80,22,12594,9,881,13,11713,35.324812,0.7104719999999958,9920.165748966943,131889.78594511896
"77.197.128.84",55701,"41.177.26.176",80,22,12855,9,889,13,11966,36.327758,0.7176979999999986,9909.460525179133,133382.00747389597
"77.197.128.84",56126,"41.177.26.176",80,21,13339,9,872,12,12467,37.557573,0.6636430000000004,10511.67570516075,150285.6204314668
"77.197.128.84",56422,"41.177.26.176",80,21,12966,9,924,12,12042,38.363099,0.708826000000002,10428.51136950391,135909.23583502826
"77.197.128.84",56704,"41.177.26.176",80,23,11525,9,889,14,10636,39.190286,1.525849000000001,4661.011672845738,55764.36462585744
"77.197.128.84",57310,"41.177.26.176",80,20,12730,8,816,12,11914,41.049923,0.6396990000000002,10204.79944473885,148995.0742458562
"77.197.128.84",57598,"41.177.26.176",80,20,12825,8,816,12,12009,41.87085,0.6520430000000061,10011.60966377975,147339.97604452327
"77.197.128.84",57876,"41.177.26.176",80,23,12982,10,943,13,12039,42.664898,0.6117580000000018,12331.673635653278,157434.8026507209
"77.197.128.84",58185,"41.177.26.176",80,19,12986,7,796,12,12190,43.498131,0.6202010000000016,10267.639039601652,157239.3465989248
"77.197.128.84",58526,"41.177.26.176",80,23,13388,10,990,13,12398,44.297386,0.7373569999999958,10741.065725286455,134512.86147687017
"77.197.128.84",58868,"41.177.26.176",80,20,12620,8,826,12,11794,45.320075,0.7244679999999946,9121.175814528799,130236.25612173445
"77.197.128.84",59248,"41.177.26.176",80,21,13080,9,926,12,12154,46.7689,0.7585869999999986,9765.524587160093,128175.1466871963
"77.197.128.84",59593,"41.177.26.176",80,20,12548,8,813,12,11735,47.789933,0.576948999999999,11273.093462333778,162718.02187021758
"77.197.128.84",59761,"41.177.26.176",80,20,12675,7,761,13,11914,48.389983,0.6856190000000026,8879.567223195356,139015.98409612282
"77.197.128.84",60013,"41.177.26.176",80,24,13381,11,1015,13,12366,49.200005,0.6723169999999996,12077.635996114936,147144.87362360323
"77.197.128.84",60354,"41.177.26.176",80,22,12004,9,904,13,11100,50.025294,1.1691119999999984,6185.891514243298,75955.08385851837
"77.197.128.84",60793,"41.177.26.176",80,20,12565,8,811,12,11754,51.419088,0.5485339999999965,11827.89034043476,171424.19613004953
"77.197.128.84",61002,"41.177.26.176",80,22,13689,9,889,13,12800,52.038315,1.0134180000000015,7017.8346940748925,101044.18907104457
"77.197.128.84",61340,"41.177.26.176",80,24,12237,9,886,15,11351,53.252091,1.9476670000000027,3639.2258019466317,46623.98654390092
"77.197.128.84",61845,"41.177.26.176",80,21,12662,9,879,12,11783,55.286045,0.6227109999999954,11292.557863920907,151376.80240111498
"77.197.128.84",62028,"41.177.26.176",80,19,12542,8,825,11,11717,56.140651,0.6500570000000039,10152.95581772054,144196.58583785643
"77.197.128.84",62249,"41.177.26.176",80,22,14103,10,989,12,13114,56.953298,0.6791440000000009,11649.959360606867,154476.81198685383
"77.197.128.84",62485,"41.177.26.176",80,21,12863,9,889,12,11974,57.763174,0.8160519999999991,8715.130898521182,117384.67646669588
"77.197.128.84",62688,"41.177.26.176",80,22,13334,9,924,13,12410,58.769151,0.6699739999999963,11033.26397740814,148184.85493466991
"77.197.128.84",62842,"41.177.26.176",80,19,12723,8,825,11,11898,59.579167,0.6840219999999988,9648.812465096169,139153.41904207785
"77.197.128.84",62952,"41.177.26.176",80,25,12230,10,951,15,11279,60.39488,1.180489999999999,6444.781404332105,76436.05621394512
"77.197.128.84",63092,"41.177.26.176",80,22,12973,9,876,13,12097,61.602932,0.6552030000000002,10695.921721970135,147703.84140487752
"77.197.128.84",63275,"41.177.26.176",80,22,12727,9,880,13,11847,62.421417,1.3233829999999998,5319.699588101103,71616.45570481109
"77.197.128.84",58941,"41.177.26.15",80,79,71330,29,2159,50,69171,186.277831,1.876810000000006,9202.849515933922,294844.97631619516
"77.197.128.92",21000,"41.177.26.176",80,18,11438,6,384,12,11054,1.315617,0.17287199999999991,17770.37345550466,511546.11504465755
"77.197.128.92",21544,"41.177.26.176",80,19,12810,7,759,12,12051,1.639867,0.6467579999999999,9388.36473611459,149063.48278645182
"77.197.128.92",21786,"41.177.26.176",80,37,28072,15,1263,22,26809,2.452636,0.7971119999999998,12675.759491765275,269061.3113339155
"77.197.128.92",39327,"244.3.210.197",80,16,11303,7,760,9,10543,34.176533,0.7714539999999985,7881.2216930627255,109331.2109341583
"77.197.128.94",58108,"41.177.26.176",80,22,13471,9,927,13,12544,63.809252,0.6650790000000057,11150.555046843963,150887.33819591228
"77.197.128.94",59012,"41.177.26.176",80,19,12643,8,825,11,11818,64.474998,0.6988740000000035,9443.762394938096,135280.46543439807
"77.197.128.94",59594,"41.177.26.176",80,22,12994,9,925,13,12069,65.174457,0.5538799999999924,13360.294648660543,174319.34715100983
"77.197.128.94",60032,"41.177.26.176",80,21,12743,8,826,13,11917,65.729084,0.6231279999999941,10604.562786458098,152995.8531794445
"77.197.128.94",60541,"41.177.26.176",80,22,12980,9,924,13,12056,66.352457,0.569790999999995,12973.177884522684,169269.08287424836
"77.197.128.94",60955,"41.177.26.176",80,22,12927,9,877,13,12050,66.922938,0.7102859999999964,9877.711231813713,135719.977586494
"77.197.128.94",61524,"41.177.26.176",80,25,11417,10,938,15,10479,67.633508,1.2422339999999963,6040.729846389668,67484.8700003383
"77.197.128.94",62421,"41.177.26.176",80,20,12565,8,823,12,11742,68.876434,0.6161259999999942,10686.125889834324,152462.3210187541
"77.197.128.94",62827,"41.177.26.176",80,22,12944,9,880,13,12064,69.493317,0.6718589999999978,10478.389066753625,143649.1882969497
"77.197.128.94",63375,"41.177.26.176",80,22,13298,9,924,13,12374,70.165708,0.6725670000000008,10990.726574452792,147185.33618211997
"77.197.128.94",63826,"41.177.26.176",80,25,12028,10,938,15,11090,70.838789,1.1097809999999981,6761.694424395455,79943.70060399317
"77.197.128.94",64589,"41.177.26.176",80,21,12689,8,826,13,11863,71.949131,0.6386640000000057,10346.598524419634,148597.69769393478
"77.197.128.94",65028,"41.177.26.176",80,36,28269,14,1176,22,27093,72.588457,0.8184289999999947,11495.193840883034,264829.32545156806
"77.197.128.94",1105,"41.177.26.176",80,25,11908,10,935,15,10973,73.407164,1.7874790000000047,4184.664547107955,49110.50703253004
"77.197.128.94",3197,"41.177.26.176",80,19,13560,8,862,11,12698,75.195311,0.6677269999999993,10327.573993563248,152134.03082397464
"77.197.128.94",3668,"41.177.26.176",80,18,12456,7,761,11,11695,75.863527,0.6430529999999948,9467.337839960392,145493.4507731101
"77.197.128.94",3955,"41.177.26.176",80,20,12677,8,823,12,11854,76.507269,0.6024770000000075,10928.218006662359,157403.519138488
"77.197.128.94",4197,"41.177.26.176",80,20,12709,8,816,12,11893,77.110025,0.6797070000000076,9604.138253688614,139977.96109205723
"77.197.128.94",4449,"41.177.26.176",80,21,12802,9,890,12,11912,77.790095,0.7178380000000004,9918.672458131216,132754.18687781916
"77.197.128.94",4723,"41.177.26.176",80,20,12804,8,862,12,11942,78.508563,0.7337180000000103,9398.70631496011,130208.06358846131
"77.197.128.94",4900,"41.177.26.176",80,21,13380,9,924,12,12456,79.242599,0.644590000000008,11467.75469678386,154591.2905878136
"77.197.128.94",5083,"41.177.26.176",80,22,13239,9,889,13,12350,79.887576,0.726216000000008,9793.229562554285,136047.6772750792
"77.197.128.94",5325,"41.177.26.176",80,24,13753,10,1001,14,12752,80.613932,3.341208999999992,2396.7372289491673,30532.660483076706
"77.197.128.94",6463,"41.177.26.176",80,21,12814,8,826,13,11988,83.955622,0.6915269999999936,9555.664493215827,138684.3897635246
"77.197.128.94",6631,"41.177.26.176",80,21,12878,9,890,12,11988,84.647528,0.7872850000000113,9043.738925547797,121816.11487580561
"77.197.128.94",7036,"41.177.26.176",80,20,12656,8,814,12,11842,85.435435,0.568366999999995,11457.385808817291,166681.03531697099
"77.197.128.94",7175,"41.177.26.176",80,20,13096,8,823,12,12273,86.004528,0.6041260000000079,10898.388746718256,162522.38771381916
"77.197.128.94",7278,"41.177.26.176",80,21,12669,9,876,12,11793,86.609089,0.5523419999999959,12687.791259763068,170807.21726756377
"77.197.128.94",7377,"41.177.26.176",80,7,1446,4,521,3,925,87.161964,0.16592900000000554,25119.177479523536,44597.38803946117
"77.197.128.94",7406,"41.177.26.176",80,20,12728,9,889,11,11839,87.328393,0.6499879999999933,10941.740462900965,145713.45932540443
"77.197.128.94",11852,"41.177.26.176",80,20,12911,8,816,12,12095,93.96389,0.6667879999999968,9790.218180291233,145113.5893267432
"77.197.128.94",12660,"41.177.26.176",80,21,12669,8,812,13,11857,95.189671,0.6362879999999933,10209.21343794016,149077.14745524197
"77.197.128.94",13428,"41.177.26.176",80,20,12682,8,815,12,11867,95.901378,0.545607000000004,11949.993310203045,174000.7001376436
"77.197.128.94",13952,"41.177.26.176",80,22,13166,9,924,13,12242,96.592133,0.6237959999999987,11850.027893734516,157000.04488646964
"77.197.128.94",14347,"41.177.26.176",80,22,12999,9,890,13,12109,97.217897,0.6647960000000097,10710.052407054038,145716.88156968242
"77.197.128.94",14773,"41.177.26.176",80,20,12887,8,860,12,12027,98.016413,0.5671099999999996,12131.685210982007,169660.2070145123
"77.197.128.94",15119,"41.177.26.176",80,19,12795,8,861,11,11934,98.646282,0.666008000000005,10342.218111494078,143349.6294338796
"77.197.128.94",15524,"41.177.26.176",80,18,12769,7,753,11,12016,99.442227,0.6988850000000042,8619.443828383732,137544.80350844478
"77.197.128.94",15923,"41.177.26.176",80,20,12667,8,811,12,11856,100.251723,0.6393350000000027,10148.04445243882,148354.149233187
"77.197.128.94",16288,"41.177.26.176",80,31,17080,13,1154,18,15926,101.078148,1.5598810000000043,5918.400185655171,81678.02543911981
"77.197.128.94",17004,"41.177.26.176",80,20,12868,8,816,12,12052,102.686442,0.6337740000000025,10300.201649168275,152129.93906345105
"77.197.128.94",17318,"41.177.26.176",80,21,12713,8,813,13,11900,103.499715,0.6408750000000083,10148.62492685768,148546.9085235011
"77.197.128.94",17623,"41.177.26.176",80,25,12883,10,978,15,11905,104.342059,1.086476999999988,7201.25690649695,87659.47185260347
"77.197.128.94",18089,"41.177.26.176",80,20,12845,8,826,12,12019,105.560158,0.6966549999999927,9485.32630929236,138019.53621233036
"77.197.128.94",18359,"41.177.26.176",80,20,12703,8,808,12,11895,106.372187,0.7103180000000009,9100.14951050092,133968.166370555
"77.197.128.94",18656,"41.177.26.176",80,20,12658,8,811,12,11847,107.185066,0.5457380000000001,11888.488615416187,173665.75169770108
"77.197.128.94",18870,"41.177.26.176",80,22,13951,9,889,13,13062,107.780711,0.6466740000000044,10997.81342685797,161589.92011430688
"77.197.128.94",19175,"41.177.26.176",80,23,11556,9,883,14,10673,108.607585,1.069736000000006,6603.498433258262,79817.82421083289
"77.197.128.94",19608,"41.177.26.176",80,37,28208,15,1263,22,26945,109.810834,0.7447350000000057,13567.24203911448,289445.23891048273
"77.197.128.94",19876,"41.177.26.176",80,22,12804,9,880,13,11924,110.637275,0.5212269999999961,13506.591178124028,183014.31046358056
"77.197.128.94",20085,"41.177.26.176",80,22,13131,9,880,13,12251,111.238357,0.6851850000000042,10274.59737151274,143038.74136182113
"77.197.128.94",20297,"41.177.26.176",80,24,14366,10,990,14,13376,112.046523,0.7421660000000116,10671.467030286858,144183.37676476466
"77.197.128.94",20502,"41.177.26.176",80,21,12662,8,816,13,11846,112.857053,0.6912140000000022,9444.253154594639,137103.7044967256
"77.197.128.94",20697,"41.177.26.176",80,22,13657,9,877,13,12780,113.670097,0.6637099999999947,10570.881861053858,154043.18150999807
"77.197.128.94",20957,"41.177.26.176",80,20,12919,8,823,12,12096,114.529723,0.6068169999999924,10850.058584383896,159468.17574326563
"77.197.128.94",21247,"41.177.26.176",80,19,12507,8,815,11,11692,115.342627,0.6429000000000116,10141.54611914743,145490.74506143772
"77.197.128.94",21614,"41.177.26.176",80,25,11878,10,980,15,10898,116.156918,1.0494149999999962,7470.828985672997,83078.66763863707
"77.197.128.94",22120,"41.177.26.176",80,21,13417,8,862,13,12555,117.373223,0.6923460000000006,9960.337750200037,145071.97268417804
"77.197.128.94",22498,"41.177.26.176",80,19,9293,7,779,12,8514,118.185686,0.8526069999999919,7309.346510174159,79886.74735253246
"77.197.128.94",22913,"41.177.26.176",80,21,12615,9,887,12,11728,119.200422,0.6321999999999974,11224.296108826366,148408.73141411005
"77.197.128.94",36553,"41.177.26.176",80,29,14976,12,1086,17,13890,155.154203,1.3017509999999959,6674.087440685682,85361.94710048262
"77.197.128.94",39211,"41.177.26.176",80,18,12733,7,758,11,11975,158.150918,0.6634490000000142,9140.114763907806,144396.93179128758
"77.197.128.94",40203,"41.177.26.176",80,21,13302,8,815,13,12487,159.547672,0.6351489999999842,10265.307825408152,157279.6304489222
"77.197.128.94",40889,"41.177.26.176",80,19,12661,8,816,11,11845,160.355143,0.6573649999999986,9930.556083758664,144151.2706030899
"77.197.128.94",41484,"41.177.26.176",80,24,11814,10,956,14,10858,161.202242,1.5469449999999938,4943.9378904874,56151.96403233492
"77.197.128.94",42409,"41.177.26.176",80,21,12646,8,808,13,11838,162.818243,0.7004950000000179,9227.760369452795,135195.82580888883
"77.197.128.94",42791,"41.177.26.176",80,30,15027,12,1096,18,13931,163.605885,1.2464689999999905,7034.270407045877,89410.96810269718
"77.197.128.94",43356,"41.177.26.176",80,19,12919,8,813,11,12106,164.918029,0.6657069999999976,9770.064007138311,145481.42050481722
"77.197.128.94",43696,"41.177.26.176",80,22,13489,9,927,13,12562,165.73694,0.6963690000000042,10649.526328713591,144314.2931405611
"77.197.128.94",43992,"41.177.26.176",80,21,12690,9,877,12,11813,166.513155,0.6272819999999797,11184.762196269345,150656.32363116278
"77.197.128.94",44281,"41.177.26.176",80,20,12711,8,816,12,11895,167.316438,0.6492580000000032,10054.554583847974,146567.31222410742
"77.197.128.94",44619,"41.177.26.176",80,21,12698,9,880,12,11818,168.153502,0.6320719999999937,11137.971623486043,149577.89618904324
"77.197.128.94",44890,"41.177.26.176",80,21,12784,8,817,13,11967,168.949078,0.7024850000000242,9304.113255086977,136281.9134928101
"77.197.128.94",45105,"41.177.26.176",80,22,13326,9,926,13,12400,169.730207,0.7481249999999875,9902.0885547203,132598.1620718485
"77.197.128.94",45317,"41.177.26.176",80,22,11427,9,919,13,10508,170.543544,1.0138070000000141,7251.873384184462,82919.13549620275
"77.197.128.94",45535,"41.177.26.176",80,20,12695,8,824,12,11871,171.577694,0.6388729999999896,10318.16965187151,148649.26205991104
"77.197.128.94",45717,"41.177.26.176",80,21,12957,9,872,12,12085,172.371498,0.7083999999999833,9847.543760587472,136476.56691135274
"77.197.128.94",45888,"41.177.26.176",80,22,13088,9,889,13,12199,173.186985,0.6683940000000064,10640.430644200775,146009.6888960689
"77.197.128.94",46057,"41.177.26.176",80,22,12206,9,880,13,11326,174.005102,0.5806259999999952,12124.844564315166,156052.26083572
"77.197.128.94",46247,"41.177.26.176",80,21,12968,9,926,12,12042,174.719167,0.6849699999999928,10815.072192942871,140642.6558827409
"77.197.128.94",46417,"41.177.26.176",80,22,13561,9,889,13,12672,175.450253,0.6927929999999947,10265.692638349485,146329.42307442595
"77.197.128.94",46645,"41.177.26.176",80,19,12836,8,826,11,12010,176.278783,0.7248809999999821,9115.979036559329,132545.89373980332
"77.197.128.94",46875,"41.177.26.176",80,19,12773,8,815,11,11958,177.07586,0.6317389999999818,10320.717891407983,151429.62520914926
"77.197.128.94",47086,"41.177.26.176",80,20,12582,8,816,12,11766,177.708227,0.6450399999999945,10120.302616892062,145925.83405680393
"77.197.128.94",47319,"41.177.26.176",80,21,13032,9,880,12,12152,178.474059,0.7172559999999919,9815.184536623017,135538.7755557306
"77.197.128.94",47577,"41.177.26.176",80,25,12533,10,964,15,11569,179.294893,1.4709220000000016,5242.970055516194,62921.07943181209
"77.197.128.94",48176,"41.177.26.176",80,20,12883,8,824,12,12059,180.935799,0.631446000000011,10439.530854578039,152779.49341669487
"77.197.128.94",48501,"41.177.26.176",80,21,12936,9,889,12,12047,181.748175,0.6567589999999939,10828.934205698082,146744.84856697952
"77.197.128.94",48803,"41.177.26.176",80,22,12712,9,880,13,11832,182.545503,1.2477489999999989,5642.160402452742,75861.41122934187
"77.197.128.106",27903,"41.177.26.176",80,22,12844,9,877,13,11967,124.393198,0.7418729999999982,9457.144282107607,129046.34620750483
"77.197.128.106",28584,"41.177.26.176",80,21,12730,9,879,12,11851,125.603547,0.5668340000000001,12405.748420172395,167258.84474114113
"77.197.128.106",28973,"41.177.26.176",80,21,12942,8,860,13,12082,126.393763,0.5763479999999959,11937.232366556402,167704.23424736565
"77.197.128.106",29372,"41.177.26.176",80,22,13431,9,926,13,12505,127.228351,0.7315380000000005,10126.609964212379,136752.97797243606
"77.197.128.106",29773,"41.177.26.176",80,22,13106,9,880,13,12226,128.013782,0.6430359999999951,10948.06511610556,152103.45921534835
"77.197.128.106",30144,"41.177.26.176",80,24,11944,9,905,15,11039,128.810805,1.0683750000000032,6776.646776646757,82660.11466011441
"77.197.128.106",30690,"41.177.26.176",80,25,12745,10,976,15,11769,130.001482,1.1055439999999805,7062.5863828125675,85163.50321651754
"77.197.128.106",31235,"41.177.26.176",80,19,12653,8,816,11,11837,131.236583,0.645573000000013,10111.94706098283,146685.1928441835
"77.197.128.106",31564,"41.177.26.176",80,23,11677,9,894,14,10783,132.064756,1.0162240000000224,7037.81843373099,84886.79661176876
"77.197.128.106",31919,"41.177.26.176",80,25,12838,10,971,15,11867,133.10317,1.237794000000008,6275.68076755902,76697.73807273211
"77.197.128.106",32345,"41.177.26.176",80,22,13731,9,924,13,12807,134.457701,0.6187350000000151,11946.956289849159,165589.4688356041
"77.197.128.106",32545,"41.177.26.176",80,22,12787,9,871,13,11916,135.272029,0.5072669999999846,13736.355804734414,187924.7023756777
"77.197.128.106",32710,"41.177.26.176",80,21,13799,8,863,13,12936,135.84775,0.7072610000000168,9761.601445576436,146322.22050982245
"77.197.128.106",32922,"41.177.26.176",80,25,12604,10,971,15,11633,136.667859,1.1755530000000078,6607.953873623689,79166.14563528771
"77.197.128.106",33179,"41.177.26.176",80,21,12575,9,889,12,11686,137.89926,0.5785700000000134,12292.376030557816,161584.59650517284
"77.197.128.106",33360,"41.177.26.176",80,22,12711,9,879,13,11832,138.70235,0.527624000000003,13327.672736645718,179400.48216153827
"77.197.128.106",33483,"41.177.26.176",80,19,12660,7,762,12,11898,139.295137,0.6578480000000013,9266.578297722252,144689.95877467107
"77.197.128.106",33662,"41.177.26.176",80,21,12798,8,816,13,11982,140.11441,0.6449900000000071,10121.087148637853,148616.25761639554
"77.197.128.106",33813,"41.177.26.176",80,20,13060,8,825,12,12235,140.9345,0.6057729999999992,10895.170303067334,161578.67716124706
"77.197.128.106",33937,"41.177.26.176",80,22,12963,9,924,13,12039,141.734215,0.5147379999999941,14360.703892077297,187108.78155489024
"77.197.128.106",34021,"41.177.26.176",80,21,13901,9,887,12,13014,142.348847,0.6338959999999929,11194.265305349898,164241.45285662185
"77.197.128.106",34141,"41.177.26.176",80,25,12265,10,937,15,11328,143.156623,1.8745700000000056,3998.7837210666858,48343.88686472083
"77.197.128.106",34459,"41.177.26.176",80,20,12911,8,862,12,12049,145.187628,0.759112000000016,9084.2984961374,126979.94498835214
"77.197.128.106",34590,"41.177.26.176",80,20,13111,8,823,12,12288,145.998811,0.5895830000000046,11167.214794184954,166734.7939136631
"77.197.128.106",34695,"41.177.26.176",80,18,12561,7,752,11,11809,146.617326,0.6406780000000083,9390.05241322462,147456.28849437437
"77.197.128.106",34820,"41.177.26.176",80,21,12910,9,879,12,12031,147.418305,0.5903840000000002,11910.891894089265,163026.0982682457
"77.197.128.106",34921,"41.177.26.176",80,19,12969,8,863,11,12106,148.030698,0.765119999999996,9023.421162693481,126578.83730656694
"77.197.128.106",35016,"41.177.26.176",80,21,13488,8,862,13,12626,148.84555,0.6781990000000064,10168.10700104237,148935.63688533756
"77.197.128.106",35135,"41.177.26.176",80,22,12941,9,926,13,12015,149.651475,0.5763340000000028,12853.657774831892,166778.29175443324
"77.197.128.106",35248,"41.177.26.176",80,22,13678,9,889,13,12789,150.260987,0.675926000000004,10521.861860617815,151365.68204211612
"77.197.128.106",52719,"41.177.26.176",80,22,13121,9,926,13,12195,185.740859,0.746075999999988,9929.283343788193,130764.15807505076
"77.197.128.106",54039,"41.177.26.15",80,85,75170,32,2351,53,72819,187.302087,1.0124619999999993,18576.499661221867,575381.594568488
"77.197.128.106",59875,"41.177.26.176",80,20,13246,7,759,13,12487,194.884728,0.603572000000014,10060.108818831653,165508.00898649654
"77.197.128.106",60351,"41.177.26.15",80,43,38265,15,1263,28,37002,195.521884,0.9692699999999945,10424.339967191863,305400.9718654262
"77.197.128.106",62293,"41.177.26.176",80,22,12736,9,876,13,11860,198.113388,0.5877499999999998,11923.4368353892,161429.17907273507
"77.197.128.106",62427,"41.177.26.15",80,42,37023,15,1263,27,35760,198.284554,1.0458119999999838,9661.392296129856,273548.20942961494
"77.197.128.106",63019,"41.177.26.176",80,21,12761,8,825,13,11936,199.033777,0.6854080000000238,9629.301087818892,139315.56095055307
"77.197.128.106",63394,"41.177.26.15",80,138,129746,47,3311,91,126435,199.494558,0.9316329999999766,28431.796640952678,1085706.4960129422
"77.197.128.106",63621,"41.177.26.176",80,22,13561,9,880,13,12681,199.809719,0.6090790000000084,11558.434948504058,166559.67452497722
"77.197.128.106",63996,"41.177.26.15",80,432,420139,142,9392,290,410747,200.573023,2.0026639999999816,37518.02598938249,1640802.4511351031
"77.197.128.106",64109,"41.177.26.176",80,22,12806,9,887,13,11919,200.720893,0.5568700000000035,12742.650887998914,171228.47343185914
"77.197.128.106",64547,"41.177.26.176",80,23,12964,9,922,14,12042,201.435843,1.1146090000000015,6617.567236582506,86430.30874503963
"77.197.128.106",65244,"41.177.26.176",80,22,12916,9,924,13,11992,202.655165,0.5763439999999775,12825.67355607118,166456.1442471922
"77.197.128.106",65523,"41.177.26.176",80,19,12502,7,752,12,11750,203.310768,0.637929000000014,9430.51656218775,147351.82128418356
"77.197.128.106",1249,"41.177.26.176",80,20,12755,8,823,12,11932,204.052031,0.6245969999999943,10541.196963802357,152828.1435869863
"77.197.128.106",1390,"41.177.26.176",80,20,12928,8,863,12,12065,204.680679,0.6836260000000038,10099.08926810853,141188.31056747324
"77.197.128.106",1601,"41.177.26.176",80,20,13270,8,812,12,12458,205.501856,0.6665059999999983,9746.348870077714,149532.03722097064
"77.197.128.106",1783,"41.177.26.176",80,29,14759,12,1078,17,13681,206.293595,1.7361760000000004,4967.238344499635,63039.69182847821
"77.197.128.106",3296,"41.177.26.176",80,23,14046,10,988,13,13058,208.112873,0.6062289999999848,13037.977397980298,172317.7215210797
"77.197.128.106",3514,"41.177.26.176",80,19,13220,8,862,11,12358,208.732537,0.6890839999999798,10007.488201728966,143471.62319833707
"77.197.128.106",3768,"41.177.26.176",80,20,12686,8,823,12,11863,209.543768,0.5261639999999943,12513.208809420772,180369.61859800562
"77.197.128.106",3943,"41.177.26.176",80,20,13062,8,825,12,12237,210.171334,0.6594470000000001,10008.385814174602,148451.65722188438
"77.197.128.106",4176,"41.177.26.176",80,19,13185,7,752,12,12433,210.994828,0.6459739999999954,9313.068327827503,153975.23739345657
"77.197.128.106",4425,"41.177.26.176",80,20,12597,8,823,12,11774,211.80319,0.5564449999999965,11832.256557251914,169274.59137920296
"77.197.128.106",4574,"41.177.26.176",80,18,13032,6,688,12,12344,212.415059,0.6089689999999734,9038.22690481821,162162.6059783081
"77.197.128.108",36939,"41.177.26.15",80,21,16882,9,576,12,16306,0.081237,0.24718,18642.2849745125,527744.9631847236
"77.197.128.108",37300,"41.177.26.15",80,224,220520,70,4784,154,215736,0.504911,1.2109619999999999,31604.62508319832,1425220.6097301156
"77.197.128.108",47681,"41.177.26.176",80,22,12994,9,879,13,12115,33.916237,0.6410020000000003,10970.32458557071,151200.7762846293
"77.197.128.108",48357,"41.177.26.176",80,22,13109,9,889,13,12220,34.703328,0.6457049999999995,11014.31768377201,151400.40730674236
"77.197.128.108",48991,"41.177.26.176",80,22,13204,9,880,13,12324,35.371925,0.6586720000000028,10688.172565404284,149682.99851823
"77.197.128.108",49595,"41.177.26.176",80,19,12826,8,860,11,11966,36.041643,0.6537500000000023,10523.90057361373,146429.06309751383
"77.197.128.108",50132,"41.177.26.176",80,22,12860,9,880,13,11980,36.704233,0.6419670000000011,10966.295775327997,149291.16294139705
"77.197.128.108",50673,"41.177.26.176",80,22,12810,9,887,13,11923,37.349673,0.5314440000000005,13352.300524608414,179480.8107721602
"77.197.128.108",51104,"41.177.26.176",80,20,12612,8,817,12,11795,37.883579,0.6146969999999996,10632.880915312755,153506.52435264864
"77.197.128.108",51610,"41.177.26.176",80,22,12699,9,887,13,11812,38.50403,0.525457000000003,13504.43518689438,179835.83813708727
"77.197.128.108",52053,"41.177.26.176",80,25,12294,10,973,15,11321,39.121397,1.176797999999998,6614.559168183506,76961.38164748764
"77.197.128.108",53061,"41.177.26.176",80,22,13188,8,863,14,12325,40.30061,0.6748860000000008,10229.87586051569,146098.7485293811
"77.197.128.108",53555,"41.177.26.176",80,24,12500,9,889,15,11611,40.978166,2.1229749999999967,3350.015897502331,43753.69469729985
"77.197.128.108",55209,"41.177.26.176",80,18,12032,7,798,11,11234,43.106248,0.6606439999999978,9663.298236266462,136036.95787746547
"77.197.128.108",55746,"41.177.26.176",80,19,12847,8,862,11,11985,43.767854,0.6938280000000034,9939.062707183864,138189.86838236498
"77.197.128.108",56286,"41.177.26.176",80,19,12499,7,748,12,11751,44.463416,0.6538819999999959,9151.498282564802,143769.05924922324
"77.197.128.108",56801,"41.177.26.176",80,22,12729,9,889,13,11840,45.11859,0.5775040000000047,12315.066215991477,164016.17997450967
"77.197.128.108",57295,"41.177.26.176",80,24,11996,9,919,15,11077,45.698514,1.0235859999999946,7182.5913992571595,86574.06412358167
"77.197.128.108",58381,"41.177.26.176",80,25,12096,10,967,15,11129,46.723997,1.2800450000000012,6043.537531883639,69553.80474905172
"77.197.128.108",59625,"41.177.26.176",80,22,12993,9,926,13,12067,48.005166,0.6786189999999976,10916.28734238214,142253.60622086964
"77.197.128.108",60270,"41.177.26.176",80,21,12735,8,812,13,11923,48.688334,0.689068000000006,9427.226340506224,138424.65475105384
"77.197.128.108",60955,"41.177.26.176",80,24,11866,9,899,15,10967,49.389034,1.0850679999999997,6628.1560234013,80857.60523764411
"77.197.128.108",62257,"41.177.26.176",80,19,12648,8,816,11,11832,50.476186,0.6681450000000027,9770.334283725799,141669.8471140241
"77.197.128.108",63047,"41.177.26.176",80,25,11655,10,949,15,10706,51.147409,1.6983079999999973,4470.331647734105,50431.37051700878
"77.197.128.108",64678,"41.177.26.176",80,25,12550,10,977,15,11573,52.847661,1.286724999999997,6074.33600808255,71953.21455633505
"77.197.128.108",1115,"41.177.26.176",80,19,13019,8,863,11,12156,54.150923,0.7605330000000023,9077.844090920418,127868.21873607022
"77.197.128.108",1655,"41.177.26.176",80,22,13059,9,924,13,12135,54.91261,0.6255310000000023,11817.160140744381,155196.1453549059
"77.197.128.108",3090,"41.177.26.176",80,20,12735,8,817,12,11918,55.543573,0.6611569999999958,9885.700370713826,144207.8054077936
"77.197.128.108",3421,"41.177.26.176",80,20,12865,8,860,12,12005,56.205977,0.6415270000000035,10724.412222712313,149705.31248100154
"77.197.128.108",3732,"41.177.26.176",80,19,12631,8,813,11,11818,56.850935,0.6255769999999998,10396.80167269577,151130.87597529966
"77.197.128.108",4847,"41.177.26.176",80,20,12803,8,814,12,11989,57.480884,0.6112369999999956,10653.80531610496,156914.5846864648
"77.197.128.108",5110,"41.177.26.176",80,25,11995,10,936,15,11059,58.092741,3.086112,2426.3539366037267,28667.786522329716
"77.197.128.108",5990,"41.177.26.176",80,26,13583,10,972,16,12611,63.954188,1.1494539999999915,6764.951011523782,87770.36749622058
"77.197.128.108",26991,"41.177.26.176",80,21,13167,9,889,12,12278,87.405599,0.6983320000000077,10184.267654926198,140655.1611554374
"77.197.128.108",31000,"41.177.26.176",80,19,12625,8,815,11,11810,94.289758,0.6474169999999901,10070.788996890875,145933.76448255364
"77.197.128.108",32350,"41.177.26.176",80,19,12646,7,761,12,11885,96.782302,0.6603690000000029,9219.088115886683,143980.10809108178
"77.197.128.108",33174,"41.177.26.176",80,20,13181,8,860,12,12321,98.261043,0.6401010000000014,10748.303783309173,153988.19873738644
"77.197.128.108",33872,"41.177.26.176",80,20,13454,8,860,12,12594,99.532506,0.6635820000000052,10367.972609262979,151830.51981518365
"77.197.128.108",34451,"41.177.26.176",80,23,14235,9,926,14,13309,100.588227,0.7247619999999984,10221.286436099046,146906.1567797432
"77.197.128.108",34973,"41.177.26.176",80,20,12683,8,811,12,11872,101.53791,0.6294409999999999,10307.558611529914,150889.43999517034
"77.197.128.108",35431,"41.177.26.176",80,23,12963,11,1007,12,11956,102.41868,0.7836300000000023,10280.361905491081,122057.6037160391
"77.197.128.108",36307,"41.177.26.176",80,37,29024,15,1240,22,27784,104.202255,0.7298000000000116,13592.765141134343,304565.6344203843
"77.197.128.108",37035,"41.177.26.176",80,26,12454,11,1012,15,11442,105.576773,1.4805279999999925,5468.319410372544,61826.59159435044
"77.197.128.108",37930,"41.177.26.176",80,21,12622,10,988,11,11634,107.401562,0.8476050000000015,9325.098365394242,109805.86476011803
"77.197.128.108",38523,"41.177.26.176",80,19,12619,8,825,11,11794,108.591961,0.7573420000000084,8714.689004439113,124583.0813555817
"77.197.128.108",39021,"41.177.26.176",80,21,12519,9,879,12,11640,109.676946,0.8689430000000016,8092.590653241912,107164.68168798165
"77.197.128.108",39586,"41.177.26.176",80,21,12822,9,889,12,11933,110.891523,0.6843119999999914,10392.920188452183,139503.6182326208
"77.197.128.108",40181,"41.177.26.176",80,21,13056,10,944,11,12112,112.160382,1.057272999999995,7142.9044343325095,91647.0958777917
"77.197.128.108",40791,"41.177.26.176",80,35,24878,14,1216,21,23662,113.366148,1.6756790000000024,5805.407837658637,112966.74363049232
"77.197.128.108",41746,"41.177.26.176",80,21,12852,9,880,12,11972,115.359655,0.7647099999999938,9206.10427482321,125244.86406611759
"77.197.128.108",42193,"41.177.26.176",80,25,12120,10,949,15,11171,116.475695,1.999055999999996,3797.792558087425,44705.10080758127
"77.197.128.108",43222,"41.177.26.176",80,19,12726,7,751,12,11975,118.643837,0.6883559999999989,8728.04188530355,139172.1725386285
"77.197.128.108",43695,"41.177.26.176",80,23,12883,10,951,13,11932,119.699284,0.6759659999999883,11255.003949903,141214.2030812225
"77.197.128.108",44201,"41.177.26.176",80,22,12698,10,935,12,11763,120.804108,0.693327999999994,10788.544527265689,135727.96713820993
"77.197.128.108",44668,"41.177.26.176",80,21,13502,9,926,12,12576,121.807507,0.8280910000000006,8945.876721278211,121493.8937870354
"77.197.128.108",45156,"41.177.26.176",80,21,12655,8,813,13,11842,123.034151,1.3480520000000098,4824.73969846857,70276.2207986037
"77.197.128.108",64031,"41.177.26.176",80,20,13154,9,925,11,12229,155.110292,0.6153270000000077,12026.125946041548,158991.88561528875
"77.197.128.108",1805,"41.177.26.176",80,20,12923,8,826,12,12097,159.142099,0.7061429999999973,9357.877936905166,137048.72809048643
"77.197.128.108",4834,"41.177.26.176",80,18,12845,7,752,11,12093,160.967465,0.6645069999999862,9053.328256888377,145587.63113105207
"77.197.128.108",5625,"41.177.26.176",80,36,27498,15,1240,21,26258,162.048026,0.7276219999999967,13633.452534420407,288699.35213613795
"77.197.128.108",6124,"41.177.26.176",80,22,12999,9,876,13,12123,162.946926,0.6235100000000102,11239.595194944564,155545.2198040102
"77.197.128.108",6596,"41.177.26.176",80,20,12712,9,880,11,11832,163.788644,0.6524220000000014,10790.561936905844,145084.0100425795
"77.197.128.108",7264,"41.177.26.176",80,21,12683,8,817,13,11866,164.64569,0.618284999999986,10571.176722709022,153534.37330681182
"77.197.128.108",7695,"41.177.26.176",80,21,12775,9,888,12,11887,165.401526,0.5298490000000129,13407.593484181016,179477.54926403123
"77.197.128.108",10589,"41.177.26.176",80,22,12688,10,939,12,11749,166.084153,0.598809000000017,12544.901629734668,156964.90867705282
"77.197.128.108",11256,"41.177.26.176",80,31,16115,13,1133,18,14982,167.313355,1.336151000000001,6783.664421161974,89702.4363264331
"77.197.128.108",12209,"41.177.26.176",80,21,12844,9,879,12,11965,169.054295,0.6154020000000173,11426.67719636888,155540.60597787675
"77.197.128.108",12875,"41.177.26.176",80,21,12969,9,926,12,12043,170.327053,0.8650629999999921,8563.53814693273,111372.23531696637
"77.197.128.108",13546,"41.177.26.176",80,20,12696,8,823,12,11873,171.564871,0.6351829999999836,10365.516709358042,149538.0071569964
"77.197.128.108",14001,"41.177.26.176",80,23,11920,10,978,13,10942,172.448041,1.301228000000009,6012.781772295052,67271.83860168964
"77.197.128.108",14944,"41.177.26.176",80,23,13452,10,953,13,12499,174.286562,0.6494179999999972,11739.742353923102,153971.71005423384
"77.197.128.108",15501,"41.177.26.176",80,19,13242,7,744,12,12498,175.261796,0.6612509999999929,9001.120603220355,151204.30819764518
"77.197.128.108",15930,"41.177.26.176",80,21,12798,9,879,12,11919,176.142892,0.6022980000000189,11675.283663568167,158313.65868722295
"77.197.128.108",16442,"41.177.26.176",80,21,12760,9,880,12,11880,177.114899,0.8177269999999908,8609.23021986565,116224.60796818629
"77.197.128.108",16964,"41.177.26.176",80,22,12745,10,940,12,11805,178.223613,0.6938580000000059,10837.952434071432,136108.54094065243
"77.197.128.108",17481,"41.177.26.176",80,20,12536,9,876,11,11660,179.365212,0.6427109999999914,10903.812133291782,145135.2162947285
"77.197.128.108",18012,"41.177.26.176",80,21,12840,9,925,12,11915,180.384836,0.5967249999999922,12401.022246428583,159738.57304453684
"77.197.128.108",18405,"41.177.26.176",80,24,12812,11,1025,13,11787,181.133717,2.275373000000002,3603.804738827433,41441.99654298435
"77.197.128.117",3340,"41.177.26.176",80,13,7923,6,384,7,7539,0.000858,0.082239,37354.5398168752,733374.6762484952
"77.197.128.117",3788,"41.177.26.176",80,21,12812,8,816,13,11996,0.224293,0.633393,10306.397449924454,151514.1468251149
"77.197.128.117",4334,"41.177.26.176",80,22,12819,9,880,13,11939,1.049643,0.5404389999999999,13026.447018072347,176730.39880541564
"77.197.128.117",4814,"41.177.26.176",80,22,13514,9,927,13,12587,1.847426,0.7494350000000001,9895.45457578042,134362.5531233529
"77.197.128.117",5372,"41.177.26.176",80,22,12731,9,877,13,11854,2.791776,0.5663450000000001,12388.20860076455,167445.63825936484
"77.197.128.117",12909,"41.177.26.176",80,19,12654,7,752,12,11902,25.079055,0.6953390000000006,8651.894974969036,136934.6462660658
"77.197.128.117",14115,"41.177.26.176",80,21,13002,8,823,13,12179,27.927211,0.6134570000000004,10732.618586143766,158824.49788656735
"77.197.128.117",14712,"41.177.26.176",80,20,13034,8,816,12,12218,29.044345,0.6517879999999998,10015.5265208933,149962.8713630813
"77.197.128.117",15388,"41.177.26.176",80,20,12924,8,862,12,12062,30.057782,0.7407609999999991,9309.34538940361,130266.03722388209
"77.197.128.117",16010,"41.177.26.176",80,24,11084,9,875,15,10209,30.85819,1.2479069999999979,5609.392366578609,65447.18476617259
"77.197.128.117",16950,"41.177.26.176",80,22,13023,10,954,12,12069,32.42725,0.8371220000000008,9116.950695358613,115338.02719316886
"77.197.128.117",17224,"41.177.26.176",80,16,9767,7,732,9,9035,33.267132,1.5660250000000033,3739.403904790784,46155.074152711386
"77.197.128.118",4420,"41.177.26.176",80,17,11236,7,840,10,10396,0.000432,0.862042,7795.443841483362,96477.89782864408
"77.197.128.118",4940,"41.177.26.176",80,22,13112,9,879,13,12233,0.886592,0.597661,11765.867272584292,163744.99925543077
"77.197.128.118",5371,"41.177.26.176",80,27,12201,11,1031,16,11170,1.700996,2.578264,3199.0517650636243,34658.979840699016
"77.197.128.118",6124,"41.177.26.176",80,21,13604,8,825,13,12779,4.081324,0.7217669999999998,9144.22521395409,141641.27758681128
"77.197.128.118",19266,"41.177.26.176",80,20,13078,7,798,13,12280,15.966048,0.7642659999999992,8353.112659728427,128541.63341035726
"77.197.128.118",22982,"41.177.26.176",80,19,12053,8,816,11,11237,20.450483,0.6374590000000033,10240.658614906944,141022.4030094477
"77.197.128.118",24338,"41.177.26.176",80,20,12558,8,825,12,11733,21.746446,0.6483460000000001,10179.749701548246,144774.54939183706
"77.197.128.118",25099,"41.177.26.176",80,20,12775,8,823,12,11952,22.397865,0.6740230000000018,9768.212657431544,141858.66060950403
"77.197.128.118",25954,"41.177.26.176",80,20,12577,8,815,12,11762,23.116279,0.6205710000000018,10506.452928029155,151628.09734905392
"77.197.128.118",28003,"41.177.26.176",80,20,12576,8,812,12,11764,23.984198,0.5466610000000003,11883.050007225678,172157.88212438778
"77.197.128.118",28547,"41.177.26.176",80,25,12504,10,980,15,11524,24.589668,1.487532999999999,5270.4713105524415,61976.440186537075
"77.197.128.118",30067,"41.177.26.176",80,18,12517,7,752,11,11765,26.229611,0.6736970000000007,8929.83047274961,139706.72275518507
"77.197.128.118",30590,"41.177.26.176",80,19,13079,8,860,11,12219,27.045406,0.6316950000000006,10891.33205106894,154745.5655023388
"77.197.128.118",30963,"41.177.26.176",80,20,12690,8,825,12,11865,27.869523,0.5721379999999989,11535.678455197893,165904.03014657335
"77.197.128.118",31157,"41.177.26.176",80,20,13347,8,825,12,12522,28.463126,0.6462000000000003,10213.556174558955,155023.21262766936
"77.197.128.118",31373,"41.177.26.176",80,19,12760,8,823,11,11937,29.285544,0.6163460000000001,10682.311558767315,154938.94663062628
"77.197.128.118",31544,"41.177.26.176",80,20,12747,8,826,12,11921,30.089659,0.7259299999999982,9102.806055680323,131373.54841375924
"77.197.128.118",31679,"41.177.26.176",80,21,12944,9,926,12,12018,30.902962,0.6672510000000003,11102.26886134303,144089.7053732403
"77.197.128.118",31838,"41.177.26.176",80,21,13613,9,889,12,12724,31.700674,0.6538779999999988,10876.646713913013,155674.30009879547
"77.197.128.118",32013,"41.177.26.176",80,22,13583,10,953,12,12630,32.509456,1.4602270000000033,5221.1060335139555,69194.72109473374
"77.197.128.121",17012,"41.177.26.15",80,7,1030,4,638,3,392,125.747481,0.27664800000000866,18449.437552412597,11335.704577657896
"77.197.128.139",11554,"41.177.26.176",80,23,13247,9,924,14,12323,34.038047,0.8361379999999983,8840.64592208465,117903.9823569796
"77.197.128.139",12361,"41.177.26.176",80,22,12999,9,879,13,12120,35.139678,0.6237809999999939,11273.187224362506,155439.16855434992
"77.197.128.139",12915,"41.177.26.176",80,20,12383,9,879,11,11504,35.919265,0.5981689999999986,11755.875011911377,153856.18445623262
"77.197.128.139",13351,"41.177.26.176",80,22,12839,9,880,13,11959,36.620912,0.5855390000000043,12023.110330823309,163391.33687081357
"77.197.128.139",13732,"41.177.26.176",80,21,12947,9,927,12,12020,37.326756,0.602407999999997,12310.59348481434,159626.03418281378
"77.197.128.139",14140,"41.177.26.176",80,25,12764,10,921,15,11843,37.988145,1.7032579999999982,4325.827326218347,55625.160721394
"77.197.128.139",15039,"41.177.26.176",80,22,12835,9,890,13,11945,39.831594,0.5523769999999999,12889.747400778819,172997.78955314943
"77.197.128.139",15290,"41.177.26.176",80,22,13575,9,889,13,12686,40.390996,0.6621069999999989,10741.466258474857,153280.3610292599
"77.197.128.139",15613,"41.177.26.176",80,21,12682,9,890,12,11792,41.246514,0.6279859999999999,11337.83237205925,150219.90936103673
"77.197.128.139",15915,"41.177.26.176",80,22,13687,9,924,13,12763,42.132238,0.6601939999999971,11196.708846187687,154657.57035053402
"77.197.128.139",16177,"41.177.26.176",80,21,12932,8,825,13,12107,42.830994,0.7099340000000041,9296.638842483895,136429.58359509398
"77.197.128.139",16451,"41.177.26.176",80,26,13940,10,996,16,12944,43.674038,1.9894789999999958,4005.068663705431,52049.808015063354
"77.197.128.139",17087,"41.177.26.176",80,20,12576,8,816,12,11760,45.905073,0.6322890000000001,10324.392801393033,148792.71978478195
"77.197.128.139",17296,"41.177.26.176",80,25,12516,10,982,15,11534,46.700625,1.2524729999999948,6272.390702234725,73671.84761667547
"77.197.128.139",17550,"41.177.26.176",80,24,11672,9,903,15,10769,47.954009,1.2416199999999975,5818.205247982486,69386.768898697
"77.197.128.139",17856,"41.177.26.176",80,41,31326,15,1279,26,30047,49.407496,1.719260999999996,5951.394232754668,139813.55943047657
"77.197.128.139",18652,"41.177.26.176",80,21,13017,9,924,12,12093,51.221491,0.6571509999999989,11248.556267889742,147217.3062203362
"77.197.128.139",19255,"41.177.26.176",80,21,13334,9,889,12,12445,52.029043,1.0164879999999954,6996.639409417556,97945.08149628963
"77.197.128.139",19685,"41.177.26.176",80,20,12830,8,815,12,12015,53.250224,0.6053069999999963,10771.393689483255,158795.45420753534
"77.197.128.139",19928,"41.177.26.176",80,21,12768,9,890,12,11878,54.055501,0.6252449999999996,11387.536085854352,151978.82430087414
"77.197.128.139",20159,"41.177.26.176",80,20,12639,8,814,12,11825,54.893224000000004,0.643263999999995,10123.370808874819,147062.48134514093
"77.197.128.139",20403,"41.177.26.176",80,21,13410,8,862,13,12548,55.676542,0.7543000000000006,9142.251093729277,133082.32798621227
"77.197.128.139",20559,"41.177.26.176",80,21,12917,9,879,12,12038,56.475381,0.5886309999999995,11946.3636811517,163606.7417448284
"77.197.128.139",20669,"41.177.26.176",80,19,12762,8,822,11,11940,57.34611,0.6241779999999935,10535.456232036484,153033.2693558584
"77.197.128.139",20823,"41.177.26.176",80,20,12728,9,877,11,11851,58.166703,0.8953220000000002,7836.286833117022,105892.62857385386
"77.197.128.139",20994,"41.177.26.176",80,18,12527,7,751,11,11776,59.160963,0.6143239999999963,9779.855581094074,153352.3026936935
"77.197.128.139",21079,"41.177.26.176",80,21,12628,9,887,12,11741,59.777822,0.5660999999999987,12534.887829005505,165921.2153329804
"77.197.128.139",21185,"41.177.26.176",80,20,13143,8,812,12,12331,60.380073,0.6539029999999997,9934.195132917272,150860.295793107
"77.197.128.139",21302,"41.177.26.176",80,21,12664,9,889,12,11775,61.195392,0.5881680000000031,12091.783300009456,160158.32211204877
"77.197.128.139",21362,"41.177.26.176",80,20,12993,8,825,12,12168,61.803173,0.7057590000000005,9351.634198076108,137928.10293598796
"77.197.128.139",22887,"41.177.26.15",80,38,31902,14,1198,24,30704,65.393659,0.8068520000000063,11878.262680144468,304432.53533485456
"77.197.128.139",25906,"41.177.26.15",80,7,1038,4,647,3,391,70.415554,0.16907399999999484,30613.814069579934,18500.774808664228
"77.197.128.139",27266,"41.177.26.15",80,103,95430,36,2607,67,92823,73.157501,0.9554729999999978,21827.932343457167,777189.936293335
"77.197.128.142",43987,"41.177.26.176",80,19,11470,7,448,12,11022,0.310607,0.17413199999999995,20582.08715227529,506374.4745365586
"77.197.128.142",44712,"41.177.26.176",80,20,12939,8,812,12,12127,0.655406,0.6792059999999999,9564.108679840874,142837.3718724511
"77.197.128.142",44957,"41.177.26.176",80,21,12759,9,876,12,11883,1.452056,0.5964029999999998,11750.443911247936,159395.57648100366
"77.197.128.142",45118,"41.177.26.176",80,23,13984,10,945,13,13039,2.058505,0.6245480000000003,12104.75415820721,167019.98885594052
"77.197.128.142",45339,"41.177.26.176",80,21,12654,9,880,12,11774,3.392319,0.5656249999999998,12446.40883977901,166527.2928176796
"77.197.128.150",64165,"41.177.26.15",80,169,159042,57,3952,112,155090,36.727616,2.3015980000000056,13736.543045310225,539068.9425347071
"77.197.128.150",6205,"41.177.26.15",80,255,249179,82,5551,173,243628,53.44441,1.4191120000000055,31292.80846050194,1373410.9781327988
"77.197.128.150",11219,"41.177.26.15",80,169,167792,51,3566,118,164226,59.161953,1.1701850000000036,24379.05117566873,1122735.2939919722
"77.197.128.150",12615,"41.177.26.15",80,22,16162,9,879,13,15283,61.472808,0.524678999999999,13402.48037371424,233026.288454465
"77.197.128.150",14355,"41.177.26.176",80,20,12491,9,880,11,11611,65.604888,0.5884199999999993,11964.24322762654,157860.0319499679
"77.197.128.150",21587,"41.177.26.176",80,25,12168,10,933,15,11235,78.823856,2.0564219999999978,3629.6052074914624,43706.98232172195
"77.197.128.150",25427,"41.177.26.176",80,25,11972,10,965,15,11007,84.252149,1.0352340000000027,7457.251210837338,85059.0301323177
"77.197.128.150",26640,"41.177.26.176",80,20,12891,8,862,12,12029,86.270905,0.5908150000000063,11672.012389664998,162880.08936807455
"77.197.128.150",27230,"41.177.26.176",80,20,12620,8,825,12,11795,87.442433,0.6261730000000085,10540.218118634803,150693.17904157273
"77.197.128.150",27627,"41.177.26.176",80,21,12698,8,826,13,11872,88.151691,0.6077219999999954,10873.392768404055,156281.9841967227
"77.197.128.150",28147,"41.177.26.176",80,20,12665,8,821,12,11844,89.174057,0.5094199999999915,12893.094107023888,185999.7644379914
"77.197.128.150",28427,"41.177.26.176",80,19,12653,8,816,11,11837,89.690797,0.6929119999999926,9421.109751310512,136663.81878218448
"77.197.128.150",28760,"41.177.26.176",80,23,12878,10,951,13,11927,90.458712,0.5873639999999938,12952.785666128808,162447.8177075902
"77.197.128.150",29103,"41.177.26.176",80,26,12043,11,1014,15,11029,91.286304,2.5200609999999983,3218.9696995429895,35011.850903609105
"77.197.128.150",42156,"41.177.26.176",80,22,13801,9,927,13,12874,125.042426,0.7311069999999944,10143.522083634894,140871.3088508259
"77.197.128.150",47364,"41.177.26.176",80,21,12800,9,890,12,11910,133.182712,0.7120809999999835,9998.86248895865,133805.00252078375
"77.197.128.150",49091,"41.177.26.176",80,23,10941,9,856,14,10085,136.146077,1.7428920000000119,3929.101745833909,46290.87746113899
"77.197.128.150",50237,"41.177.26.176",80,29,14351,12,1102,17,13249,138.06549,1.1915300000000002,7398.890502127516,88954.53744345503
"77.197.128.150",50764,"41.177.26.176",80,21,12667,9,890,12,11777,139.279349,0.6227370000000008,11433.39804765092,151293.40315414034
"77.197.128.150",51086,"41.177.26.176",80,21,12733,9,879,12,11854,140.081277,0.5289649999999995,13293.885228701345,179278.40216271416
"77.197.128.150",51315,"41.177.26.176",80,21,12780,8,826,13,11954,140.687818,0.6217460000000017,10628.134318515893,153812.00683237164
"77.197.128.150",51563,"41.177.26.176",80,21,12161,9,889,12,11272,141.500408,0.5883500000000197,12088.042831647424,153269.31248406047
"77.197.128.150",51755,"41.177.26.176",80,21,13190,8,823,13,12367,142.139372,0.6069689999999923,10847.341462249446,163000.0873191238
"77.197.128.150",51929,"41.177.26.176",80,22,12729,9,872,13,11857,142.770528,0.5370309999999847,12989.939128281605,176630.39936242544
"77.197.128.150",52125,"41.177.26.176",80,24,12014,10,969,14,11045,143.363609,1.0393100000000004,7458.79477730417,85017.94459785816
"77.197.128.150",52496,"41.177.26.176",80,21,12960,9,889,12,12071,144.572695,0.6844739999999945,10390.460411936841,141083.51814678247
"77.197.128.150",52811,"41.177.26.176",80,20,12997,8,817,12,12180,145.392516,0.6677880000000016,9787.537362156829,145914.57169041637
"77.197.128.150",53109,"41.177.26.176",80,19,12604,7,748,12,11856,146.211027,0.6432499999999948,9302.759424796033,147451.2242518473
"77.197.128.150",53422,"41.177.26.176",80,19,12664,8,826,11,11838,147.003069,0.60478599999999,10926.178846732742,156590.9263772666
"77.197.128.150",53735,"41.177.26.176",80,21,12797,9,880,12,11917,147.637861,0.6112850000000094,11516.722968827784,155959.98593127352
"77.197.128.150",54206,"41.177.26.176",80,20,12681,8,816,12,11865,148.437269,0.6388300000000129,10218.68102625091,148584.13036331744
"77.197.128.150",54715,"41.177.26.176",80,23,11424,9,870,14,10554,149.241769,1.6221539999999948,4290.591398843773,52049.31221080136
"77.197.128.150",55745,"41.177.26.176",80,22,12674,10,951,12,11723,151.067088,0.6036900000000003,12602.494657854191,155351.25643956327
"77.197.128.150",56221,"41.177.26.176",80,20,12868,8,825,12,12043,151.911411,0.6731870000000129,9804.110893406845,143116.25150218018
"77.197.128.150",56720,"41.177.26.176",80,27,12149,12,1104,15,11045,152.722197,1.4065569999999923,6279.162522386258,62820.06345992412
"77.197.128.150",4421,"41.177.26.176",80,18,12988,7,751,11,12237,185.881547,0.5986469999999997,10035.964433130046,163528.75734781942
"77.197.128.150",14767,"41.177.26.176",80,21,12957,8,807,13,12150,204.787466,0.6053679999999986,10664.587490584265,160563.49195861068
"77.197.128.150",18875,"41.177.26.176",80,5,631,3,501,2,130,212.210333,0.07931300000001329,50533.96038479604,13112.604491064842
"77.197.128.151",41041,"41.177.26.176",80,25,12206,10,974,15,11232,4.575856,1.037356,7511.403992457749,86620.21523951276
"77.197.128.151",41888,"41.177.26.176",80,20,12480,8,815,12,11665,5.740141,0.5710639999999998,11417.284227337044,163414.2582967934
"77.197.128.151",42216,"41.177.26.176",80,19,13222,7,753,12,12469,6.335675,0.6441799999999995,9351.423515166574,154851.12856654983
"77.197.128.151",42620,"41.177.26.176",80,19,13094,7,761,12,12333,7.234759,0.6918789999999992,8799.226454336678,142602.96959439456
"77.197.128.151",42959,"41.177.26.176",80,21,12739,9,887,12,11852,7.997717,0.5318880000000004,13341.154528772966,178263.09298198106
"77.197.128.151",43174,"41.177.26.176",80,20,12203,8,812,12,11391,8.563173,0.6926899999999989,9377.932408436689,131556.6848085004
"77.197.128.151",43464,"41.177.26.176",80,22,14418,9,924,13,13494,9.380446,0.6618970000000015,11167.90074588642,163094.86219154907
"77.197.128.151",43724,"41.177.26.176",80,35,27685,14,1184,21,26501,10.235303,0.7164830000000002,13220.132229236418,295900.9494991506
"77.197.128.151",43995,"41.177.26.176",80,21,12910,9,879,12,12031,11.022461,0.6253849999999996,11244.273527507063,153901.996370236
"77.197.128.151",44269,"41.177.26.176",80,20,12710,8,825,12,11885,11.893644,0.6884359999999994,9586.947806332042,138110.15112515917
"77.197.128.151",44551,"41.177.26.176",80,23,13845,10,1018,13,12827,12.640936,1.0965830000000008,7426.706414379937,93577.95989906823
"77.197.128.151",44873,"41.177.26.176",80,22,13283,9,935,13,12348,13.844457,3.4254039999999986,2183.684026760056,28838.642098859007
"77.197.128.151",45740,"41.177.26.176",80,20,12724,8,816,12,11908,17.329657,0.5553159999999977,11755.468958214831,171549.17200296838
"77.197.128.151",45882,"41.177.26.176",80,19,12602,8,821,11,11781,17.953292,0.604222,10870.17685552661,155982.40381846405
"77.197.128.151",46048,"41.177.26.176",80,22,12827,10,953,12,11874,18.562797,0.5960870000000007,12790.079300504776,159359.28815760097
"77.197.128.151",46255,"41.177.26.176",80,23,14309,9,880,14,13429,19.391098,0.6622659999999989,10630.16975052322,162218.80634065493
"77.197.128.151",46417,"41.177.26.176",80,23,12307,9,904,14,11403,20.17222,0.9921849999999992,7288.9632477814175,91942.53087881804
"77.197.128.151",46587,"41.177.26.176",80,21,14002,9,876,12,13126,21.187937,0.7094360000000002,9878.269498587608,148016.1705918504
"77.197.128.151",46730,"41.177.26.176",80,20,12341,8,856,12,11485,21.986932,1.1485480000000017,5962.310673998814,79996.65664822007
"77.197.128.151",46955,"41.177.26.176",80,22,12695,10,943,12,11752,23.204895,0.6496479999999991,11612.442430362304,144718.37056375164
"77.197.128.151",47094,"41.177.26.176",80,21,12818,9,879,12,11939,24.017379,0.6146160000000016,11441.290171424078,155401.0959688647
"77.197.128.151",47212,"41.177.26.176",80,21,12983,9,880,12,12103,24.844163,0.6152359999999994,11442.76342736772,157377.00654708126
"77.197.128.151",47357,"41.177.26.176",80,22,12072,9,918,13,11154,25.642619,1.0049920000000014,7307.520855887399,88788.76647774297
"77.197.128.151",47543,"41.177.26.176",80,22,13657,9,880,13,12777,26.656472,0.6516990000000007,10802.53307124914,156845.41483107983
"77.197.128.151",47628,"41.177.26.176",80,19,12889,8,815,11,12074,27.329503,0.6082890000000027,10718.589354731008,158792.9421705794
"77.197.128.151",47701,"41.177.26.176",80,20,13242,8,825,12,12417,27.939692,0.7004389999999994,9422.66207335686,141819.6302604511
"77.197.128.151",47825,"41.177.26.176",80,24,11300,9,912,15,10388,28.765005,1.1168130000000005,6532.875244109799,74411.74126733837
"77.197.128.151",48067,"41.177.26.176",80,23,14142,10,988,13,13154,29.968673,0.6677260000000018,11837.190703971357,157597.57744943243
"77.197.128.151",48175,"41.177.26.176",80,21,13023,8,861,13,12162,30.776114,0.6466379999999994,10652.018594638741,150464.40203019325
"77.197.128.151",48262,"41.177.26.176",80,22,13099,9,876,13,12223,31.582532,0.6405200000000022,10941.110347842341,152663.46093798737
"77.197.128.151",38307,"244.3.210.197",80,22,16613,9,926,13,15687,184.529495,0.7104339999999922,10427.428867424815,176646.95101867503
"77.197.128.153",46088,"41.177.26.176",80,21,13458,9,927,12,12531,66.417124,0.7984799999999979,9287.646528403993,125548.54223023778
"77.197.128.153",47537,"41.177.26.15",80,161,157781,51,3566,110,154215,69.030771,1.1136539999999968,25616.573908952047,1107812.6599464498
"77.197.128.153",55321,"41.177.26.176",80,20,12603,8,825,12,11778,91.382595,0.6978459999999984,9457.674042697121,135021.19378774145
"77.197.128.153",55839,"41.177.26.15",80,7,1019,4,626,3,393,93.636832,0.16484700000000885,30379.685405252938,19072.230613840904
"77.197.128.153",56082,"41.177.26.176",80,20,13081,8,825,12,12256,94.04731,0.6899879999999996,9565.38374580428,142101.0220467603
"77.197.128.153",58908,"41.177.26.176",80,21,13283,8,862,13,12421,102.692854,0.7604120000000023,9068.767983671982,130676.52798745903
"77.197.128.153",61215,"41.177.26.176",80,21,13039,9,879,12,12160,105.709332,0.7753340000000009,9069.639664970184,125468.50776568535
"77.197.128.153",61755,"41.177.26.176",80,24,12310,9,901,15,11409,106.800111,1.2583759999999984,5728.017699002531,72531.58038614859
"77.197.128.153",62530,"41.177.26.176",80,21,12743,9,871,12,11872,108.155342,0.6271720000000016,11110.189868170106,151435.33193446096
"77.197.128.153",62883,"41.177.26.176",80,23,11868,9,899,14,10969,108.784703,1.1226550000000088,6406.242345154961,78164.70776863712
"77.197.128.153",63418,"41.177.26.176",80,20,12705,8,816,12,11889,110.016849,0.724338000000003,9012.367154560403,131308.8640938341
"77.197.128.153",63803,"41.177.26.176",80,21,12949,8,808,13,12141,110.872482,0.7186169999999947,8995.055780756713,135159.61910169217
"77.197.128.153",64126,"41.177.26.176",80,25,11936,10,950,15,10986,111.639036,1.7470359999999943,4350.225181392956,50306.919834508444
"77.197.128.153",64854,"41.177.26.176",80,21,12668,8,816,13,11852,113.436333,0.5738709999999969,11375.378787218791,165221.80071828078
"77.197.128.153",65124,"41.177.26.176",80,21,12906,9,887,12,12019,114.045081,0.626174000000006,11332.313382542125,153554.76273367958
"77.197.128.153",65479,"41.177.26.176",80,25,12847,10,971,15,11876,114.8963,1.274597,6094.475351817085,74539.63880348063
"77.197.128.153",1349,"41.177.26.176",80,20,12732,8,816,12,11916,116.254901,0.7234499999999997,9023.429400787894,131768.60874974087
"77.197.128.153",1570,"41.177.26.176",80,19,12740,8,816,11,11924,117.122886,0.6474660000000085,10082.38270426542,147331.2884383099
"77.197.128.153",1770,"41.177.26.176",80,20,12901,8,862,12,12039,117.874824,0.5874009999999998,11739.850630148743,163962.94865007044
"77.197.128.153",1879,"41.177.26.176",80,20,13179,8,863,12,12316,118.498509,0.7504729999999995,9199.531495470197,131287.86778471718
"77.197.128.153",3028,"41.177.26.176",80,21,11919,8,855,13,11064,119.301987,1.132782000000006,6038.231539696044,78136.83480140004
"77.197.128.153",3286,"41.177.26.176",80,29,14283,12,1048,17,13235,120.560241,1.7183419999999927,4879.121851179821,61617.53597363066
"77.197.128.153",3701,"41.177.26.176",80,15,9283,6,677,9,8606,122.358163,1.5317419999999942,3535.843503670997,44947.51727118553
"77.197.128.153",23417,"41.177.26.176",80,26,14583,11,1023,15,13560,154.981157,1.7051360000000102,4799.6171566373305,63619.55879179101
"77.197.128.153",31163,"41.177.26.176",80,20,12735,8,825,12,11910,166.055101,0.7232009999999889,9126.093575645085,131747.6054374945
"77.197.128.153",33305,"41.177.26.176",80,19,12555,8,825,11,11730,169.904464,0.643369000000007,10258.498622097006,145857.1985905429
"77.197.128.153",33739,"41.177.26.176",80,21,12663,9,889,12,11774,170.561917,0.6167460000000062,11531.489462436608,152724.13603006594
"77.197.128.153",34094,"41.177.26.176",80,21,12759,9,879,12,11880,171.324894,0.6379860000000122,11022.185439805678,148968.7861489095
"77.197.128.153",34467,"41.177.26.176",80,20,12704,8,826,12,11878,172.170829,0.6085360000000151,10858.848120735398,156151.81353280274
"77.197.128.153",34800,"41.177.26.176",80,20,12989,8,816,12,12173,172.881937,0.6717629999999986,9717.712943404167,144967.7937010526
"77.197.128.153",35038,"41.177.26.176",80,20,13169,9,924,11,12245,173.607995,0.6614160000000027,11176.02235204466,148106.48668916326
"77.197.128.153",35282,"41.177.26.176",80,25,12589,10,978,15,11611,174.355367,1.3140730000000076,5954.007121369935,70687.09272620278
"77.197.128.153",35706,"41.177.26.176",80,22,12808,9,879,13,11929,175.736907,0.5234240000000057,13434.615149477142,182322.55303539571
"77.197.128.153",35885,"41.177.26.176",80,20,12719,8,825,12,11894,176.34297,0.6061049999999852,10889.202365926962,156989.30053373973
"77.197.128.153",36019,"41.177.26.176",80,24,11651,9,891,15,10760,176.951591,1.3049230000000023,5462.391267530718,65965.57804560104
"77.197.128.153",36338,"41.177.26.176",80,20,12664,8,816,12,11848,178.375672,0.6718309999999974,9716.729356043446,141083.09976765045
"77.197.128.153",36511,"41.177.26.176",80,21,12645,8,812,13,11833,179.205039,0.6942809999999895,9356.442132220382,136348.2509243396
"77.197.128.153",36633,"41.177.26.176",80,20,12699,8,813,12,11886,179.998066,0.6783159999999953,9588.451400232407,140182.45183660812
"77.197.128.153",36774,"41.177.26.176",80,20,13051,8,815,12,12236,180.796477,0.6258880000000033,10417.199243315043,156398.58888491147
"77.197.128.153",36898,"41.177.26.176",80,21,13069,9,889,12,12180,181.579335,0.673293000000001,10563.008972319612,144721.54025067817
"77.197.128.153",37031,"41.177.26.176",80,25,12583,10,980,15,11603,182.405208,1.4519650000000013,5399.579190958455,63929.91566601118
"77.197.128.155",36706,"41.177.26.176",80,19,13465,7,448,12,13017,1.08894,0.24526199999999987,14612.944524630811,424590.8457078555
"77.197.128.155",37774,"41.177.26.176",80,22,13011,9,877,13,12134,1.5004119999999999,0.679211,10329.632470616642,142918.76898342342
"77.197.128.155",38165,"41.177.26.176",80,21,12484,9,880,12,11604,2.31238,0.6187659999999999,11377.483572141975,150027.63564901758
"77.197.128.155",38435,"41.177.26.176",80,19,12708,8,817,11,11891,4.077033,0.7187010000000003,9094.185203582572,132361.0235689111
"77.197.128.155",44262,"41.177.26.176",80,21,12942,9,924,12,12018,10.712327,0.5511470000000003,13412.029821445089,174443.4787815228
"77.197.128.155",46325,"41.177.26.176",80,21,13592,8,863,13,12729,13.439338,0.6499750000000013,10621.946997961439,156670.64117850654
"77.197.128.155",46960,"41.177.26.176",80,22,14072,9,880,13,13192,14.140059,0.7079679999999993,9943.95226902912,149068.8844693547
"77.197.128.155",47584,"41.177.26.176",80,20,12595,9,877,11,11718,14.870539,0.6250019999999985,11225.564078194977,149989.92003225625
"77.197.128.155",47981,"41.177.26.176",80,20,12661,8,810,12,11851,15.515997,0.596641,10860.802392058205,158902.92487442197
"77.197.128.155",48376,"41.177.26.176",80,21,12968,9,925,12,12043,16.287353,0.5611360000000012,13187.533859884206,171694.56245901136
"77.197.128.155",48643,"41.177.26.176",80,20,12803,8,815,12,11988,16.930849,0.6356160000000024,10257.765695010785,150883.5523334838
"77.197.128.155",48906,"41.177.26.176",80,20,12993,8,815,12,12178,17.715244,0.6457990000000002,10096.020588449344,150858.08432654737
"77.197.128.155",49187,"41.177.26.176",80,19,12652,8,825,11,11827,18.521531,0.7129690000000011,9257.064472648866,132707.0321430523
"77.197.128.155",49450,"41.177.26.176",80,29,14395,12,1109,17,13286,19.357632,1.3022890000000018,6812.619933056324,81616.29254336008
"77.197.128.155",49835,"41.177.26.176",80,22,13675,9,872,13,12803,20.744482,0.6710789999999989,10395.199372950146,152625.84583931277
"77.197.128.155",50005,"41.177.26.176",80,21,12763,9,879,12,11884,21.556567,0.5609280000000005,12536.368303953437,169490.55850305193
"77.197.128.155",50099,"41.177.26.176",80,25,11927,10,938,15,10989,22.153174,1.1345929999999989,6613.825398182438,77483.29136527379
"77.197.128.155",50339,"41.177.26.176",80,24,12585,10,981,14,11604,23.36263,1.0341450000000023,7588.877768591428,89766.90889575427
"77.197.128.155",50665,"41.177.26.176",80,18,12651,7,797,11,11854,24.618588,0.6600450000000002,9659.947427826888,143675.05245854444
"77.197.128.155",50826,"41.177.26.176",80,20,12586,9,879,11,11707,25.398791,0.6523050000000019,10780.233173132168,143577.00768812094
"77.197.128.155",50948,"41.177.26.176",80,21,12900,8,860,13,12040,26.216187,0.6249579999999995,11008.739787313718,154122.35702239204
"77.197.128.155",51064,"41.177.26.176",80,34,22424,13,1144,21,21280,27.03906,1.131845000000002,8085.912823752355,150409.28749077808
"77.197.128.155",51243,"41.177.26.176",80,22,13371,9,926,13,12445,28.247428,0.7551890000000014,9809.464915405264,131834.54737820572
"77.197.128.155",51416,"41.177.26.176",80,66,58426,24,1895,42,56531,29.058129,1.2975959999999986,11683.143289590917,348527.5848569204
"77.197.128.155",51701,"41.177.26.176",80,19,12611,7,751,12,11860,30.477666,0.6017709999999994,9983.864293892537,157667.95010061984
"77.197.128.155",51769,"41.177.26.176",80,19,12661,8,812,11,11849,31.278877,0.6225409999999982,10434.65410310328,152266.27643801816
"77.197.128.155",51857,"41.177.26.176",80,25,12497,10,943,15,11554,32.122259,1.9188210000000012,3931.5809030649525,48171.24682291884
"77.197.128.155",52606,"41.177.26.91",80,27,21186,11,1002,16,20184,34.627056,0.5915839999999974,13550.062205874458,272948.5584464771
"77.197.128.155",56519,"244.3.210.197",80,23,16352,10,927,13,15425,39.986148,0.7760510000000025,9556.072990048304,159010.16814616515
"77.197.128.155",58358,"41.177.26.91",80,18,11780,8,742,10,11038,44.251198,0.43541700000000105,13632.908223610897,202803.2897199691
"77.197.128.155",60347,"244.3.210.197",80,22,17481,9,907,13,16574,48.31073,0.7740179999999981,9374.458991909773,171303.50973750008
"77.197.128.155",61863,"41.177.26.91",80,18,14326,7,770,11,13556,50.491309,0.4266489999999976,14438.097827488251,254185.52486939053
"77.197.128.155",63538,"244.3.210.197",80,12,5661,6,631,6,5030,52.571098,0.5620049999999992,8982.126493536547,71600.78646987137
"77.197.128.155",64550,"41.177.26.91",80,24,19320,10,981,14,18339,53.687934,0.4430109999999985,17715.135741550497,331170.10638562136
"77.197.128.155",1934,"41.177.26.91",80,21,17109,8,813,13,16296,55.587573,0.4552970000000016,14285.180881929766,286336.1717735885
"77.197.128.155",42408,"41.177.26.176",80,21,12696,9,889,12,11807,126.438789,0.5816140000000019,12228.041278236042,162403.24338822605
"77.197.128.155",56872,"41.177.26.176",80,21,13523,8,862,13,12661,191.498332,0.7281729999999982,9470.276980882314,139098.81305678768
"77.197.128.164",22423,"41.177.26.176",80,22,13771,9,924,13,12847,35.278488,0.7582689999999985,9748.519324936156,135540.28979161775
"77.197.128.164",26951,"41.177.26.176",80,20,12581,8,815,12,11766,40.255483,0.5230129999999988,12466.229328907722,179972.58194347026
"77.197.128.164",28634,"41.177.26.176",80,23,14336,10,988,13,13348,42.605879,0.623981999999998,12667.032061822336,171133.1416611382
"77.197.128.164",29345,"41.177.26.176",80,22,13317,9,927,13,12390,43.46451,0.6759730000000062,10970.852386115914,146633.0755814198
"77.197.128.164",30000,"41.177.26.176",80,21,12712,8,821,13,11891,44.299943999999996,0.6262790000000038,10487.338710063661,151893.96419167722
"77.197.128.164",30443,"41.177.26.176",80,21,12796,8,823,13,11973,44.991865,0.6132640000000009,10735.996243053547,156187.22116413136
"77.197.128.164",30818,"41.177.26.176",80,19,12532,7,752,12,11780,45.655144,0.6595299999999966,9121.64723363612,142889.63352690625
"77.197.128.164",31149,"41.177.26.176",80,21,12778,8,825,13,11953,46.401738,0.6466629999999967,10206.243437462843,147873.0034036283
"77.197.128.164",31439,"41.177.26.176",80,25,12613,10,1013,15,11600,47.133141,1.652471999999996,4904.167816459232,56158.28891503168
"77.197.128.164",31942,"41.177.26.176",80,23,14170,10,990,13,13180,48.791049,0.7729209999999966,10246.842820935173,136417.56402012685
"77.197.128.164",32169,"41.177.26.176",80,25,12022,10,949,15,11073,49.612009,1.691754000000003,4487.650095699485,52362.22287637555
"77.197.128.164",32619,"41.177.26.176",80,21,12797,9,880,12,11917,51.451532,0.5997860000000017,11737.519715365113,158950.0255090978
"77.197.128.164",32830,"41.177.26.176",80,21,12768,8,816,13,11952,52.262006,0.8381100000000004,7788.9537172924765,114085.26327093097
"77.197.128.164",33042,"41.177.26.176",80,72,71639,23,1826,49,69813,53.230386,4.18694,3488.944193133888,133391.92823398474
"77.197.128.164",34357,"41.177.26.176",80,23,11893,9,905,14,10988,57.497459,1.0585299999999975,6839.673887372126,83043.46593861318
"77.197.128.164",34571,"41.177.26.176",80,20,13154,8,862,12,12292,58.779305,0.7594890000000021,9079.789174036729,129476.5296139901
"77.197.128.164",34698,"41.177.26.176",80,21,12712,9,879,12,11833,59.576975,0.6156580000000034,11421.925809459086,153760.6918126614
"77.197.128.164",34828,"41.177.26.176",80,20,13061,8,860,12,12201,60.388368,0.636453000000003,10809.910551132554,153362.4635283352
"77.197.128.164",34970,"41.177.26.176",80,20,12657,8,825,12,11832,61.199781,0.7286959999999993,9057.274912995277,129897.79002492134
"77.197.128.164",35115,"41.177.26.176",80,21,12907,8,825,13,12082,61.997482,0.6893230000000017,9574.611611682743,140218.73635436475
"77.197.128.165",38719,"41.177.26.176",80,25,12259,10,964,15,11295,3.712154,1.054709,7311.969462666954,85672.92020832287
"77.197.128.165",42179,"41.177.26.15",80,216,207649,72,4912,144,202737,7.264109,1.2248039999999998,32083.50070705191,1324208.6080711691
"77.197.128.165",48577,"41.177.26.176",80,20,12964,8,860,12,12104,15.291755,0.6126269999999998,11230.324487820488,158060.28790765023
"77.197.128.165",49807,"41.177.26.15",80,157,150054,52,3631,105,146423,16.780326,1.0988100000000003,26435.87153375014,1066047.8153638933
"77.197.128.165",51983,"41.177.26.176",80,25,12014,10,955,15,11059,19.465593,1.3205440000000017,5785.494462888015,66996.63169118173
"77.197.128.165",52315,"41.177.26.15",80,34,28125,13,1135,21,26990,19.808692,0.711551,12760.856214101308,303449.78785779234
"77.197.128.165",53328,"41.177.26.176",80,20,13255,8,816,12,12439,21.043178,0.6475829999999974,10080.561101820194,153666.7886587517
"77.197.128.165",53902,"41.177.26.176",80,25,11991,10,976,15,11015,21.860305,1.3360880000000002,5843.926447958517,65953.73957404002
"77.197.128.165",54777,"41.177.26.176",80,23,12424,9,911,14,11513,23.27324,1.1577609999999972,6294.908880157492,79553.5520716281
"77.197.128.165",55512,"41.177.26.176",80,20,12807,8,808,12,11999,24.493306,0.7167950000000012,9017.920046875312,133918.34485452584
"77.197.128.165",56101,"41.177.26.176",80,20,13234,8,812,12,12422,25.320197,0.7290129999999984,8910.677861711676,136315.81329825424
"77.197.128.165",56642,"41.177.26.176",80,21,12778,8,816,13,11962,26.166733,0.6238409999999988,10464.204821420864,153398.06136499555
"77.197.128.165",57088,"41.177.26.176",80,20,12966,8,860,12,12106,26.976574,0.6665379999999992,10321.992144483898,145300.04290828147
"77.197.128.165",57512,"41.177.26.176",80,20,12669,8,815,12,11854,27.784828,0.6143789999999996,10612.341893196226,154354.23411281971
"77.197.128.165",58034,"41.177.26.176",80,20,13426,8,825,12,12601,28.58751,0.6927159999999972,9527.714099284594,145525.72771525473
"77.197.128.165",58430,"41.177.26.176",80,19,12512,8,815,11,11697,29.397375,0.6383639999999993,10213.608536822263,146587.21356467486
"77.197.128.165",58795,"41.177.26.176",80,21,12654,9,880,12,11774,30.208129,0.5504770000000008,12788.908528421696,171109.7829700421
"77.197.128.165",58952,"41.177.26.176",80,20,12995,9,924,11,12071,30.810670000000002,0.6660559999999975,11098.165919982745,144984.806082372
"77.197.128.165",59114,"41.177.26.176",80,22,12866,9,871,13,11995,31.634952,0.6384690000000006,10913.607395190673,150297.03869725845
"77.197.128.165",59264,"41.177.26.176",80,23,13123,10,951,13,12172,32.457845,1.2174729999999983,6249.009218274254,79982.06120382147
"77.197.128.167",7745,"41.177.26.15",80,49,41982,19,1519,30,40463,6.6300930000000005,0.6918429999999995,17564.678691552865,467886.5002608977
"77.197.128.167",15422,"41.177.26.15",80,135,128935,45,3184,90,125751,15.225904,1.0730740000000019,23737.412331302367,937501.048389951
"77.197.128.167",26391,"41.177.26.176",80,19,13083,8,823,11,12260,35.819660999999996,0.6779880000000063,9711.08633191139,144663.32737452447
"77.197.128.167",32648,"41.177.26.176",80,19,12939,7,799,12,12140,49.497334,0.7348429999999979,8698.456677140584,132164.28543239887
"77.197.128.167",34845,"41.177.26.176",80,19,12813,8,816,11,11997,53.854872,0.6700609999999969,9742.396587773397,143234.72042097725
"77.197.128.167",35946,"41.177.26.176",80,18,12676,7,752,11,11924,55.53753,0.7070900000000009,8508.110707264977,134907.86179977073
"77.197.128.167",36595,"41.177.26.176",80,23,11676,9,895,14,10781,56.508079,0.9965240000000009,7184.974973006163,86548.84378098263
"77.197.128.167",37307,"41.177.26.176",80,25,12597,10,1009,15,11588,57.508339,1.7524409999999975,4606.146512207835,52899.926445455305
"77.197.128.167",38256,"41.177.26.176",80,20,13216,8,824,12,12392,59.448236,0.612369000000001,10764.751318241108,161889.31836849975
"77.197.128.167",38536,"41.177.26.176",80,21,12953,9,889,12,12064,60.152632,0.665023000000005,10694.3669617441,145125.80767883107
"77.197.128.167",38837,"41.177.26.176",80,25,12026,10,924,15,11102,60.995934,1.6269100000000023,4543.5826198130135,54591.833598662415
"77.197.128.167",39347,"41.177.26.176",80,19,12590,7,757,12,11833,63.472867,0.5860010000000031,10334.453354175108,161542.38644643864
"77.197.128.168",12339,"41.177.26.176",80,26,12478,11,1002,15,11476,2.343346,1.883892,4255.020988464307,48733.154554507375
"77.197.128.168",12492,"41.177.26.15",80,162,157888,51,3567,111,154321,2.703675,1.7109710000000002,16678.24878387769,721559.8627913622
"77.197.128.168",13066,"41.177.26.176",80,22,13032,9,926,13,12106,4.638094,0.6250249999999999,11852.325906963722,154950.601975921
"77.197.128.168",24273,"41.177.26.176",80,21,12953,10,989,11,11964,27.256255,0.9865209999999998,8020.102967904385,97019.72892619623
"77.197.128.168",26344,"41.177.26.176",80,21,13205,8,825,13,12380,33.296567,0.7013829999999999,9409.979996663737,141206.730131754
"77.197.128.180",29988,"41.177.26.176",80,20,12565,8,815,12,11750,42.831663,0.6563179999999988,9934.208721991492,143223.25458085892
"77.197.128.186",56490,"41.177.26.176",80,23,10034,9,868,14,9166,64.881607,0.2530409999999961,27442.19316237332,289787.0305602694
"77.197.128.186",62867,"41.177.26.176",80,20,12706,8,823,12,11883,73.20476,0.5598480000000023,11760.334948057282,169803.2323059109
"77.197.128.186",1710,"41.177.26.176",80,21,12805,8,817,13,11988,76.912653,0.6437229999999943,10153.435561569275,148983.33600011317
"77.197.128.186",3717,"41.177.26.176",80,21,12796,9,889,12,11907,78.11413,0.6372479999999996,11160.490107462094,149480.26514010254
"77.197.128.186",4551,"41.177.26.176",80,22,11727,9,895,13,10832,78.965427,1.152132999999992,6214.560298160064,75213.53871471487
"77.197.128.186",5446,"41.177.26.176",80,20,12481,8,816,12,11665,80.201651,0.6486480000000086,10064.010064009932,143868.47720180865
"77.197.128.186",5905,"41.177.26.176",80,22,13252,9,879,13,12373,80.913143,0.6397029999999972,10992.601254019492,154734.30638905935
"77.197.128.186",6339,"41.177.26.176",80,25,12643,10,943,15,11700,81.625298,1.1981250000000045,6296.5049556598615,78122.06572769923
"77.197.128.186",7601,"41.177.26.176",80,20,12252,7,748,13,11504,82.886837,0.7169600000000003,8346.351260879264,128364.2044186565
"77.197.128.186",10564,"41.177.26.176",80,21,12854,8,861,13,11993,83.692165,0.5843069999999955,11788.323603859022,164201.3530558435
"77.197.128.186",10861,"41.177.26.176",80,20,12592,8,813,12,11779,84.282683,0.5731179999999938,11348.448312564027,164419.89258756663
"77.197.128.186",11150,"41.177.26.176",80,20,12617,8,813,12,11804,84.945438,0.6172180000000083,10537.60583780757,152996.1861125222
"77.197.128.186",11367,"41.177.26.176",80,21,13634,9,925,12,12709,85.781102,0.6503309999999942,11378.820938875842,156338.84898613306
"77.197.128.186",11547,"41.177.26.176",80,20,12872,7,796,13,12076,86.563493,0.6558340000000129,9709.774119670335,147305.56817731026
"77.197.128.186",11695,"41.177.26.176",80,21,13518,8,825,13,12693,87.37815,0.721705,9145.010773099812,140700.14756721928
"77.197.128.186",11855,"41.177.26.176",80,20,12722,9,889,11,11833,88.21571,0.6261860000000041,11357.647727671894,151175.5293155698
"77.197.128.186",12020,"41.177.26.176",80,21,12955,8,808,13,12147,89.013844,0.6977709999999888,9263.78425013379,139266.32089897912
"77.197.128.186",12174,"41.177.26.176",80,30,15781,12,1117,18,14664,89.834798,1.3519569999999987,6609.677674659777,86771.99052928467
"77.197.128.186",12480,"41.177.26.176",80,22,13667,9,926,13,12741,91.25612,0.7122949999999975,10400.185316477058,143098.0141654797
"77.197.128.186",12593,"41.177.26.176",80,19,12646,8,816,11,11830,92.053499,0.698514000000003,9345.553560844839,135487.62086371868
"77.197.128.186",12865,"41.177.26.176",80,21,12395,8,821,13,11574,93.773583,1.9713899999999995,3331.6593875387425,46967.87545843289
"77.197.128.186",14539,"41.177.26.176",80,19,12641,7,744,12,11897,95.906697,0.6614130000000102,8998.915957200581,143897.98809518188
"77.197.128.186",15196,"41.177.26.176",80,20,13077,8,825,12,12252,97.059868,0.6704090000000065,9844.736571257152,146203.28784368804
"77.197.128.186",15654,"41.177.26.176",80,20,12634,8,821,12,11813,97.860318,0.6288780000000003,10443.997086875352,150273.98000884108
"77.197.128.186",16000,"41.177.26.176",80,20,12795,8,812,12,11983,98.561489,0.6711740000000077,9678.563233974983,142830.32417822935
"77.197.128.186",16365,"41.177.26.176",80,20,12814,7,752,13,12062,99.406361,0.6447929999999928,9330.126102485707,149654.2301172641
"77.197.128.186",16666,"41.177.26.176",80,25,11757,10,949,15,10808,100.209028,1.2426679999999948,6109.435504897552,69579.32448570363
"77.197.128.186",17134,"41.177.26.176",80,20,12859,8,860,12,11999,101.537649,0.5519979999999975,12463.813274685834,173899.1807941341
"77.197.128.186",17349,"41.177.26.176",80,20,13578,8,863,12,12715,102.140456,0.7125439999999941,9689.226209188566,142756.09646562295
"77.197.128.186",17729,"41.177.26.176",80,21,13454,9,880,12,12574,103.032961,0.6876450000000034,10237.840746315273,146284.78357291844
"77.197.128.186",18130,"41.177.26.176",80,22,13290,9,926,13,12364,103.926086,0.7472929999999991,9913.113062747823,132360.39946848174
"77.197.128.186",18548,"41.177.26.176",80,21,12845,9,879,12,11966,104.737734,0.6070129999999949,11584.595387578287,157703.3770281704
"77.197.128.186",18911,"41.177.26.176",80,21,12635,9,879,12,11756,105.529421,0.6303759999999983,11155.247027171115,149193.49721436136
"77.197.128.186",19184,"41.177.26.176",80,20,12575,9,879,11,11696,106.350328,0.6263280000000009,11227.344139173068,149391.37321020276
"77.197.128.186",19448,"41.177.26.176",80,22,13426,9,879,13,12547,107.153951,0.6262189999999919,11229.298376446724,160288.97238825602
"77.197.128.186",19637,"41.177.26.176",80,21,12737,8,823,13,11914,107.794346,0.5318809999999985,12378.708771322943,179197.9784951902
"77.197.128.186",19783,"41.177.26.176",80,19,12818,8,860,11,11958,108.39547,0.6621669999999966,10390.128170084035,144471.10774170337
"77.197.128.186",19997,"41.177.26.176",80,23,14145,10,951,13,13194,109.188384,0.6200680000000034,12269.622041453451,170226.49128805136
"77.197.128.186",20154,"41.177.26.176",80,19,13070,7,751,12,12319,109.863162,0.6123070000000013,9812.07139555809,160951.94077480707
"77.197.128.186",20369,"41.177.26.176",80,20,12982,9,924,11,12058,110.483164,0.6590939999999961,11215.395679523777,146358.48604296288
"77.197.128.186",20566,"41.177.26.176",80,22,13828,9,887,13,12941,111.282601,0.6558979999999934,10818.755355253517,157841.615617064
"77.197.128.186",20746,"41.177.26.176",80,21,12851,9,887,12,11964,112.091392,0.6265530000000012,11325.458500717396,152759.622889045
"77.197.128.186",20950,"41.177.26.176",80,25,11875,10,973,15,10902,112.907297,1.092808000000005,7122.934678369817,79809.07899649306
"77.197.128.186",21347,"41.177.26.176",80,22,12778,9,887,13,11891,114.141768,0.5458420000000075,13000.098929726739,174277.53818870423
"77.197.128.186",21556,"41.177.26.176",80,21,13428,8,816,13,12612,114.753909,0.665733000000003,9805.732928966974,151556.25453447484
"77.197.128.186",21967,"41.177.26.176",80,26,12018,10,980,16,11038,115.546459,1.7266340000000042,4540.62644428407,51142.2802979669
"77.197.128.186",22862,"41.177.26.176",80,19,12924,7,761,12,12163,117.399653,0.6880579999999981,8848.091294629257,141418.31066567102
"77.197.128.186",23344,"41.177.26.176",80,21,13068,8,816,13,12252,118.196485,0.6501640000000037,10040.543616687424,150755.80930349795
"77.197.128.186",23807,"41.177.26.176",80,21,13482,9,887,12,12595,119.003915,0.6132969999999887,11570.250628977692,164292.34123108684
"77.197.128.186",24356,"41.177.26.176",80,19,12196,8,862,11,11334,119.84751,0.772363999999996,8928.432707894252,117395.4249550736
"77.197.128.186",37962,"41.177.26.176",80,23,13884,9,876,14,13008,156.472793,0.6751120000000128,10380.499828176462,154143.3125170313
"77.197.128.186",45882,"41.177.26.176",80,20,12594,8,816,12,11778,167.535268,0.6612580000000037,9872.092284705763,142492.03790351038
"77.197.128.186",48347,"41.177.26.176",80,22,12848,9,880,13,11968,171.394977,0.6298850000000016,11176.643355533124,152002.3496352505
"77.197.128.186",48923,"41.177.26.176",80,19,13222,8,826,11,12396,172.256059,0.6595959999999934,10018.253597656847,150346.57578275338
"77.197.128.186",49363,"41.177.26.176",80,20,12777,8,861,12,11916,173.003916,0.5843889999999874,11786.669495832653,163124.22033953763
"77.197.128.186",49606,"41.177.26.176",80,25,12173,10,967,15,11206,173.668919,1.2780370000000119,6053.032893413828,70145.07404715134
"77.197.128.186",49958,"41.177.26.176",80,20,12736,8,825,12,11911,175.09039,0.6763809999999921,9757.81401310811,140879.17904258266
"77.197.128.186",50212,"41.177.26.176",80,21,14277,9,926,12,13351,175.865838,0.7408729999999935,9999.0146759297,144165.05932865813
"77.197.128.186",50553,"41.177.26.176",80,21,13158,8,814,13,12344,176.685897,0.6025779999999941,10806.899687675395,163882.51811383915
"77.197.128.186",50876,"41.177.26.176",80,22,12741,9,880,13,11861,177.290276,0.5751840000000072,12239.56160115704,164969.81835377688
"77.197.128.186",51264,"41.177.26.176",80,19,12824,8,862,11,11962,177.915067,0.6554040000000043,10521.754520875604,146010.70484769603
"77.197.128.186",51763,"41.177.26.176",80,22,12388,9,912,13,11476,178.718571,1.166327999999993,6255.53017675992,78715.42139089566
"77.197.128.186",52488,"41.177.26.176",80,19,12818,8,821,11,11997,179.99982,0.6029709999999966,10892.729501087179,159171.8341346442
"77.197.128.186",52991,"41.177.26.176",80,20,12617,7,762,13,11855,180.79854,0.6226120000000037,9791.009489055727,152326.0072083407
"77.197.128.186",53599,"41.177.26.176",80,25,12535,10,969,15,11566,181.61054,1.1645160000000203,6656.842842863357,79456.18608932671
"77.197.128.186",54465,"41.177.26.176",80,20,12801,8,814,12,11987,183.724921,0.612891000000019,10625.054047130401,156465.01580215248
"77.197.128.186",3999,"41.177.26.176",80,20,12080,8,817,12,11263,197.213604,0.7477429999999856,8740.971162552007,120501.29523111782
"77.197.128.186",7241,"41.177.26.176",80,20,12870,8,825,12,12045,201.361245,0.6498009999999965,10156.955744912728,148291.55387572583
"77.197.128.186",7735,"41.177.26.176",80,21,12629,9,887,12,11742,202.032953,0.6295620000000213,11271.328320323908,149208.49733623824
"77.197.128.186",10568,"41.177.26.176",80,20,12871,9,877,11,11994,202.75263,0.711024999999978,9867.444885904457,134948.84146127486
"77.197.128.186",10796,"41.177.26.176",80,20,12821,9,926,11,11895,203.54575,0.7526479999999935,9842.582455543712,126433.60508498104
"77.197.128.186",10964,"41.177.26.176",80,22,12800,9,879,13,11921,204.343906,0.5210869999999943,13494.86745975255,183017.4231942095
"77.197.128.186",11083,"41.177.26.176",80,20,12566,8,816,12,11750,204.941832,0.6284129999999948,10388.07281198838,149583.1563000778
"77.197.128.186",11230,"41.177.26.176",80,21,13689,9,926,12,12763,205.752917,0.7179169999999999,10318.741581547729,142222.56890420482
"77.197.128.186",11342,"41.177.26.176",80,21,13215,8,808,13,12407,206.538579,0.6752150000000086,9573.247039831636,146999.1039890979
"77.197.128.186",11453,"41.177.26.176",80,25,11644,10,954,15,10690,207.360226,1.0070049999999924,7578.909737290339,84925.0996767649
"77.197.128.186",11593,"41.177.26.176",80,20,12830,9,880,11,11950,208.389252,0.6738990000000058,10446.669308011942,141861.02071675306
"77.197.128.186",11685,"41.177.26.176",80,11,5220,5,695,6,4525,209.187385,1.074580999999995,5174.109722766387,33687.54891441424
"77.197.128.186",11788,"41.177.26.176",80,19,13228,7,799,12,12429,210.262526,0.6342489999999827,10078.060824692155,156771.2365332901
"77.197.128.186",11902,"41.177.26.176",80,22,13962,9,880,13,13082,211.091907,0.678054000000003,10382.653888923254,154347.58883510684
"77.197.128.186",12020,"41.177.26.176",80,13,4865,3,487,10,4378,211.88973,1.1223270000000127,3471.359060238198,31206.59130538569
"77.197.128.193",13544,"244.3.210.197",80,22,16487,9,911,13,15576,33.918687,0.7515709999999984,9697.02130603764,165796.71115569954
"77.197.128.193",21723,"244.3.210.197",80,25,17950,11,1057,14,16893,46.48852,0.7620859999999965,11095.860572166446,177334.3165994397
"77.197.128.203",35728,"41.177.26.176",80,20,12906,8,862,12,12044,95.119534,0.666877999999997,10340.72199112886,144482.19914287236
"77.197.128.203",36101,"41.177.26.176",80,20,12776,8,860,12,11916,95.843345,0.6642510000000073,10357.53051180943,143512.01578921065
"77.197.128.203",36486,"41.177.26.176",80,22,13217,9,928,13,12289,96.519181,4.322512000000003,1717.5198125534398,22744.182086712524
"77.197.128.203",38273,"41.177.26.176",80,21,12721,8,825,13,11896,100.843012,0.5577380000000005,11833.513226640454,170632.08890195738
"77.197.128.203",38414,"41.177.26.176",80,21,13430,9,926,12,12504,101.403877,0.6995010000000121,10590.406589840288,143004.79913538118
"77.197.128.203",38555,"41.177.26.176",80,21,12938,8,812,13,12126,102.104818,0.7114880000000028,9130.161014662193,136345.23702437655
"77.197.128.203",38702,"41.177.26.176",80,20,12655,8,825,12,11830,102.819246,0.5557649999999938,11875.52292785633,170287.80149883684
"77.197.128.203",38823,"41.177.26.176",80,20,12689,8,815,12,11874,103.377525,0.5529909999999916,11790.426968974358,171778.56420810003
"77.197.128.203",38975,"41.177.26.176",80,21,12916,9,876,12,12040,103.93254400000001,0.6847999999999956,10233.64485981315,140654.20560747755
"77.197.128.203",39116,"41.177.26.176",80,21,13024,8,815,13,12209,104.618221,0.6102789999999914,10683.638139277433,160044.83195391187
"77.197.128.203",39195,"41.177.26.176",80,22,13548,9,889,13,12659,105.233243,0.6467640000000046,10996.283033687636,156582.61746170055
"77.197.128.203",39318,"41.177.26.176",80,20,12721,8,825,12,11896,105.882767,0.6625269999999972,9961.858158233594,143643.95715193555
"77.197.128.203",39457,"41.177.26.176",80,19,12183,7,748,12,11435,106.545578,0.8324899999999928,7188.07433122326,109887.20585232349
"77.197.128.203",39564,"41.177.26.176",80,20,12895,8,825,12,12070,107.380329,0.6954640000000012,9490.067063140563,138842.55691164435
"77.197.128.203",39618,"41.177.26.176",80,19,12649,8,816,11,11833,108.077482,0.6548640000000034,9968.482005423975,144555.20535561506
"77.197.128.203",39712,"41.177.26.176",80,21,12851,9,880,12,11971,108.735231,0.6329980000000006,11121.678109567476,151292.73710185484
"77.197.128.203",39794,"41.177.26.176",80,22,12722,9,876,13,11846,109.371433,0.5804940000000016,12072.476201304373,163254.0560281411
"77.197.128.203",39870,"41.177.26.176",80,21,12871,8,863,13,12008,109.953653,0.5731679999999955,12045.334003294069,167601.8200597395
"77.197.128.203",39916,"41.177.26.176",80,22,13382,9,887,13,12495,110.528487,0.6609969999999947,10735.29834477321,151226.10238775788
"77.197.128.203",39951,"41.177.26.176",80,21,12758,8,824,13,11934,111.192137,0.6598790000000037,9989.710234755104,144681.07031743618
"77.197.128.203",40031,"41.177.26.176",80,29,13461,12,1119,17,12342,111.853911,3.6227190000000036,2471.072142222455,27254.667005638556
"77.197.128.203",40550,"41.177.26.176",80,20,12572,8,812,12,11760,115.6023,0.6894080000000002,9422.577051615295,136464.90902339394
"77.197.128.203",40628,"41.177.26.176",80,22,13124,9,876,13,12248,116.428601,0.6556599999999975,10688.466583290161,149443.3090321209
"77.197.128.203",40692,"41.177.26.176",80,21,13036,9,924,12,12112,117.086328,0.6286840000000069,11757.894268026415,154125.12486399992
"77.197.128.203",40764,"41.177.26.176",80,21,12751,8,808,13,11943,117.845548,0.7134100000000103,9060.708428533251,133925.79302224334
"77.197.128.203",40838,"41.177.26.176",80,20,13003,8,816,12,12187,118.615768,0.6857509999999962,9519.490310623005,142174.05443083646
"77.197.128.203",40884,"41.177.26.176",80,19,12640,8,825,11,11815,119.34436,0.6840170000000114,9648.882995597902,138183.7001127142
"77.197.128.203",40988,"41.177.26.176",80,25,12456,10,947,15,11509,120.031634,1.3683690000000013,5536.518292945831,67285.94406918011
"77.197.128.203",41082,"41.177.26.176",80,22,12931,9,889,13,12042,121.435652,0.6820149999999927,10427.923139520502,141252.02524871303
"77.197.128.203",41110,"41.177.26.176",80,19,12698,8,815,11,11883,122.11988,0.6289590000000089,10366.335484506792,151144.98719312172
"77.197.128.203",45452,"41.177.26.176",80,24,11862,9,862,15,11000,146.215791,2.4576859999999954,2805.8913954020218,35806.03868842487
"77.197.128.203",46540,"41.177.26.176",80,18,12835,7,748,11,12087,148.840326,0.7025559999999871,8517.470493455483,137634.58001924655
"77.197.128.203",46818,"41.177.26.176",80,22,12871,9,916,13,11955,149.600174,1.2131139999999903,6040.65240364884,78838.42738605008
"77.197.128.203",47283,"41.177.26.176",80,20,12960,8,860,12,12100,150.934281,0.6583840000000123,10449.828671413448,147026.65921407292
"77.197.128.203",47597,"41.177.26.176",80,23,11734,9,913,14,10821,151.666694,1.0017509999999845,7291.233050927938,86416.68438564207
"77.197.128.203",47965,"41.177.26.176",80,35,27425,14,1184,21,26241,152.699498,0.8127369999999985,11654.446641410466,258297.57965984123
"77.197.128.203",48215,"41.177.26.176",80,23,12788,9,880,14,11908,153.560782,0.5868560000000116,11996.12852215852,162329.43004757236
"77.197.128.203",51426,"41.177.26.176",80,21,12636,9,887,12,11749,167.449352,0.6745970000000057,10518.872749211663,139330.59293177884
"77.197.128.203",51997,"41.177.26.176",80,19,12852,8,862,11,11990,169.831871,0.7543799999999976,9141.281582226493,127150.77282006457
"77.197.128.203",52241,"41.177.26.176",80,25,12297,10,980,15,11317,171.106158,1.5148670000000095,5175.3718313224535,59764.9826684451
"77.197.128.203",52787,"41.177.26.176",80,20,12960,8,816,12,12144,173.115651,0.7162259999999776,9114.441531025408,135644.33572643696
"77.197.128.203",53073,"41.177.26.176",80,22,13217,9,880,13,12337,174.188335,0.6689790000000073,10523.499242875969,147532.28427200095
"77.197.128.203",54025,"41.177.26.176",80,20,12678,9,890,11,11788,179.89506,0.6483249999999998,10982.146300080982,145457.91077006134
"77.197.128.203",54462,"41.177.26.176",80,13,5242,6,683,7,4559,182.378349,0.594551000000024,9190.128348955395,61343.77034097752
"77.197.128.203",54706,"41.177.26.176",80,22,13104,9,879,13,12225,183.503525,0.6341930000000104,11088.107248108832,154211.73049844193
"77.197.128.209",45270,"41.177.26.176",80,19,12522,8,823,11,11699,64.921802,0.6878269999999986,9572.174398504294,136069.09877047598
"77.197.128.209",46805,"41.177.26.176",80,22,12948,9,877,13,12071,70.201817,0.6318069999999949,11104.656960116074,152844.14386038898
"77.197.128.209",47624,"41.177.26.176",80,22,12846,9,890,13,11956,72.481795,0.5428879999999907,13115.043986973596,176183.66955983857
"77.197.128.209",48205,"41.177.26.176",80,19,12548,8,825,11,11723,74.183326,0.6769990000000092,9748.90657150145,138529.008166923
"77.197.128.209",48677,"41.177.26.176",80,20,13245,8,816,12,12429,75.541111,0.7170969999999954,9103.370952604797,138659.0656494179
"77.197.128.209",49044,"41.177.26.176",80,25,12059,10,980,15,11079,76.562537,1.0176799999999986,7703.796871315159,87092.20973193944
"77.197.128.209",49892,"41.177.26.176",80,22,13318,9,926,13,12392,78.882337,0.7732979999999969,9579.74804021222,128198.96081458945
"77.197.128.209",50453,"41.177.26.176",80,20,13013,8,826,12,12187,80.36495,0.6577359999999999,10046.584039797124,148229.68485836266
"77.197.128.209",50959,"41.177.26.176",80,49,38603,18,1472,31,37131,81.882003,1.7502440000000092,6728.204753165809,169718.050740353
"77.197.128.209",51839,"41.177.26.176",80,19,12851,7,762,12,12089,84.075714,0.6824649999999934,8932.326199878467,141709.8312734
"77.197.128.209",52188,"41.177.26.176",80,25,11071,10,972,15,10099,84.861936,1.0386620000000022,7486.554817640372,77784.68837793221
"77.197.128.209",52815,"41.177.26.176",80,20,12655,8,825,12,11830,86.028994,0.5354480000000024,12326.126906814427,176749.18946377534
"77.197.128.209",53173,"41.177.26.176",80,19,12610,8,815,11,11795,86.687103,0.6002190000000098,10862.7017805166,157209.2852775378
"77.197.128.209",53504,"41.177.26.176",80,20,12794,8,862,12,11932,87.289095,0.794392000000002,8680.852777973572,120162.33798930472
"77.197.128.209",53967,"41.177.26.176",80,20,12815,8,810,12,12005,88.193739,0.5982000000000056,10832.49749247733,160548.31160146958
"77.197.128.209",54293,"41.177.26.176",80,22,13582,9,924,13,12658,88.826598,0.6683239999999984,11060.50358808006,151519.32296311407
"77.197.128.209",54698,"41.177.26.176",80,20,12611,8,825,12,11786,89.566323,0.5726590000000016,11525.183398846402,164649.46853188326
"77.197.128.209",54929,"41.177.26.176",80,22,12996,9,880,13,12116,90.305429,0.6531090000000006,10779.211433313572,148410.1428704855
"77.197.128.209",55212,"41.177.26.176",80,20,12571,9,887,11,11684,91.116933,0.6202770000000015,11440.05017113319,150693.96414827532
"77.197.128.209",55440,"41.177.26.176",80,22,12931,9,889,13,12042,91.754606,0.7121190000000013,9987.094853528675,135280.76065938393
"77.197.128.209",55682,"41.177.26.176",80,22,13568,9,889,13,12679,92.552191,0.7862360000000024,9045.630065272995,129009.61034600259
"77.197.128.209",55929,"41.177.26.176",80,20,12670,8,814,12,11856,93.714033,0.6543609999999944,9951.693331356935,144947.51368128727
"77.197.128.209",1613,"41.177.26.176",80,21,12653,8,816,13,11837,125.75772,0.709399999999988,9202.14265576559,133487.45418663885
"77.197.128.209",20777,"41.177.26.176",80,21,12749,9,880,12,11869,189.963311,0.690685000000002,10192.779631814763,137475.11528410163
"77.197.128.209",25350,"41.177.26.176",80,25,11534,10,935,15,10599,206.909545,1.7491749999999797,4276.301685080159,48475.424128518294
"77.197.128.209",26531,"41.177.26.176",80,20,12457,8,825,12,11632,210.38624,0.6391620000000273,10326.020633266242,145590.6327347308
"77.197.128.209",28040,"41.177.26.176",80,25,12570,10,978,15,11592,211.762216,1.0556210000000021,7411.750997753914,87849.71121264149
"77.197.128.211",49841,"41.177.26.176",80,20,13073,8,812,12,12261,65.013154,0.7059019999999947,9202.410532906903,138954.1324433147
"77.197.128.211",50496,"41.177.26.176",80,18,12523,7,757,11,11766,67.37635,0.586086999999992,10332.936918921734,160604.14238841893
"77.197.128.211",50792,"41.177.26.176",80,20,12820,8,816,12,12004,68.345863,0.5865520000000117,11129.448028478071,163722.90947775828
"77.197.128.211",51048,"41.177.26.176",80,21,12645,8,824,13,11821,69.137,0.6109150000000056,10790.3718193201,154797.31222837733
"77.197.128.211",51313,"41.177.26.176",80,25,12020,10,978,15,11042,69.989134,1.2429619999999915,6294.641348649479,71068.94659691978
"77.197.128.211",51675,"41.177.26.176",80,21,13000,9,880,12,12120,71.336246,0.683803999999995,10295.347789717596,141795.017285656
"77.197.128.211",51885,"41.177.26.176",80,20,12457,8,807,12,11650,72.320624,0.6299369999999982,10248.643912010279,147951.30306681505
"77.197.128.211",52071,"41.177.26.176",80,21,12907,8,812,13,12095,73.196142,0.659008,9857.239972807613,146826.74565407398
"77.197.128.211",52274,"41.177.26.176",80,25,12937,10,971,15,11966,73.993251,1.1827770000000015,6567.5947367931485,80934.95223529023
"77.197.128.211",52671,"41.177.26.176",80,21,13417,8,863,13,12554,75.390468,0.6942300000000046,9944.830963801556,144666.7530933543
"77.197.128.211",52869,"41.177.26.176",80,20,12577,8,826,12,11751,76.402758,0.6548489999999987,10090.875911851455,143556.75888640006
"77.197.128.211",53011,"41.177.26.176",80,26,12246,11,1036,15,11210,77.221768,1.106150999999997,7492.647929622649,81073.9220956273
"77.197.128.211",53242,"41.177.26.176",80,19,12657,8,816,11,11841,78.803402,0.6727959999999911,9702.792525520495,140797.50771407865
"77.197.128.211",53426,"41.177.26.176",80,19,13226,7,752,12,12474,79.7997,0.7471579999999989,8051.844455924997,133562.1113606495
"77.197.128.211",53571,"41.177.26.176",80,18,11202,8,777,10,10425,80.848543,3.5395269999999925,1756.1668550628413,23562.470352677115
"77.197.128.211",54067,"41.177.26.176",80,22,12731,9,889,13,11842,84.731255,0.8378159999999895,8488.737383864822,113074.94724378765
"77.197.128.211",54291,"41.177.26.176",80,20,13203,8,862,12,12341,86.153296,0.9967400000000026,6918.554487629654,99050.90595340786
"77.197.128.211",54469,"41.177.26.176",80,21,12892,9,887,12,12005,87.784046,1.0631839999999926,6674.291561949813,90332.43540158682
"77.197.128.211",54640,"41.177.26.176",80,23,13093,11,1054,12,12039,89.402267,1.1058689999999984,7624.7729161410725,87091.68988370245
"77.197.128.211",54820,"41.177.26.176",80,23,12543,11,1017,12,11526,91.009474,1.3673030000000068,5950.400167336691,67437.86856314917
"77.197.128.211",55102,"41.177.26.176",80,23,13069,10,990,13,12079,93.045348,0.8825559999999939,8973.934798471773,109491.06912196016
"77.197.128.211",63804,"41.177.26.176",80,21,12788,9,880,12,11908,125.119229,0.5881479999999897,11969.776314805327,161972.83676897935
"77.197.128.211",64426,"41.177.26.176",80,22,12830,9,877,13,11953,127.11715,0.5250510000000048,13362.511451268421,182123.2604070826
"77.197.128.211",64754,"41.177.26.176",80,22,13257,9,879,13,12378,128.110116,0.5799979999999891,12124.179738551049,170731.62321249704
"77.197.128.211",65074,"41.177.26.176",80,21,13286,9,876,12,12410,128.948043,0.598528999999985,11708.705843827409,165873.33278755497
"77.197.128.211",65314,"41.177.26.176",80,21,12858,9,889,12,11969,129.730692,0.6556559999999934,10847.151555083874,146039.9965835758
"77.197.128.211",1143,"41.177.26.176",80,25,11950,10,941,15,11009,130.74318,1.1024500000000046,6828.427593088093,79887.52324368419
"77.197.128.211",1463,"41.177.26.176",80,23,12912,10,953,13,11959,131.982107,0.6094919999999888,12508.777801841763,156970.06687536795
"77.197.128.211",1654,"41.177.26.176",80,20,12614,7,761,13,11853,132.83773,0.615602999999993,9889.490467070611,154034.33706463594
"77.197.128.211",1852,"41.177.26.176",80,23,12785,9,880,14,11905,133.65533,0.5424600000000055,12977.915422335156,175570.54898056822
"77.197.128.211",3005,"41.177.26.176",80,23,13533,10,940,13,12593,134.281525,0.7035419999999988,10688.771956755976,143195.43111854044
"77.197.128.211",3201,"41.177.26.176",80,20,12856,8,816,12,12040,135.113039,0.6949670000000197,9393.251765910922,138596.50889897978
"77.197.128.211",3375,"41.177.26.176",80,24,11828,10,962,14,10866,135.891222,1.192059999999998,6456.050869922667,72922.5039008105
"77.197.128.211",3635,"41.177.26.176",80,21,12508,8,816,13,11692,137.326401,0.5596349999999859,11664.745771797983,167137.50926943874
"77.197.128.211",3731,"41.177.26.176",80,20,12612,8,826,12,11786,138.142449,0.688036000000011,9604.148620130189,137039.34096471476
"77.197.128.211",3830,"41.177.26.176",80,21,11732,8,850,13,10882,139.155676,1.1665279999999996,5829.264278268505,74628.29867778573
"77.197.128.211",3996,"41.177.26.176",80,23,12968,10,944,13,12024,140.566222,0.6840979999999774,11039.354010683044,140611.43286488656
"77.197.128.211",4100,"41.177.26.176",80,23,11786,9,876,14,10910,141.591206,2.052493999999996,3414.3826973428495,42523.8758310622
"77.197.128.211",4395,"41.177.26.176",80,26,11277,11,1002,15,10275,144.023746,1.5362580000000037,5217.873560300406,53506.637556972724
"77.197.128.211",4676,"41.177.26.176",80,23,14484,9,965,14,13519,146.06056,1.520403999999985,5077.597796375224,71133.72498362347
"77.197.128.211",5031,"41.177.26.176",80,22,12915,10,990,12,11925,148.702421,0.8497610000000009,9320.267698800006,112266.86091736371
"77.197.128.211",5179,"41.177.26.176",80,21,12644,10,943,11,11701,149.912248,1.1978149999999914,6298.134519938433,78148.96290328696
"77.197.128.211",5439,"41.177.26.176",80,21,12663,9,880,12,11783,151.741637,0.7073420000000112,9952.752699542638,133265.096657626
"77.197.128.211",5531,"41.177.26.176",80,20,13046,9,889,11,12157,152.750225,0.8078270000000032,8803.865184005947,120392.11365799808
"77.197.128.211",15488,"41.177.26.176",80,20,12695,7,744,13,11951,186.596582,0.7326799999999878,8123.601026369082,130490.8008953453
"77.197.128.224",45762,"41.177.26.176",80,25,12457,10,922,15,11535,154.665934,1.836117999999999,4017.17100970635,50258.207805816426
"77.197.128.224",46975,"41.177.26.176",80,21,12810,8,825,13,11985,157.214699,0.6164420000000064,10706.603378744361,155537.747265759
"77.197.128.224",47372,"41.177.26.176",80,23,11936,9,878,14,11058,158.004364,1.6946209999999837,4144.879592546102,52202.822932089744
"77.197.128.224",49352,"41.177.26.176",80,20,12573,8,812,12,11761,159.990339,0.5991819999999848,10841.447172979437,157027.41404114675
"77.197.128.224",49813,"41.177.26.176",80,24,12783,10,975,14,11808,160.796037,1.0133629999999982,7697.143077061244,93218.32354250172
"77.197.128.224",50301,"41.177.26.176",80,22,12714,9,876,13,11838,161.833964,0.540976999999998,12954.34001815239,175061.04695763468
"77.197.128.224",50608,"41.177.26.176",80,20,12717,8,826,12,11891,162.49218,0.6344600000000185,10415.156195819765,149935.3781168194
"77.197.128.224",51052,"41.177.26.176",80,22,12795,9,875,13,11920,163.323241,0.5333249999999907,13125.205081329625,178802.79379365614
"77.197.128.224",51426,"41.177.26.176",80,20,12794,8,862,12,11932,163.995319,0.726821000000001,9487.893167643739,131333.57456650242
"77.197.128.224",51874,"41.177.26.176",80,20,12876,7,752,13,12124,164.787405,0.6288779999999861,9566.243373118687,154230.2322549082
"77.197.128.224",52293,"41.177.26.176",80,25,11850,10,915,15,10935,165.478914,1.6829600000000084,4349.4794885202045,51979.84503493818
"77.197.128.224",53197,"41.177.26.176",80,20,12961,8,815,12,12146,167.246156,0.6140199999999822,10618.546627146003,158248.91697339306
"77.197.128.224",53670,"41.177.26.176",80,21,12960,8,862,13,12098,168.106896,0.5640049999999803,12226.841960621343,171601.31559117982
"77.197.128.224",53841,"41.177.26.176",80,21,12679,9,888,12,11791,168.672001,0.5535849999999982,12832.717649502827,170394.7903212701
"77.197.128.224",53995,"41.177.26.176",80,21,12944,9,890,12,12054,169.33599,0.6523589999999899,10914.23587319269,147820.4485567019
"77.197.128.224",54205,"41.177.26.176",80,21,12649,8,815,13,11834,170.090207,0.5094899999999996,12797.110836326534,185817.18973875852
"77.197.128.224",54332,"41.177.26.176",80,25,12074,10,967,15,11107,170.622787,1.2830710000000067,6029.284427751823,69252.59786870683
"77.197.128.224",54550,"41.177.26.176",80,21,12660,9,881,12,11779,172.050885,0.5619030000000009,12543.090177486129,167701.54279297288
"77.197.128.224",54612,"41.177.26.176",80,22,12867,9,876,13,11991,172.682707,0.6008449999999925,11663.573800231487,159655.15232714126
"77.197.128.224",54674,"41.177.26.176",80,23,13462,10,945,13,12517,173.341455,0.7014520000000175,10777.64408683675,142755.3132644821
"77.197.128.224",54775,"41.177.26.176",80,21,12957,9,925,12,12032,174.169948,0.5633770000000027,13135.076511820618,170855.3952326764
"77.197.128.224",54905,"41.177.26.176",80,22,13114,9,877,13,12237,174.75891,0.6464010000000258,10853.943604666021,151447.78550775154
"77.197.128.224",55071,"41.177.26.176",80,23,14776,10,988,13,13788,175.539428,0.6499770000000069,12160.43029214867,169704.46646573467
"77.197.128.224",55222,"41.177.26.176",80,20,12563,9,879,11,11684,176.373919,0.5546559999999943,12678.128425546776,168522.47158599377
"77.197.128.224",55288,"41.177.26.176",80,20,12696,9,889,11,11807,176.947189,0.6233009999999979,11410.217535348129,151541.55055101842
"77.197.128.224",55365,"41.177.26.176",80,22,13305,9,889,13,12416,177.77702,0.705787000000015,10076.694526818783,140733.67744092466
"77.197.128.224",55432,"41.177.26.176",80,21,12944,9,924,12,12020,178.57519,0.5112170000000162,14459.613041036908,188100.16098838055
"77.197.128.224",55496,"41.177.26.176",80,20,13156,8,812,12,12344,179.166816,0.6846479999999815,9488.087309099239,144237.62283684852
"77.197.128.224",55624,"41.177.26.176",80,25,12565,10,975,15,11590,179.985278,1.0096440000000086,7725.495323103919,91834.34953310197
"77.197.128.224",55864,"41.177.26.176",80,19,12436,8,812,11,11624,181.214641,0.6331859999999949,10259.228725840514,146863.63880439673
"77.197.128.225",49179,"41.177.26.176",80,20,12687,8,816,12,11871,125.481179,0.5524640000000005,11816.154536766186,171898.9834631757
"77.197.128.225",50694,"41.177.26.91",80,22,18487,8,830,14,17657,127.568941,0.5198330000000055,12773.332974243514,271733.42207978043
"77.197.128.225",54252,"41.177.26.176",80,22,12657,9,879,13,11778,133.80098,0.529012999999992,13292.679007888477,178112.8252046763
"77.197.128.225",54729,"41.177.26.91",80,17,12546,7,746,10,11800,134.779513,0.39088099999997894,15268.073915079836,241505.72680689287
"77.197.128.225",55752,"41.177.26.176",80,21,12655,7,751,14,11904,136.808997,0.6789169999999842,8849.388069528586,140270.46015934527
"77.197.128.225",56175,"41.177.26.176",80,20,12944,9,879,11,12065,137.492543,0.614356999999984,11446.113578912884,157107.34963547662
"77.197.128.225",56495,"41.177.26.176",80,22,13061,8,862,14,12199,138.322265,0.6571930000000066,10493.112373381839,148498.2341564792
"77.197.128.225",56754,"41.177.26.176",80,19,12814,7,796,12,12018,139.113156,0.649517000000003,9804.208357902828,148023.83925285953
"77.197.128.225",56991,"41.177.26.91",80,20,15989,8,811,12,15178,139.908629,0.540789000000018,11997.285447743547,224531.1942365617
"77.197.128.225",57001,"41.177.26.176",80,21,12769,8,825,13,11944,139.92457,0.5463720000000194,12079.68197491776,174884.5109192942
"77.197.128.225",57267,"41.177.26.91",80,22,18547,8,819,14,17728,140.521164,0.4729719999999986,13852.828497247236,299857.07399169594
"77.197.128.225",57287,"41.177.26.176",80,23,14703,10,953,13,13750,140.549373,0.6640179999999987,11481.616462204362,165658.1598691605
"77.197.128.225",57630,"41.177.26.176",80,20,12702,8,816,12,11886,141.380015,0.633591000000024,10303.176654971034,150077.8893639531
"77.197.128.225",57881,"41.177.26.176",80,25,12053,10,916,15,11137,142.16436,1.612924000000021,4543.301482276849,55238.80852414549
"77.197.128.225",58291,"41.177.26.176",80,19,13342,8,815,11,12527,143.784508,0.6412620000000118,10167.451057445913,156279.33668297538
"77.197.128.225",58458,"41.177.26.176",80,20,12911,8,826,12,12085,144.611713,0.6829089999999951,9676.252619309524,141570.83886725857
"77.197.128.225",58598,"41.177.26.176",80,19,12656,8,816,11,11840,145.424058,0.6527299999999912,10001.072418917605,145113.5998039025
"77.197.128.225",58740,"41.177.26.176",80,20,12793,8,821,12,11972,146.251997,0.5966690000000199,11007.778181872665,160517.80803091297
"77.197.128.225",58901,"41.177.26.176",80,25,14470,10,990,15,13480,147.034551,0.6947270000000003,11400.161502287943,155226.44146549643
"77.197.128.225",59053,"41.177.26.176",80,23,11960,9,880,14,11080,147.851319,2.046560999999997,3439.9170120020904,43311.68237838996
"77.197.128.225",59445,"41.177.26.176",80,21,13261,9,924,12,12337,150.095962,0.6633870000000002,11142.817088667698,148775.90305507943
"77.197.128.225",59568,"41.177.26.176",80,21,12840,8,823,13,12017,150.893889,0.6352400000000102,10364.586612933528,151338.07694729307
"77.197.128.225",59686,"41.177.26.176",80,21,12626,9,879,12,11747,151.70618,0.6199700000000234,11342.484313756688,151581.5281384526
"77.197.128.225",59841,"41.177.26.176",80,20,12577,8,816,12,11761,152.518681,1.116074000000026,5849.074523732161,84302.65376668375
"77.197.128.225",15705,"41.177.26.176",80,22,12912,9,889,13,12023,185.242732,0.7051420000000235,10085.911773798416,136403.7314469948
"77.197.128.225",19345,"41.177.26.176",80,20,12602,8,817,12,11785,189.694263,0.6397309999999834,10216.794246331927,147374.44332071207
"77.197.128.225",20963,"41.177.26.176",80,49,39116,18,1471,31,37645,192.134241,1.7403759999999977,6761.757229472261,173043.066555733
"77.197.128.225",22393,"41.177.26.176",80,20,13119,8,825,12,12294,194.024086,0.6224079999999788,10603.976812637731,158018.53446614335
"77.197.128.225",22837,"41.177.26.176",80,23,13440,9,924,14,12516,194.822742,0.6656899999999837,11104.267752257329,150412.35409875837
"77.197.128.225",23189,"41.177.26.176",80,21,12774,9,889,12,11885,195.601525,0.6396049999999889,11119.362731686157,148654.24754340827
"77.197.128.225",23445,"41.177.26.176",80,20,13073,8,816,12,12257,196.261392,0.6967089999999985,9369.765569269257,140741.68698839864
"77.197.128.225",23752,"41.177.26.176",80,20,13005,8,817,12,12188,197.049435,0.6384410000000003,10237.43775853994,152722.02129875738
"77.197.128.225",24011,"41.177.26.176",80,22,12901,9,925,13,11976,197.850238,0.5420220000000029,13652.582367505305,176760.35290080382
"77.197.128.225",24151,"41.177.26.176",80,20,12980,8,861,12,12119,198.454824,0.6201389999999947,11107.187259630598,156339.1433210955
"77.197.128.225",24335,"41.177.26.176",80,20,12781,8,812,12,11969,199.08072,0.6312519999999893,10290.660465234345,151685.8560448151
"77.197.128.225",24547,"41.177.26.176",80,20,12835,8,812,12,12023,199.877753,0.7048189999999863,9216.55063214829,136466.24168758484
"77.197.128.225",24745,"41.177.26.176",80,20,13136,8,816,12,12320,200.674522,0.6358529999999973,10266.523866365382,155004.3799431636
"77.197.128.225",24938,"41.177.26.176",80,20,12868,8,825,12,12043,201.534102,0.6725739999999973,9813.046594129459,143246.69107042553
"77.197.128.225",25133,"41.177.26.176",80,25,12533,10,953,15,11580,202.29425,1.256666999999993,6066.841892084412,73718.8133371852
"77.197.128.225",25399,"41.177.26.176",80,21,12867,9,887,12,11980,203.721734,0.6213610000000074,11420.092345673313,154242.05896411082
"77.197.128.225",25518,"41.177.26.176",80,29,15077,12,1100,17,13977,204.564834,1.1408580000000086,7713.492827328146,98010.44477051409
"77.197.128.225",25697,"41.177.26.176",80,25,12114,10,929,15,11185,205.753657,1.6429029999999898,4523.699816726883,54464.56668470418
"77.197.128.225",26013,"41.177.26.176",80,20,12672,8,812,12,11860,207.57044,0.5622040000000084,11554.524692104473,168764.36311374267
"77.197.128.225",26128,"41.177.26.176",80,22,12814,8,816,14,11998,208.190326,0.6559450000000027,9952.053906958623,146329.34163687445
"77.197.128.225",26228,"41.177.26.176",80,20,12901,8,825,12,12076,209.014192,0.7182739999999797,9188.694008136432,134500.20465727945
"77.197.128.225",26294,"41.177.26.176",80,19,12958,8,813,11,12145,209.803928,0.7055009999999982,9218.980554244454,137717.73533985106
"77.197.128.225",26355,"41.177.26.176",80,26,15453,11,1004,15,14449,210.627679,0.6673800000000085,12035.122419011504,173202.67313973827
"77.197.128.225",26415,"41.177.26.176",80,20,12808,8,825,12,11983,211.47112,0.6941879999999969,9507.510933637615,138095.15577912674
"77.197.128.225",26520,"41.177.26.176",80,18,12798,7,798,11,12000,212.283691,0.7613599999999963,8384.99527161925,126090.15446043984
"77.197.128.251",3324,"41.177.26.176",80,25,12576,10,941,15,11635,46.329633,1.8451799999999992,4079.818771068407,50444.94304078737
"77.197.128.254",57443,"41.177.26.176",80,23,13267,10,944,13,12323,0.19072,1.077578,7008.309375284202,91486.64876231698
"77.197.128.254",57616,"41.177.26.176",80,21,13578,9,877,12,12701,1.54109,1.0410529999999998,6739.330274251168,97601.17880645848
"77.197.128.254",57791,"41.177.26.176",80,21,12240,9,926,12,11314,3.260835,0.5807089999999997,12756.81968076955,155864.6413263787
"77.197.128.254",58069,"41.177.26.176",80,23,12900,10,944,13,11956,4.509691,1.3965269999999999,5407.700674602067,68489.90388298973
"77.197.128.254",58895,"41.177.26.176",80,20,12989,8,816,12,12173,7.100585,0.6807750000000006,9589.071279056949,143048.73122544147
"77.197.128.254",59177,"41.177.26.176",80,21,13346,8,825,13,12521,7.950007,0.717757999999999,9195.29980857059,139556.78654922708
"77.197.128.254",59399,"41.177.26.176",80,22,12819,9,887,13,11932,8.740268,0.641665999999999,11058.712788273046,148762.751961301
"77.197.128.254",59655,"41.177.26.176",80,21,13220,9,876,12,12344,9.564666,0.6630829999999985,10568.81265241307,148928.56550386635
"77.197.128.254",59909,"41.177.26.176",80,19,12643,8,825,11,11818,10.395822,0.701338999999999,9410.570351855535,134804.99444633783
"77.197.128.254",60229,"41.177.26.176",80,25,12072,10,971,15,11101,11.184242,0.9715420000000012,7995.536991710075,91409.32661686256
"77.197.128.254",60554,"41.177.26.176",80,22,11667,9,873,13,10794,12.231686,1.0938569999999999,6384.7468179113,78942.67715066961
"77.197.128.254",60904,"41.177.26.176",80,18,12667,7,798,11,11869,13.430768,0.6847999999999992,9322.429906542067,138656.54205607492
"77.197.128.254",61079,"41.177.26.176",80,25,11956,10,963,15,10993,14.120176,1.0988159999999993,7011.182946007343,80035.23792882526
"77.197.128.254",61337,"41.177.26.176",80,7,893,4,552,3,341,15.297792,0.1813830000000003,24346.27280395623,15039.998235777308
"77.197.128.254",61399,"41.177.26.176",80,20,12957,8,823,12,12134,15.520448,0.6437380000000008,10227.763468988924,150794.2672329424
"77.197.128.254",61575,"41.177.26.176",80,22,13096,9,889,13,12207,16.233953,0.652982999999999,10891.55460402493,149553.66372478326
"77.197.128.254",61813,"41.177.26.176",80,20,12578,8,816,12,11762,17.066489,0.6360329999999976,10263.618397158676,147942.00929826024
"77.197.128.254",62139,"41.177.26.176",80,24,12005,9,905,15,11100,17.983821,1.5160560000000025,4775.54918815663,58573.03424147911
"77.197.128.254",62548,"41.177.26.176",80,25,13006,10,955,15,12051,19.536,1.6813729999999971,4543.905486765883,57338.85342514728
"77.197.128.254",63107,"41.177.26.176",80,25,12640,10,982,15,11658,21.458064,1.2171529999999997,6454.406307177489,76624.7135733963
"77.197.128.254",63548,"41.177.26.176",80,25,11129,10,931,15,10198,22.69813,1.8607370000000003,4002.715053228908,43844.99260239356
"77.197.128.254",64242,"41.177.26.176",80,21,12743,9,880,12,11863,24.654179,0.5557820000000007,12666.83699723991,170757.59920256483
"77.197.128.254",64460,"41.177.26.176",80,21,13112,9,924,12,12188,25.242141,0.6589719999999986,11217.472062545929,147963.79815834394
"77.197.128.254",64744,"41.177.26.176",80,21,13196,8,815,13,12381,26.071511,0.6115819999999985,10660.87621937862,161953.75272653584
"77.197.128.254",64972,"41.177.26.176",80,21,12744,9,879,12,11865,26.773128,0.5658700000000003,12426.882499514015,167741.70745931036
"77.197.128.254",65182,"41.177.26.176",80,25,12157,10,967,15,11190,27.56176,1.7324790000000014,4465.277789802932,51671.62199368646
"77.197.128.254",1252,"41.177.26.176",80,19,12527,8,816,11,11711,29.336724,0.6546990000000008,9970.994304252781,143100.87536409844
"77.197.128.254",1458,"41.177.26.176",80,25,12627,10,986,15,11641,30.156997,1.2517509999999987,6301.572756882166,74398.18302521836
"77.197.128.254",1745,"41.177.26.176",80,25,11854,11,1023,14,10831,31.566814,2.1476669999999984,3810.6466225909353,40345.17455452827
"77.197.128.254",3306,"41.177.26.176",80,24,13978,10,944,14,13034,34.568057,0.6555749999999989,11519.658315219483,159054.26533958764
"77.197.128.254",7402,"41.177.26.176",80,21,11796,9,895,12,10901,42.50542,1.4523069999999976,4930.08709591017,60047.909980465665
"77.197.128.254",12183,"41.177.26.176",80,21,12736,10,989,11,11747,48.618045,0.7675659999999951,10307.908375305902,122433.77116756162
"77.197.128.254",12732,"41.177.26.176",80,23,13070,10,940,13,12130,50.289653,0.8732059999999962,8611.942657288238,111130.70684351737
"77.197.128.254",13730,"41.177.26.176",80,21,12655,9,881,12,11774,53.109015,0.8805440000000004,8004.142893484024,106970.23658102259
"77.197.128.254",14126,"41.177.26.176",80,22,12723,10,951,12,11772,54.385454,0.8923050000000003,8526.232622253598,105542.38741237577
"77.197.128.254",14875,"41.177.26.176",80,34,24559,14,1217,20,23342,56.626006,1.7574770000000015,5539.759553041088,106252.31510853334
"77.197.128.254",15727,"41.177.26.176",80,20,12700,9,887,11,11813,59.342421,1.2948419999999956,5480.205306902328,72984.96650556618
"77.197.128.254",16393,"41.177.26.176",80,26,12253,11,1013,15,11240,61.060127,2.2203249999999954,3649.9161158839433,40498.575658968926
"77.197.210.37",24350,"41.177.26.176",80,19,12566,7,761,12,11805,94.99579,0.6767559999999975,8995.856704632131,139548.07936686242
"77.197.210.37",28287,"41.177.26.176",80,22,13100,9,879,13,12221,99.600962,0.6619639999999976,10622.93417768946,147693.83229299533
"77.197.210.37",29367,"41.177.26.176",80,24,12460,10,947,14,11513,101.448468,1.7015710000000013,4452.356087403931,54128.802148132476
"77.197.210.37",30364,"41.177.26.176",80,20,12701,8,812,12,11889,103.317796,0.6297289999999975,10315.548434326553,151036.3981966852
"77.197.210.37",30794,"41.177.26.176",80,23,11773,9,899,14,10874,104.138401,1.1390389999999968,6314.0946007994635,76373.15315805713
"77.197.210.37",31286,"41.177.26.176",80,23,13405,9,924,14,12481,105.350085,0.6819389999999999,10839.679208844194,146417.78810128183
"77.197.210.37",31561,"41.177.26.176",80,21,13134,9,924,12,12210,107.099599,0.7062250000000034,10466.919182979878,138312.8606322341
"77.197.210.37",32002,"41.177.26.176",80,18,12660,7,761,11,11899,108.011547,0.7363830000000036,8267.436918016807,129269.6871057582
"77.197.210.37",32323,"41.177.26.176",80,20,12686,8,812,12,11874,108.799081,0.5838999999999999,11125.192669977738,162685.39133413258
"77.197.210.37",32555,"41.177.26.176",80,22,13711,9,890,13,12821,109.394505,0.6986140000000063,10191.607955179736,146816.4107790555
"77.197.210.37",32846,"41.177.26.176",80,19,13041,7,752,12,12289,110.207479,0.6889699999999976,8731.875117929692,142694.1666545718
"77.197.210.37",33088,"41.177.26.176",80,19,13012,8,863,11,12149,111.033471,0.7700899999999962,8965.18588736386,126208.62496591371
"77.197.210.37",33288,"41.177.26.176",80,18,12685,7,747,11,11938,111.838734,0.6120820000000009,9763.397714685272,156031.38141621524
"77.197.210.37",33426,"41.177.26.176",80,20,12989,8,813,12,12176,112.454139,0.6586029999999994,9875.448487176654,147900.93576858912
"77.197.210.37",33618,"41.177.26.176",80,21,13020,9,879,12,12141,113.277759,0.698174999999992,10071.97335911495,139116.9835642942
"77.197.210.37",33820,"41.177.26.176",80,22,12725,9,890,13,11835,114.091782,0.6199550000000045,11484.704535006491,152720.76199078854
"77.197.210.37",33955,"41.177.26.176",80,21,12658,9,877,12,11781,114.729006,0.5796760000000063,12103.312885128802,162587.376396468
"77.197.210.37",34123,"41.177.26.176",80,20,12774,7,759,13,12015,115.359845,0.6454049999999967,9408.046110581776,148929.74179003958
"77.197.210.37",34376,"41.177.26.176",80,20,12584,8,812,12,11772,116.178466,0.719183000000001,9032.4715684325,130948.59027535393
"77.197.210.37",34613,"41.177.26.176",80,21,13183,9,880,12,12303,117.103072,0.7037329999999997,10003.794052573921,139859.86162365563
"77.197.210.37",34844,"41.177.26.176",80,21,13699,9,926,12,12773,117.875421,0.697529000000003,10620.346967652913,146494.26762184736
"77.197.210.37",35061,"41.177.26.176",80,22,13283,9,880,13,12403,118.697854,0.6502459999999957,10826.671751921653,152594.55652168667
"77.197.210.37",35302,"41.177.26.176",80,20,12598,8,816,12,11782,119.501942,1.1265080000000012,5794.89892659439,83670.95484452831
"77.197.210.37",35496,"41.177.26.176",80,23,13247,10,936,13,12311,120.676777,0.9114369999999923,8215.598006225404,108057.9348874369
"77.197.210.37",35635,"41.177.26.176",80,30,14122,12,1068,18,13054,121.673728,2.042256000000009,4183.608715068024,51135.606897470025
"77.197.210.37",47319,"41.177.26.176",80,22,13855,7,754,15,13101,156.110202,2.075927000000007,2905.689843621659,50487.324457940784
"77.197.210.37",54686,"41.177.26.176",80,18,12565,7,744,11,11821,167.448589,0.6342600000000118,9384.164222873726,149099.73827767515
"77.197.210.37",57298,"41.177.26.176",80,20,12711,8,816,12,11895,171.640198,0.6702009999999916,9740.36147364758,141987.25456989947
"77.197.210.37",57860,"41.177.26.176",80,11,4900,5,607,6,4293,172.458075,0.6399529999999913,7588.05724795425,53666.44112927116
"77.197.210.37",58236,"41.177.26.176",80,19,12471,7,752,12,11719,173.269373,0.5912710000000061,10174.691469732048,158560.11879493334
"77.197.210.37",58440,"41.177.26.176",80,20,12620,9,876,11,11744,173.940224,0.6990110000000129,10025.593302537256,134407.04080479173
"77.197.210.37",58565,"41.177.26.176",80,21,12810,8,817,13,11993,174.682895,0.7080729999999846,9230.686666487978,135500.15323279108
"77.197.210.37",58751,"41.177.26.176",80,21,13197,8,823,13,12374,175.502226,0.6492289999999912,10141.259863622989,152476.24489972158
"77.197.210.37",58925,"41.177.26.176",80,25,11941,10,952,15,10989,176.282777,1.6952269999999885,4492.613673567052,51858.54165843312
"77.197.210.37",59252,"41.177.26.176",80,21,12747,8,811,13,11936,177.986034,0.613617000000005,10573.370685623031,155614.98459136437
"77.197.210.37",59426,"41.177.26.176",80,20,13061,8,860,12,12201,178.784219,0.7246509999999944,9494.225496135454,134696.56427714962
"77.197.210.37",59585,"41.177.26.176",80,20,13048,8,816,12,12232,179.620406,0.6953000000000031,9388.753056234676,140739.2492449296
"77.197.210.37",59701,"41.177.26.176",80,25,11784,10,956,15,10828,180.428588,2.218913000000015,3446.7327020031653,39038.93482980154
"77.197.210.37",60002,"41.177.26.176",80,23,13617,10,951,13,12666,182.683039,0.8856309999999894,8590.485202076363,114413.33918979937
"77.197.210.47",60703,"41.177.26.91",80,46,41736,16,1326,30,40410,126.634119,1.256338999999997,8443.58091247667,257319.0834639383
"77.197.210.56",49964,"41.177.26.91",80,23,19650,8,819,15,18831,99.083656,0.5925790000000006,11056.753614286015,254224.33127059825
"77.197.210.56",17871,"41.177.26.15",80,82,74942,29,2159,53,72783,188.207667,0.8722830000000101,19800.913235727166,667517.3080296111
"77.197.210.56",24114,"41.177.26.15",80,207,201274,67,4592,140,196682,200.519362,1.2464339999999936,29472.88023272808,1262366.0779471742
"77.197.210.67",14688,"244.3.210.197",80,23,17605,10,967,13,16638,63.983286,0.8366310000000041,9246.609317608314,159095.22836232383
"77.197.210.67",61229,"41.177.26.176",80,21,12769,8,808,13,11961,94.274184,0.647956999999991,9975.97062768068,147676.46618525818
"77.197.210.67",64792,"41.177.26.176",80,22,13265,9,871,13,12394,98.530437,0.6073260000000005,11473.245011739979,163259.92959300263
"77.197.210.67",1600,"41.177.26.176",80,21,12747,9,880,12,11867,100.225833,0.6006080000000082,11721.45559166695,158066.49262080874
"77.197.210.67",1899,"41.177.26.176",80,19,12811,8,861,11,11950,101.692171,0.6599829999999969,10436.632458714896,144852.21589040998
"77.197.210.67",3210,"41.177.26.176",80,21,12624,9,877,12,11747,102.462468,0.5961539999999985,11768.771156446182,157637.1206097757
"77.197.210.67",3364,"41.177.26.176",80,21,12650,8,825,13,11825,103.149409,0.6926539999999903,9528.566932407944,136576.12603118052
"77.197.210.67",3578,"41.177.26.176",80,20,12564,8,825,12,11739,103.963835,0.6548799999999915,10078.18226239935,143403.37161006784
"77.197.210.67",3804,"41.177.26.176",80,20,12754,8,815,12,11939,104.777825,0.6327049999999872,10304.960447602172,150958.18746493536
"77.197.210.67",4017,"41.177.26.176",80,24,15105,10,988,14,14117,105.573695,0.6788329999999974,11643.511732635317,166367.86956438542
"77.197.210.67",4244,"41.177.26.176",80,22,12703,9,887,13,11816,106.345796,0.5631629999999888,12600.259605123458,167851.93629553413
"77.197.210.67",4381,"41.177.26.176",80,19,13105,8,861,11,12244,106.96744699999999,0.7495000000000118,9190.1267511673,130689.79319546158
"77.197.210.67",4556,"41.177.26.176",80,22,13227,9,927,13,12300,107.933713,0.6972319999999996,10636.34486082108,141129.49491704346
"77.197.210.67",4632,"41.177.26.176",80,22,12729,9,880,13,11849,108.684694,0.5730020000000025,12286.170030820083,165430.4871536218
"77.197.210.67",4721,"41.177.26.176",80,21,12988,8,862,13,12126,109.339319,0.6471190000000036,10656.463494349513,149907.51314673107
"77.197.210.67",4862,"41.177.26.176",80,21,14358,9,924,12,13434,110.152457,0.6730689999999981,10982.529280058985,159674.5653120264
"77.197.210.67",5021,"41.177.26.176",80,19,12547,7,761,12,11786,110.953352,0.6496000000000066,9371.921182265914,145147.78325123005
"77.197.210.67",5173,"41.177.26.176",80,20,12584,8,823,12,11761,111.778202,0.6782530000000122,9707.292116658358,138721.0966999015
"77.197.210.67",5291,"41.177.26.176",80,25,12467,10,981,15,11486,112.589235,1.3991039999999941,5609.304240428183,65676.31855816321
"77.197.210.67",5497,"41.177.26.176",80,25,11922,10,974,15,10948,114.010967,1.048679000000007,7430.30040651138,83518.40744403141
"77.197.210.67",5667,"41.177.26.176",80,23,13846,10,936,13,12910,115.229468,0.6677729999999968,11213.391377009904,154663.3361935875
"77.197.210.67",5753,"41.177.26.176",80,20,12876,7,797,13,12079,116.034938,0.5520780000000087,11549.092700668925,175033.23805693845
"77.197.210.67",5829,"41.177.26.176",80,21,12761,9,876,12,11885,116.650806,0.6081580000000031,11523.321242177139,156340.95087131884
"77.197.210.67",5928,"41.177.26.176",80,20,12261,8,816,12,11445,117.450111,0.7039459999999877,9273.438587619097,130066.79489620168
"77.197.210.67",6047,"41.177.26.176",80,20,12780,8,823,12,11957,118.327712,0.667974000000001,9856.671068035568,143203.17856683023
"77.197.210.67",6194,"41.177.26.176",80,21,12668,8,826,13,11842,119.126186,0.5824039999999968,11346.075919808305,162663.7179689709
"77.197.210.67",6272,"41.177.26.176",80,19,13014,7,759,12,12255,119.731637,0.614104999999995,9887.559944960632,159646.96590973987
"77.197.210.67",6356,"41.177.26.176",80,21,12683,9,889,12,11794,120.545103,0.6271880000000039,11339.502669056099,150436.5517197386
"77.197.210.67",6445,"41.177.26.176",80,21,12773,9,889,12,11884,121.356161,0.570650999999998,12462.958971420403,166602.7046303263
"77.197.210.67",6486,"41.177.26.176",80,20,12563,8,815,12,11748,122.010587,0.609999000000002,10688.542112364084,154072.38372521874
"77.197.210.71",24579,"41.177.26.15",80,234,235542,70,4784,164,230758,67.608342,1.3960720000000038,27414.05887375429,1322327.2152152576
"77.197.210.80",30890,"41.177.26.91",80,22,17546,9,884,13,16662,98.397083,0.4325639999999993,16349.02580889767,308153.2443753993
"77.197.210.81",39341,"41.177.26.15",80,39,32589,15,1262,24,31327,65.934971,0.7319490000000002,13793.31073613052,342395.4401194618
"77.197.210.82",60651,"41.177.26.15",80,31,24664,13,1134,18,23530,189.58311,0.8809839999999838,10297.576346449161,213670.16881124227
"77.197.210.103",46892,"41.177.26.46",80,118,129520,32,2315,86,127205,8.350007,1.0966930000000001,16887.13249742635,927916.9284384963
"77.197.210.103",4048,"41.177.98.142",80,7,1041,4,470,3,571,53.424269,0.17064999999999486,22033.40169938537,26768.239085849033
"77.197.210.103",16063,"244.3.210.197",80,23,17616,10,979,13,16637,94.852438,1.2560379999999896,6235.480136747507,105964.9469203966
"77.197.210.103",18847,"41.177.26.15",80,304,264468,122,8482,182,255986,98.277534,1.770820999999998,38318.94923315235,1156462.4544208604
"77.197.210.103",31763,"41.177.98.142",80,7,934,4,577,3,357,125.736141,0.1869999999999976,24684.49197860994,15272.727272727469
"77.197.210.106",24314,"41.177.26.15",80,14,9333,6,741,8,8592,64.377188,0.6669589999999914,8888.102567024474,103058.80871238095
"77.197.210.106",3108,"41.177.26.15",80,66,56734,25,1921,41,54813,187.853624,5.621474000000006,2733.8025578344723,78005.16377021391
"77.197.210.108",64520,"41.177.26.15",80,28,23282,10,943,18,22339,153.967842,0.6201450000000079,12164.896919268725,288177.76487756526
"77.197.210.108",46847,"244.3.210.197",80,22,17282,9,902,13,16380,154.20268,1.219947000000019,5915.011061955878,107414.50243330076
"77.197.210.108",4204,"41.177.26.15",80,175,167197,59,4079,116,163118,158.035856,7.2408729999999935,4506.638909424323,180219.15313250228
"77.197.210.108",10518,"41.177.26.15",80,30,25354,11,1006,19,24348,165.471097,0.5774430000000166,13937.306366169074,337321.6057688714
"77.197.210.110",38785,"41.177.26.15",80,26,20855,10,943,16,19912,36.190435,0.6383670000000023,11817.653481461248,249536.70850780103
"77.197.210.110",39373,"41.177.26.91",80,22,17935,8,819,14,17116,36.958882,0.42010699999999446,15596.026726524638,325936.0115399215
"77.197.210.111",45741,"41.177.26.15",80,225,217964,74,5039,151,212925,5.975765,1.5808290000000005,25500.544334649723,1077535.9004674125
"77.197.210.111",31067,"41.177.26.15",80,29,22496,12,1071,17,21425,126.750417,0.7103450000000038,12061.744645207546,241291.20357009495
"77.197.210.111",31538,"41.177.26.91",80,21,17617,8,818,13,16799,127.404143,0.4342879999999951,15068.34174556993,309453.63445455895
"77.197.210.117",25107,"41.177.26.46",80,16,11044,7,800,9,10244,188.087997,0.5800000000000125,11034.482758620452,141296.5517241349
"77.197.210.123",55750,"41.177.26.15",80,33,26877,13,1135,20,25742,156.220809,1.0184840000000008,8915.211235522593,202198.56178398465
"77.197.210.123",61159,"41.177.26.15",80,33,28072,12,1070,21,27002,163.546327,0.7063540000000046,12118.569442517413,305818.32905313565
"77.197.210.128",16334,"41.177.26.176",80,19,12523,7,761,12,11762,94.937638,0.6376409999999879,9547.692196706477,147568.92985238053
"77.197.210.128",61119,"41.177.26.15",80,269,269397,82,5551,187,263846,98.539624,1.517747,29259.15847634685,1390724.5410466962
"77.197.210.128",62018,"41.177.26.91",80,26,21942,10,938,16,21004,99.767008,0.6636949999999899,11306.398270289988,253176.53440210118
"77.197.210.128",22854,"41.177.26.176",80,21,13133,9,924,12,12209,104.681907,0.6278000000000077,11774.450461930406,155578.20962089646
"77.197.210.128",24777,"41.177.26.176",80,33,24612,13,1144,20,23468,108.148482,1.6780370000000033,5453.991777296914,111883.11103986362
"77.197.210.128",5145,"41.177.26.15",80,110,108672,33,2415,77,106257,109.620148,0.8794589999999971,21968.050813056736,966566.9462703808
"77.197.210.128",25549,"41.177.26.176",80,23,11824,9,893,14,10931,109.914936,1.6879200000000054,4232.4280771600415,51808.14256599822
"77.197.210.128",26085,"41.177.26.176",80,18,12577,7,752,11,11825,111.754415,0.6817060000000055,8824.918659950114,138769.49887488043
"77.197.210.128",26319,"41.177.26.176",80,21,13241,9,924,12,12317,112.549193,0.6171159999999958,11978.29905560713,159671.76349341238
"77.197.210.128",26575,"41.177.26.176",80,19,13051,7,762,12,12289,113.363649,0.6557770000000005,9295.842946611418,149916.81623478702
"77.197.210.128",26843,"41.177.26.176",80,20,12814,7,761,13,12053,114.190019,0.7003869999999921,8692.337236413681,137672.45822666766
"77.197.210.128",27092,"41.177.26.176",80,18,12737,7,796,11,11941,115.006957,0.7407699999999977,8596.460439812654,128957.70617060666
"77.197.210.128",27397,"41.177.26.176",80,21,12756,9,876,12,11880,115.938441,0.6404250000000076,10942.73334114052,148401.4521606728
"77.197.210.128",27663,"41.177.26.176",80,22,13031,9,889,13,12142,116.753632,0.6711110000000104,10597.35274790592,144739.0968111065
"77.197.210.128",28006,"41.177.26.176",80,19,13315,7,752,12,12563,117.560831,0.6957200000000086,8647.156902201928,144460.41510952506
"77.197.210.128",28356,"41.177.26.176",80,20,12676,8,823,12,11853,118.480557,0.6360779999999977,10350.931803961186,149076.05671002666
"77.197.210.128",28684,"41.177.26.176",80,20,12721,7,752,13,11969,119.195516,0.6226290000000034,9662.254729541937,153786.60486421204
"77.197.210.128",29005,"41.177.26.176",80,19,13226,8,825,11,12401,120.02633,0.7096909999999923,9299.822035223882,139790.41582886226
"77.197.210.128",29269,"41.177.26.176",80,22,13468,9,879,13,12589,120.823167,0.6471839999999958,10865.534376622485,155615.7136146763
"77.197.210.128",29429,"41.177.26.176",80,20,12961,8,860,12,12101,121.616776,0.6225039999999922,11052.13781758846,155513.8601519046
"77.197.210.128",29615,"41.177.26.176",80,24,13031,11,1008,13,12023,122.428009,1.3219959999999986,6099.867170551203,72756.64979319158
"77.197.210.136",27681,"41.177.26.15",80,326,322704,103,7099,223,315605,37.298323,1.8102329999999967,31372.756987636458,1394759.6801074804
"77.197.210.136",56184,"41.177.26.176",80,22,12716,9,889,13,11827,93.573108,0.5838519999999932,12181.169200413946,162054.7673040447
"77.197.210.136",58095,"41.177.26.176",80,23,12883,9,880,14,12003,96.135766,0.5702739999999977,12344.942957245163,168382.2162679701
"77.197.210.136",58790,"41.177.26.176",80,25,12141,10,965,15,11176,97.38432,1.125152,6861.295185006115,79463.04143795684
"77.197.210.136",59536,"41.177.26.176",80,21,13351,8,863,13,12488,98.693785,0.7924189999999953,8712.562419629061,126074.71552297533
"77.197.210.136",59831,"41.177.26.176",80,19,12976,8,862,11,12114,99.859109,0.7574579999999997,9104.135146767216,127943.727573014
"77.197.210.136",60172,"41.177.26.176",80,21,12578,9,876,12,11702,100.765011,0.6408930000000055,10934.742616942203,146071.18504960922
"77.197.210.136",60432,"41.177.26.176",80,27,13164,11,1042,16,12122,101.598064,1.0586010000000101,7874.543855522449,91607.69732883218
"77.197.210.136",60733,"41.177.26.176",80,22,13544,9,887,13,12657,102.821427,0.6380010000000027,11122.239620314027,158708.2151908846
"77.197.210.136",60928,"41.177.26.176",80,20,12613,8,816,12,11797,103.633971,0.6945839999999919,9398.43129124782,135874.13473388547
"77.197.210.136",61098,"41.177.26.176",80,22,12766,9,885,13,11881,104.445977,0.6516330000000039,10865.011440488677,145861.2439824248
"77.197.210.136",61270,"41.177.26.176",80,21,12781,9,880,12,11901,105.24547,0.5826200000000057,12083.347636538278,163413.5457073205
"77.197.210.136",61378,"41.177.26.176",80,21,13042,9,889,12,12153,105.85794,0.7396540000000016,9615.306616336808,131445.2433164693
"77.197.210.136",61518,"41.177.26.176",80,20,12964,8,816,12,12148,106.665877,0.8138560000000012,8021.074981323465,119411.78783470276
"77.197.210.136",61696,"41.177.26.176",80,25,13326,10,1079,15,12247,107.680283,1.7725119999999919,4869.9247170118115,55275.225217093284
"77.197.210.136",62016,"41.177.26.176",80,20,12849,8,826,12,12023,109.512842,0.7372399999999999,8963.159893657426,130464.97748358746
"77.197.210.136",62126,"41.177.26.176",80,19,12844,7,761,12,12083,110.337374,0.6651470000000046,9152.863953381671,145327.27351998782
"77.197.210.136",62222,"41.177.26.176",80,20,12863,8,815,12,12048,111.146462,0.6340229999999991,10283.53860979808,152019.72168202122
"77.197.210.136",62316,"41.177.26.176",80,20,12589,8,816,12,11773,111.806173,0.6621899999999954,9858.197798215082,142231.08171370853
"77.197.210.136",62403,"41.177.26.176",80,20,12680,7,759,13,11921,112.61624,0.549554999999998,11048.93959658273,173536.77065989817
"77.197.210.136",62477,"41.177.26.176",80,20,13027,9,924,11,12103,113.214974,0.6466269999999952,11431.629053534813,149737.01995122494
"77.197.210.136",62607,"41.177.26.176",80,22,13450,9,924,13,12526,114.026686,0.6442169999999976,11474.394497506319,155550.0708612166
"77.197.210.136",62733,"41.177.26.176",80,21,12943,8,823,13,12120,114.867961,0.6752230000000026,9750.852681262302,143597.00424896608
"77.197.210.136",62851,"41.177.26.176",80,20,12988,8,813,12,12175,115.68103,0.667942999999994,9737.357828437545,145820.82602856963
"77.197.210.136",62924,"41.177.26.176",80,22,13436,9,926,13,12510,116.500443,0.7743150000000014,9567.165817529025,129249.72394955518
"77.197.210.136",62985,"41.177.26.176",80,25,12314,10,978,15,11336,117.297255,1.3132049999999964,5957.9425908369385,69058.52475432263
"77.197.210.136",63085,"41.177.26.176",80,25,12406,10,974,15,11432,118.729166,1.0493749999999977,7425.372245384174,87152.82906491979
"77.197.210.136",63988,"244.3.210.197",80,27,21208,11,1051,16,20157,123.397689,1.2359160000000031,6803.051340058692,130474.88664278122
"77.197.210.152",58690,"41.177.26.91",80,24,20572,9,884,15,19688,3.839047,0.5955500000000002,11874.737637477956,264468.13869532355
"77.197.210.152",59720,"244.3.210.197",80,23,16769,10,996,13,15773,4.632747,0.7421139999999999,10736.894870599397,170033.1754959481
"77.197.210.152",61385,"41.177.26.15",80,42,36135,16,1327,26,34808,7.229666,0.9704759999999997,10938.961911474373,286935.48320617934
"77.197.210.152",1248,"41.177.26.15",80,29,23055,12,1070,17,21985,14.391739,0.8580320000000015,9976.3178995655,204980.7000205117
"77.197.210.152",46758,"41.177.26.15",80,24,19020,9,879,15,18141,126.629398,0.6172200000000032,11393.020316904773,235131.71964615412
"77.197.210.152",51958,"41.177.26.15",80,280,252397,105,7624,175,244773,134.996521,1.4193089999999984,42973.02419698605,1379674.1935688439
"77.197.210.152",54019,"41.177.26.15",80,177,171750,56,3887,121,167863,138.847835,1.1443160000000034,27174.311990743732,1173542.9723957332
"77.197.210.153",40996,"41.177.26.15",80,21,16885,8,815,13,16070,6.71797,0.5087640000000002,12815.37215683499,252690.83504335987
"77.197.210.159",12671,"41.177.26.15",80,7,1014,4,623,3,391,6.62667,0.29823300000000064,16711.765632911145,10488.443599467508
"77.197.210.160",44341,"244.3.210.197",80,22,16221,10,962,12,15259,94.735066,0.769250999999997,10004.536880680076,158689.4264680845
"77.197.210.160",51471,"244.3.210.197",80,25,19138,11,988,14,18150,105.590954,2.2005419999999987,3591.842373378924,65983.7440048861
"77.197.210.164",51319,"41.177.26.15",80,30,25431,11,1007,19,24424,95.965367,0.7116120000000024,11320.775928455358,274576.5951108179
"77.197.210.164",28104,"41.177.26.15",80,7,1011,4,619,3,392,188.716136,0.17617099999998231,28109.05313587649,17800.88663855183
"77.197.210.176",60813,"41.177.26.15",80,29,23485,11,1006,18,22479,34.588699,0.8255780000000001,9748.321781830426,217825.571902352
"77.197.210.176",63141,"41.177.26.15",80,345,308955,132,9396,213,299559,37.852434,5.073153999999995,14816.818097775087,472383.0579556627
"77.197.210.181",62660,"41.177.26.15",80,167,161771,54,3759,113,158012,94.342142,1.4758950000000084,20375.4332117121,856494.5338252333
"77.197.210.181",18831,"41.177.26.15",80,206,200563,66,4802,140,195761,125.380649,1.42369699999999,26983.269614250974,1100014.9610486017
"77.197.210.186",53952,"41.177.26.91",80,26,22032,10,943,16,21089,184.796576,0.5344460000000026,14115.551430827367,315676.42006863025
"77.197.210.202",12232,"41.177.26.91",80,22,17678,9,879,13,16799,37.33195,0.4374310000000037,16075.678221250759,307230.1688723453
"77.197.210.203",65407,"41.177.26.46",80,14,9581,6,631,8,8950,67.961098,0.469348999999994,10755.322798173778,152551.725901197
"77.197.210.203",43795,"244.3.210.197",80,22,17429,9,905,13,16524,154.129404,0.8320410000000038,8701.494277325237,158876.78611991403
"77.197.210.203",46671,"41.177.26.15",80,7,1021,4,628,3,393,159.692533,0.17905799999999772,28057.947704096237,17558.556445397804
"77.197.210.203",47593,"41.177.26.91",80,22,17380,9,888,13,16492,160.555855,0.4844829999999831,14663.053192785397,272323.2806930369
"77.197.210.203",54166,"244.3.210.197",80,21,16181,9,902,12,15279,168.606112,0.6833819999999946,10559.24797551012,178863.35899979947
"77.197.210.203",55283,"41.177.26.15",80,24,18734,10,943,14,17791,170.321032,0.6963330000000099,10833.897000429239,204396.4597398055
"77.197.210.203",55529,"41.177.26.91",80,33,32949,10,941,23,32008,170.73842,34.150710000000004,220.43465567772967,7498.0578734673445
"77.197.210.203",57213,"244.3.210.197",80,21,16103,9,904,12,15199,173.410989,0.7185279999999921,10065.021822392559,169223.74632582354
"77.197.210.203",57496,"41.177.26.15",80,7,1015,4,623,3,392,173.887949,0.16777300000001105,29706.80622030763,18691.923015025026
"77.197.210.203",55529,"41.177.26.91",8000,2,1582,1,64,1,1518,178.414964,0.07882900000001314,6495.071610700563,154054.97976630396
"77.197.210.213",42141,"41.177.26.91",80,23,19026,9,883,14,18143,128.623486,0.5418049999999823,13037.901089875933,267889.73892822093
"77.197.210.213",50728,"41.177.26.91",80,22,14636,11,1015,11,13621,137.65736,0.6555259999999805,12386.99914267358,166229.86731266684
"77.197.210.213",57332,"244.3.210.197",80,21,16034,9,893,12,15141,153.948689,0.7586990000000071,9416.118908816188,159652.24680670313
"77.197.210.217",19113,"41.177.26.91",80,22,17640,9,894,13,16746,5.495864,0.4227210000000001,16918.96073296571,316918.2510450154
"77.197.210.217",41512,"41.177.26.15",80,205,195505,69,4719,136,190786,66.221326,6.172623999999999,6116.037523102008,247267.28859557948
"77.197.210.217",57260,"41.177.26.176",80,19,12825,8,816,11,12009,94.441212,0.6964910000000089,9372.698283251208,137937.17363181832
"77.197.210.217",62025,"41.177.26.176",80,21,12103,8,839,13,11264,100.956394,1.2372680000000003,5424.855407235941,72831.4318320687
"77.197.210.217",63759,"41.177.26.176",80,21,12656,9,889,12,11767,105.143741,0.5947649999999953,11957.663951308594,158274.27639487988
"77.197.210.217",64581,"41.177.26.176",80,18,12648,7,760,11,11888,106.201585,0.6165320000000065,9861.613022519408,154256.38896277727
"77.197.210.217",1064,"41.177.26.176",80,20,12770,8,825,12,11945,107.072487,0.7302690000000069,9037.765535713466,130855.89008981497
"77.197.210.217",1440,"41.177.26.176",80,20,12857,8,823,12,12034,107.824352,0.9523539999999997,6913.395649096871,101088.46080344077
"77.197.210.217",1924,"41.177.26.176",80,20,12938,8,815,12,12123,109.030871,0.6633399999999909,9829.046944251952,146205.5657732103
"77.197.210.217",3301,"41.177.26.176",80,21,13142,9,926,12,12216,109.825086,0.7658590000000061,9672.798778887422,127605.73421478266
"77.197.210.217",3624,"41.177.26.176",80,20,12742,7,752,13,11990,110.623947,0.7373589999999979,8158.847996701766,130085.88760698693
"77.197.210.217",3961,"41.177.26.176",80,19,12619,8,823,11,11796,111.434789,0.6219350000000077,10586.315290182927,151732.89813243962
"77.197.210.217",4330,"41.177.26.176",80,18,12887,7,761,11,12126,112.252664,0.7198390000000074,8457.446734616959,134763.46794213567
"77.197.210.217",4706,"41.177.26.176",80,20,13007,8,825,12,12182,113.062464,0.7169319999999999,9205.894003894373,135934.78879447424
"77.197.210.217",5110,"41.177.26.176",80,19,12607,8,823,11,11784,113.912469,0.604069999999993,10899.399076266121,156061.38361448358
"77.197.210.217",5459,"41.177.26.176",80,19,12528,8,826,11,11702,114.709693,0.6871170000000006,9616.993903512785,136244.6279163518
"77.197.210.217",5898,"41.177.26.176",80,19,13050,8,815,11,12235,115.535449,0.641414999999995,10165.025763351421,152600.1106927664
"77.197.210.217",6292,"41.177.26.176",80,22,13462,9,879,13,12583,116.319763,0.6568749999999994,10705.23311132256,153246.8125594673
"77.197.210.217",6920,"41.177.26.176",80,24,11566,10,941,14,10625,117.124007,1.7149280000000005,4389.688663314144,49564.76306877022
"77.197.210.217",7671,"41.177.26.176",80,21,12750,8,816,13,11934,118.973527,0.6636349999999993,9836.73254123126,143862.21341550717
"77.197.210.217",7925,"41.177.26.176",80,20,13466,7,752,13,12714,119.781858,0.6624850000000038,9080.960323629917,153531.0233439239
"77.197.210.217",10722,"41.177.26.176",80,19,12614,8,812,11,11802,120.559375,0.6267709999999909,10364.231912453024,150638.75003789482
"77.197.210.217",11020,"41.177.26.176",80,19,12630,8,823,11,11807,121.383279,0.6123259999999959,10752.442326473225,154257.69933009642
"77.197.210.217",11385,"41.177.26.176",80,19,12548,8,826,11,11722,122.217495,0.6873649999999998,9613.524110188913,136428.24409156712
"77.197.210.217",26195,"41.177.26.176",80,23,13118,9,926,14,12192,156.114714,0.6794650000000217,10902.69550307928,143548.23280080192
"77.197.210.217",34529,"41.177.26.176",80,23,14805,10,991,13,13814,169.458173,0.8702090000000169,9110.455074585354,126994.7794150576
"77.197.210.217",37295,"41.177.26.176",80,36,28253,13,1135,23,27118,175.27563,0.79224099999999,11461.158915027265,273835.865601506
"77.197.210.217",37854,"41.177.26.176",80,18,12519,7,757,11,11762,176.264892,0.6242619999999874,9701.055005750986,150731.5838542181
"77.197.210.217",38266,"41.177.26.176",80,20,12702,8,825,12,11877,177.096801,0.8700570000000027,7585.709901765033,109206.63818577369
"77.197.210.217",38530,"41.177.26.176",80,21,12887,7,762,14,12125,178.035372,0.6717830000000049,9074.358833135038,144391.8646348587
"77.197.210.217",38735,"41.177.26.176",80,29,13874,12,1107,17,12767,178.85857,1.281735000000026,6909.384545167152,79685.73847167935
"77.197.210.217",38987,"41.177.26.176",80,21,13053,8,815,13,12238,180.28998,0.6372679999999775,10231.174325401918,153630.81152671005
"77.197.210.217",39116,"41.177.26.176",80,18,12584,7,761,11,11823,181.075532,0.6530379999999809,9322.581534306086,144836.90076228758
"77.197.210.217",39331,"41.177.26.176",80,23,12144,10,951,13,11193,181.74818,2.16797200000002,3509.2704149315255,41303.11646091332
"77.197.210.218",4067,"244.3.210.197",80,20,15994,8,837,12,15157,94.604941,1.4113899999999973,4744.259205464126,85912.46926788501
"77.197.210.218",23217,"41.177.26.15",80,94,83285,35,2543,59,80742,125.920337,0.9360229999999916,21734.50866057798,690085.6068707776
"77.197.210.218",23641,"41.177.26.91",80,22,17296,9,883,13,16413,126.967527,0.43934999999999036,16078.297484921259,298859.67907136196
"77.197.210.218",27886,"41.177.26.91",80,24,18285,10,974,14,17311,133.975293,0.42385300000000825,18383.732095797004,326735.9202364907
"77.197.210.218",33102,"41.177.26.46",80,7,935,4,580,3,355,155.35786,0.18633400000001643,24901.520924788772,15241.448152241403
"77.197.210.224",7175,"41.177.26.15",80,29,25616,10,942,19,24674,7.948337,0.746357999999999,10097.031183426734,264473.617218547
"77.197.210.224",3566,"41.177.26.15",80,25,20550,9,879,16,19671,66.912558,0.5735229999999945,12261.060149287941,274388.29828969634
"77.197.210.224",44924,"41.177.26.15",80,14,9333,6,741,8,8592,98.668767,0.6773510000000016,8751.740235121799,101477.66815137179
"77.197.210.224",14052,"41.177.26.15",80,7,1022,4,631,3,391,125.186266,0.23489499999999452,21490.453181209126,13316.588262841155
"77.197.210.224",32667,"41.177.26.91",80,21,17088,8,814,13,16274,128.566782,0.4310250000000053,15108.17237979217,302052.08514586947
"77.197.210.224",5098,"41.177.26.91",80,22,16899,9,825,13,16074,154.175517,0.4160739999999805,15862.562909483191,309060.4075236761
"77.197.210.224",6222,"41.177.26.91",80,21,17533,8,819,13,16714,155.820463,0.5081890000000158,12892.841049294253,263114.70732344827
"77.197.210.224",6910,"41.177.26.91",80,22,17796,8,815,14,16981,156.820288,0.479771999999997,13589.78848286278,283151.1634693164
"77.197.210.224",19256,"41.177.26.15",80,33,27100,13,1135,20,25965,186.275441,0.849096000000003,10693.726033334238,244636.64885949207
"77.197.210.231",32023,"41.177.26.15",80,95,85196,35,2543,60,82653,36.198597,0.9890469999999993,20569.295493540765,668546.5908091329
"77.197.210.231",36520,"41.177.26.15",80,7,1035,4,643,3,392,44.291914,0.2557120000000026,20116.380928544408,12263.796771367664
"77.197.210.231",57609,"41.177.26.91",80,24,18629,10,963,14,17666,95.557251,0.4354900000000015,17690.41769041763,324526.39555443183
"77.197.210.231",4033,"41.177.26.15",80,104,95419,36,2607,68,92812,127.16543,1.067930000000004,19529.369902521626,695266.5436873178
"77.197.210.231",18417,"41.177.26.46",80,20,14649,8,859,12,13790,158.041426,0.6125059999999962,11219.481931605636,180112.52134673076
"77.197.210.239",52385,"41.177.26.15",80,7,1035,4,643,3,392,97.454105,0.4998680000000064,10290.716749221663,6273.656245248665
"77.197.210.241",39942,"41.177.26.15",80,224,216717,73,4975,151,211742,5.183278,1.4889920000000005,26729.49216651264,1137639.423180245
"77.197.210.241",54181,"41.177.26.91",80,23,18933,9,907,14,18026,34.63719,0.5444800000000001,13326.476638260358,264854.54011166614
"77.197.210.247",7474,"41.177.26.15",80,462,450333,151,9968,311,440365,126.075549,1.9541250000000048,40808.03428644524,1802812.0002558646
"77.197.210.247",14320,"41.177.26.15",80,26,21195,10,943,16,20252,133.303193,0.8591650000000186,8780.618391112112,188573.7896678711
"77.197.210.247",15920,"41.177.26.15",80,33,24982,14,1211,19,23771,136.319529,4.459895000000017,2172.248449795334,42639.568868773655
"77.197.210.249",47460,"41.177.26.91",80,21,17562,8,817,13,16745,38.080884,0.41955899999999957,15578.261936938563,319287.63296699664
"77.197.213.197",63880,"41.177.26.176",80,67,62536,15,1872,52,60664,205.358874,3.2192480000000216,4652.018111061931,150753.21938539582
"77.197.213.197",63931,"41.177.26.176",80,8,1963,4,751,4,1212,208.467524,0.7950000000000159,7557.232704402364,12196.226415094096
"77.197.213.197",63944,"41.177.26.15",80,3,196,2,130,1,66,209.425323,0.08235100000001694,12628.869109054973,6411.579701520217
"77.197.217.20",37818,"41.177.26.15",80,191,176326,67,4592,124,171734,6.958296,2.5234809999999994,14557.668553874591,544435.2463917899
"77.197.217.20",38567,"41.177.26.91",80,30,25897,11,1000,19,24897,8.177636,0.7279210000000003,10990.203607259575,273623.09920994163
"77.197.217.20",45215,"41.177.26.91",80,24,18857,10,917,14,17940,17.35466,0.44053000000000253,16652.668376727936,325789.39005288895
"77.197.217.20",54218,"41.177.26.176",80,21,12787,9,880,12,11907,34.291026,0.592489999999998,11882.057081132212,160772.33371027414
"77.197.217.20",56101,"41.177.26.176",80,24,12251,9,885,15,11366,36.769775,2.25141,3144.6959905126123,40387.13517306932
"77.197.217.20",57626,"41.177.26.176",80,23,11632,8,839,15,10793,39.09267,0.9877340000000032,6795.351784994723,87416.24769421699
"77.197.217.20",58236,"41.177.26.176",80,19,13222,8,862,11,12360,40.40442,0.7342629999999986,9391.730211109661,134665.644326352
"77.197.217.20",58685,"41.177.26.176",80,21,12737,9,888,12,11849,41.160416,0.5584350000000029,12721.265679980594,169745.80747983116
"77.197.217.20",59002,"41.177.26.176",80,20,12967,8,860,12,12107,41.787107,0.6623310000000018,10387.555466979473,146235.03957990755
"77.197.217.20",59384,"41.177.26.176",80,19,12678,7,759,12,11919,42.529962,0.6167500000000032,9845.156059991841,154603.97243615647
"77.197.217.20",59692,"41.177.26.176",80,21,13196,8,863,13,12333,43.242567,0.8011589999999984,8617.515374601064,123151.58414247383
"77.197.217.20",60090,"41.177.26.176",80,20,12870,8,825,12,12045,44.193927,0.7182239999999993,9189.333689768104,134164.27187061432
"77.197.217.20",60575,"41.177.26.176",80,21,12940,8,808,13,12132,44.972008,0.7245849999999976,8920.968554413936,133947.0179482053
"77.197.217.20",61039,"41.177.26.176",80,19,12360,8,862,11,11498,46.273216,0.938403000000001,7348.655108732594,98021.85201880205
"77.197.217.20",61641,"41.177.26.176",80,19,12678,7,749,12,11929,48.49841,0.7068780000000032,8476.710266835256,135004.90890931612
"77.197.217.20",62202,"41.177.26.176",80,22,13602,9,878,13,12724,49.301323,0.6073040000000063,11565.871458116408,167612.9253224068
"77.197.217.20",62437,"41.177.26.176",80,23,12474,9,916,14,11558,50.020701,1.549792999999994,4728.373402125335,59662.161333804164
"77.197.217.20",62933,"41.177.26.176",80,21,12126,8,816,13,11310,51.602317,1.1591880000000003,5631.528276690234,78054.63824677272
"77.197.217.20",63225,"41.177.26.176",80,19,12556,8,825,11,11731,52.891548,0.9179010000000005,7190.317910101412,102241.96291321171
"77.197.217.20",63436,"41.177.26.176",80,20,12785,7,759,13,12026,53.865852,0.6576420000000027,9232.98694426447,146292.35967289133
"77.197.217.20",63634,"41.177.26.176",80,20,13184,8,826,12,12358,54.731752,0.674675999999998,9794.330908465721,146535.5222358588
"77.197.217.20",63917,"41.177.26.176",80,21,12827,9,879,12,11948,55.568477,0.626615000000001,11222.201830470047,152540.23603009796
"77.197.217.20",64158,"41.177.26.176",80,22,12988,9,924,13,12064,56.407039,0.5903460000000038,12521.470459696437,163483.78747378552
"77.197.217.20",64340,"41.177.26.176",80,18,12735,7,748,11,11987,57.195665,0.7629209999999986,7843.538190717009,125695.84531032725
"77.197.217.20",64570,"41.177.26.176",80,20,12743,8,816,12,11927,58.023499,0.7447450000000018,8765.416350562924,128119.02060436763
"77.197.217.20",64796,"41.177.26.176",80,23,11777,9,890,14,10887,58.820134,1.756845999999996,4052.717198889383,49575.20465652664
"77.197.217.20",65248,"41.177.26.176",80,25,12599,10,986,15,11613,60.66252,1.4842099999999974,5314.611813692142,62594.91581380004
"77.197.217.20",1122,"41.177.26.176",80,26,12681,12,1134,14,11547,62.267368,1.5452830000000048,5870.769302451377,59779.34138924696
"77.197.217.20",26336,"41.177.26.15",80,381,388412,112,7472,269,380940,125.745175,1.866969999999995,32017.6542740377,1632334.7456038438
"77.197.217.152",44615,"41.177.26.176",80,21,13042,9,877,12,12165,35.412954,0.6608000000000018,10617.433414043555,147276.02905568967
"77.197.217.152",45711,"41.177.26.15",80,157,153697,51,3567,106,150130,36.744468,5.686523000000001,5018.180705503169,211208.14951421102
"77.197.217.152",50804,"41.177.26.176",80,23,11872,8,797,15,11075,45.806892,1.8539810000000045,3439.0859453252133,47789.05501189051
"77.197.217.152",53276,"41.177.26.176",80,29,14927,12,1109,17,13818,50.609641,1.8576829999999944,4775.8417340310625,59506.38510445557
"77.197.217.152",54378,"41.177.26.176",80,20,12695,7,761,13,11934,52.515947,0.7447920000000039,8174.094243761974,128186.12444816741
"77.197.217.152",54811,"41.177.26.176",80,24,11229,9,895,15,10334,53.345458,1.2076069999999959,5929.081232553326,68459.35805274421
"77.197.217.152",55285,"41.177.26.176",80,20,12850,8,826,12,12024,54.719184,0.7173790000000011,9211.309503066008,134088.11799620543
"77.197.217.152",55609,"41.177.26.176",80,22,12221,8,838,14,11383,55.54205,1.1141719999999964,6017.024301454373,81732.44346474358
"77.197.217.152",56047,"41.177.26.176",80,23,15764,9,877,14,14887,56.767775,0.6786680000000018,10337.897175054639,175484.92046184538
"77.197.217.152",56303,"41.177.26.176",80,21,12828,7,759,14,12069,57.576224,0.6441949999999963,9425.717368188258,149880.08289415558
"77.197.217.152",56510,"41.177.26.176",80,20,12873,8,860,12,12013,58.389356,0.6867420000000024,10018.318378663276,139941.92870102552
"77.197.217.152",56696,"41.177.26.176",80,19,12514,7,751,12,11763,59.217052,0.5621620000000007,10687.310775185786,167396.5867490152
"77.197.217.152",56884,"41.177.26.176",80,19,12803,8,861,11,11942,59.899437,0.7469660000000005,9221.303245395367,127898.7263141829
"77.197.217.152",57092,"41.177.26.176",80,33,22489,12,1114,21,21375,60.697474,1.2629209999999986,7056.6567505014245,135400.39321541108
"77.197.217.152",57370,"41.177.26.176",80,35,26199,14,1184,21,25015,62.092715,0.712885,13286.855523681941,280718.4889568444
"77.197.217.152",30885,"41.177.26.15",80,7,1017,4,626,3,391,158.567928,0.16963400000000206,29522.38348444262,18439.699588525662
"77.197.217.218",4537,"41.177.26.15",80,186,193097,51,3567,135,189530,5.135886,1.628952,17518.011580451726,930807.0464936966
"77.197.217.218",27502,"41.177.26.91",80,25,19523,10,936,15,18587,66.36274,0.5480780000000038,13662.28894427426,271304.4493666941
"77.197.217.218",32072,"41.177.26.91",80,24,18828,10,966,14,17862,72.810244,0.5914410000000032,13066.39208306485,241606.51696449725
"77.197.217.218",62376,"244.3.210.197",80,23,17322,10,924,13,16398,183.655916,0.7903190000000109,9353.185232798272,165988.67039764728
"77.197.217.224",14186,"41.177.26.176",80,20,12720,8,826,12,11894,35.576349,0.6716219999999993,9838.867696412575,141674.93024350022
"77.197.217.224",18516,"41.177.26.176",80,20,12703,8,825,12,11878,42.365847,0.7071509999999961,9333.225859823484,134375.82637937376
"77.197.217.224",20135,"41.177.26.176",80,21,12762,8,813,13,11949,46.777391,0.6447429999999983,10087.740386479602,148263.72678726292
"77.197.217.224",20726,"41.177.26.176",80,26,12984,11,1019,15,11965,48.125143,4.402729999999998,1851.5784524601788,21741.056117454405
"77.197.217.224",22658,"41.177.26.176",80,21,12827,9,880,12,11947,52.732328,0.6294409999999999,11184.527223361683,151842.6667471614
"77.197.217.224",22942,"41.177.26.176",80,20,12942,8,823,12,12119,53.556634,0.6396569999999997,10293.016413484107,151568.73136696705
"77.197.217.224",23168,"41.177.26.176",80,20,12702,7,762,13,11940,54.362478,0.6275890000000004,9713.363363602606,152201.52042180463
"77.197.217.224",23384,"41.177.26.176",80,21,12758,9,889,12,11869,55.166711,0.5721759999999989,12429.741897597965,165948.93878806554
"77.197.217.224",23530,"41.177.26.176",80,19,13306,7,798,12,12508,55.774236,0.7063539999999975,9037.961135634572,141662.67905327975
"77.197.217.224",23805,"41.177.26.176",80,18,12459,7,761,11,11698,56.589424,0.7273089999999982,8370.582517196975,128671.58250482289
"77.197.217.224",24010,"41.177.26.176",80,24,12567,10,983,14,11584,57.447539,1.0844220000000035,7251.789432527165,85457.50639511159
"77.197.217.224",24184,"41.177.26.176",80,19,12137,8,816,11,11321,58.742265,0.7103199999999958,9190.22412433838,127503.09719563088
"77.197.217.224",24347,"41.177.26.176",80,18,12534,7,759,11,11775,59.51157,0.640546999999998,9479.398076956131,147061.8081108807
"77.197.217.224",24487,"41.177.26.176",80,28,15052,10,942,18,14110,60.249184,1.6062360000000027,4691.714044511508,70276.09890451952
"77.197.217.224",24764,"41.177.26.176",80,15,9304,7,808,8,8496,61.986897,2.4277680000000004,2662.527885695832,27996.085293158158
"77.197.254.117",23940,"244.3.210.197",80,13,7525,7,616,6,6909,95.059793,0.4240470000000016,11621.353293384887,130344.04205194185
"77.197.254.117",23959,"244.3.210.197",80,8,3040,5,724,3,2316,95.484378,0.3855119999999914,15024.175641744301,48060.760754530114
"77.209.122.142",1100,"244.3.210.197",80,1,64,1,64,0,0,39.587427,0,0,0
"77.209.122.142",1097,"244.3.210.197",80,1,64,1,64,0,0,39.587431,0,0,0
"79.46.215.185",53686,"244.3.210.90",22,31,4539,13,1506,18,3033,151.635886,2.1089020000000005,5712.925493930015,11505.513295544313
"79.108.231.176",56146,"41.177.26.176",80,7,460,4,262,3,198,178.373336,0.6638340000000085,3157.4158599890534,2386.138703350506
"82.242.180.186",4722,"244.3.210.197",25,3,198,3,198,0,0,10.852546,9.010535,175.79422309552095,0
"85.26.113.153",3040,"41.177.98.127",210,14,1162,7,631,7,531,37.574343999999996,2.2627780000000044,2230.886105486261,1877.3383867087234
"85.26.113.153",3072,"41.177.98.127",210,14,1162,7,631,7,531,157.551964,1.6749409999999898,3013.8375023359217,2536.20873809885
"85.141.12.209",20302,"244.3.210.197",80,149,129482,57,11028,92,118454,10.429771,6.178396000000001,14279.434338621219,153378.32019831683
"85.141.12.209",19469,"244.3.210.197",80,92,70211,43,7494,49,62717,11.85258,4.7524049999999995,12615.086466746838,105575.17719975466
"85.141.12.209",41342,"244.3.210.197",80,74,54326,35,7742,39,46584,11.852585,4.7521819999999995,13033.170867614079,78421.23891719636
"85.141.12.209",57940,"244.3.210.197",80,114,95669,47,7738,67,87931,11.853673,4.558575999999999,13579.679268262726,154313.10128426075
"85.141.12.209",3468,"244.3.210.197",80,158,123902,73,9397,85,114505,11.85504,4.803205999999998,15651.212960676688,190714.2854168654
"85.141.12.209",11341,"244.3.210.197",80,199,161749,88,9589,111,152160,11.856018,4.748606999999998,16154.632295323667,256344.65012581594
"90.18.177.176",63084,"41.177.98.127",210,14,1178,7,648,7,530,155.207646,1.5594569999999806,3324.234012223527,2718.89510259023
"90.38.224.197",51286,"41.177.98.176",80,2,140,1,70,1,70,9.387893,0.00017099999999992122,0,0
"90.48.117.203",49370,"41.177.241.46",443,42,3255,21,1722,21,1533,5.144745,193.590235,71.16061406712998,63.350302767079135
"90.55.124.188",16942,"244.3.210.197",80,17,10970,7,872,10,10098,67.448643,131.060686,53.22725077144797,616.3862136354146
"90.55.124.188",16943,"244.3.210.197",80,12,2335,6,1341,6,994,67.453111,136.056165,78.8497897173568,58.44645114023316
"90.55.124.188",16944,"244.3.210.197",80,14,8354,6,798,8,7556,67.456791,131.05253299999998,48.713289654615075,461.25014615322243
"90.55.124.188",16945,"244.3.210.197",80,8,1403,4,756,4,647,67.459669,131.04960499999999,46.15046340658563,39.49649447627103
"90.55.244.16",59162,"41.177.98.176",80,47,36051,19,5947,28,30104,130.312685,20.78224400000002,2289.2619295587115,11588.353981408349
"90.55.244.16",59165,"41.177.98.176",80,31,21957,13,4027,18,17930,132.197341,18.901974999999993,1704.3721621682396,7588.62499818141
"90.55.244.16",59166,"41.177.98.176",80,28,16047,12,3160,16,12887,132.197346,18.902059999999977,1337.4203658225626,5454.220333656762
"90.55.244.16",59170,"41.177.98.176",80,63,64863,17,1962,46,62901,132.19735,18.902027000000004,830.3871325546195,26621.906740478145
"90.55.244.16",59171,"41.177.98.176",80,27,15775,12,3195,15,12580,132.197354,18.901997000000023,1352.238073045931,5324.305151460974
"90.55.244.16",59172,"41.177.98.176",80,38,27147,14,2515,24,24632,132.20096,18.898471,1064.6363930711643,10427.086932059212
"90.55.244.16",59173,"41.177.98.176",80,21,13960,8,1556,13,12404,162.792849,18.292975000000013,680.4798016724995,5424.596053949668
"90.55.244.16",59178,"41.177.98.176",80,38,30666,13,2706,25,27960,186.403172,25.11244499999998,862.04270432449,8907.137477055707
"90.55.244.16",59179,"41.177.98.176",80,22,14097,9,1420,13,12677,187.828086,23.687501999999995,479.57779591955295,4281.413886529699
"90.55.244.16",59180,"41.177.98.176",80,23,14796,9,1425,14,13371,187.82809,23.687555000000003,481.26537331522815,4515.788987086256
"90.82.244.202",36033,"41.177.26.46",80,19,12923,8,926,11,11997,209.051934,0.9772100000000137,7580.765649143886,98214.3039878825
"90.91.84.180",43954,"41.177.26.176",80,24,19256,7,859,17,18397,47.775884,0.7782460000000029,8830.112843496754,189112.44002538972
"90.103.17.55",2159,"244.3.160.239",80,7,510,4,288,3,222,39.817224,0.03404299999999694,67679.11171166487,52169.315277741676
"90.103.17.55",11879,"244.3.160.239",80,13,4395,6,1363,7,3032,71.552686,0.3148650000000117,34630.71475076491,77036.19011322026
"90.103.17.55",10034,"244.3.160.239",80,55,41687,16,2059,39,39628,71.886926,0.18913299999999822,87092.15208345532,1676196.1159607419
"90.103.17.55",12494,"244.3.160.239",80,12,3712,6,1683,6,2029,72.115488,0.31445200000000284,42817.34573162161,51619.96107513978
"90.103.17.55",3649,"244.3.160.239",80,13,2911,7,1291,6,1620,72.115592,0.09654299999999694,106978.23767647916,134240.70103477634
"90.103.17.55",4164,"244.3.160.239",443,24,8927,11,2330,13,6597,72.562163,1.4775510000000054,12615.469787506443,35718.564029261805
"90.103.17.55",12822,"244.3.160.239",80,11,3167,6,1815,5,1352,74.045972,0.04778699999999958,303848.32695084705,226337.7069077384
"90.103.17.55",5874,"244.3.160.239",80,252,233735,43,4358,209,229377,74.098214,1.319724000000008,26417.644901509553,1390454.3677314264
"90.103.17.55",9910,"244.3.160.239",80,11,2513,6,1419,5,1094,75.123941,0.05206599999999639,218030.9607037373,168094.34179696167
"90.103.17.55",3804,"244.3.160.239",80,57,43582,15,2062,42,41520,75.133198,0.23209900000000516,71073.11966014345,1431113.447278931
"90.103.17.55",15327,"244.3.160.239",80,11,2229,6,1432,5,797,75.133203,0.0706260000000043,162206.55282756072,90278.36773992032
"90.103.17.55",6934,"244.3.160.239",80,13,4974,6,1428,7,3546,75.133227,0.08073100000000011,141506.9799705192,351389.18135536485
"90.103.17.55",11714,"244.3.160.239",80,16,8755,7,1479,9,7276,75.133231,0.12362600000000157,95708.02258424481,470839.46742594003
"90.103.17.55",15238,"244.3.160.239",80,11,2620,6,1423,5,1197,75.137458,0.10836900000001037,105048.49172732895,88364.75375798506
"90.103.17.55",7285,"244.3.160.239",80,14,4744,6,1430,8,3314,75.223804,0.06674200000000496,171406.3108687056,397231.12882439885
"90.103.17.55",4182,"244.3.160.239",80,28,18557,10,1698,18,16859,75.223808,0.16009699999999327,84848.56056016397,842439.2711918753
"90.103.17.55",14487,"244.3.160.239",80,12,3525,6,1429,6,2096,75.223837,0.07452599999999165,153396.13020960847,224995.3036524418
"90.103.17.55",9955,"244.3.160.239",80,156,138307,29,3026,127,135281,75.223841,0.24594600000000355,98428.11023557874,4400348.043879488
"90.103.17.55",4118,"244.3.160.239",80,50,38433,14,1962,36,36471,75.223845,0.22348000000000923,70234.4728834766,1305566.49364591
"90.103.17.55",8274,"244.3.160.239",80,14,6057,6,1422,8,4635,75.227687,0.10561599999999771,107710.95288592871,351083.1692167929
"90.103.17.55",5798,"244.3.160.239",80,11,2040,6,1412,5,628,75.290541,0.05639999999999645,200283.687943275,89078.01418440277
"90.103.17.55",5015,"244.3.160.239",80,11,1835,6,1301,5,534,75.541755,0.06993200000000854,148830.29228391478,61087.913973566865
"90.103.17.55",8722,"244.3.160.239",80,83,83842,21,2518,62,81324,75.581668,0.4702830000000091,42833.78306253811,1383405.3112699958
"90.103.17.55",12740,"244.3.160.239",80,12,2320,6,1449,6,871,75.58959,0.0800869999999918,144742.5924307464,87005.3816474673
"90.103.17.55",16273,"244.3.160.239",80,12,3095,6,1453,6,1642,75.594294,0.07542599999999311,154111.3144008838,174157.4523374062
"90.103.17.55",10855,"244.3.160.239",80,11,2450,5,1396,6,1054,75.594299,0.07542499999999563,148067.61683792702,111793.17202519705
"90.103.17.55",6395,"244.3.160.239",80,13,3178,7,1527,6,1651,75.594303,0.1344710000000049,90844.8661793216,98221.92145518007
"90.103.17.55",13461,"244.3.160.239",80,12,2479,6,1453,6,1026,75.594307,0.0710239999999942,163662.98715928345,115566.56904709211
"90.103.17.55",5521,"244.3.160.239",80,13,3372,7,1535,6,1837,75.611636,0.11714699999998857,104825.56104724148,125449.22191777368
"90.103.17.55",15627,"244.3.160.239",80,13,2840,7,1359,6,1481,75.660297,0.09207899999999825,118072.52467989668,128672.11850693672
"90.103.17.55",13901,"244.3.160.239",80,12,2025,6,1296,6,729,75.66032,0.09222200000000669,112424.36728762387,63238.70659928842
"90.103.17.55",6984,"244.3.160.239",80,13,2423,7,1392,6,1031,75.660336,0.10130999999999801,109920.04737933293,81413.48336788236
"90.103.17.55",5634,"244.3.160.239",80,13,2487,7,1387,6,1100,75.66034,0.10579699999999548,104880.10056996394,83178.1619516657
"90.103.17.55",12680,"244.3.160.239",80,12,2256,6,1449,6,807,75.674222,0.0919190000000043,126111.03253951258,70235.75104167471
"90.103.17.55",5561,"244.3.160.239",80,12,2305,6,1456,6,849,75.674226,0.09193100000000243,126703.72344475414,73881.49808007985
"90.103.17.55",4330,"244.3.160.239",80,13,3193,7,1535,6,1658,75.67423,0.1581510000000037,77647.31174636715,83869.21359965912
"90.103.17.55",12065,"244.3.160.239",80,13,3188,7,1539,6,1649,75.674234,0.15816800000000342,77841.28268676176,83404.98710231978
"90.103.17.55",14193,"244.3.160.239",80,17,7190,7,1518,10,5672,75.748826,0.20287900000001002,59858.33920711064,223660.40842077177
"90.103.17.55",15105,"244.3.160.239",80,13,3293,7,1520,6,1773,75.748984,0.20705600000000857,58728.07356463709,68503.20686190893
"90.103.17.55",10803,"244.3.160.239",80,13,3169,7,1522,6,1647,75.756652,0.1993930000000006,61065.333286524416,66080.55448285527
"90.103.17.55",5733,"244.3.160.239",80,13,2657,7,1515,6,1142,75.766055,0.29675400000000707,40841.90946036013,30786.442642726914
"90.103.17.55",14545,"244.3.160.239",80,13,3380,7,1522,6,1858,75.832386,0.2263329999999968,53796.83917060337,65673.14532127534
"90.103.17.55",15014,"244.3.160.239",80,12,2552,6,1457,6,1095,76.327283,0.16501500000001101,70636.00278762066,53086.08308335252
"90.103.17.55",15304,"244.3.160.239",80,11,1835,6,1301,5,534,79.332651,0.04002900000000409,260011.49166851374,106722.62609606943
"90.103.17.55",10222,"244.3.160.239",80,13,3602,7,1637,6,1965,86.419418,0.07216500000001247,181473.01323353063,217834.13011844084
"90.103.17.55",4161,"244.3.160.239",80,11,2177,6,1277,5,900,87.613915,0.041412999999991484,246685.82329225366,173858.45024512787
"90.103.17.55",14289,"244.3.160.239",80,11,2329,6,1311,5,1018,88.011566,0.04228100000000268,248054.6817719386,192616.06868332074
"90.103.17.55",15484,"244.3.160.239",80,11,2234,6,1294,5,940,88.142698,0.13018600000000902,79516.99875562105,57763.50759681901
"90.103.17.55",7346,"244.3.160.239",80,11,2297,6,1315,5,982,88.358005,1.5537009999999896,6770.929541784469,5056.313923978972
"90.103.17.55",2167,"244.3.160.239",80,11,1823,6,1289,5,534,89.617657,0.057492000000010535,179364.0854379411,74305.99039865055
"90.103.17.55",7816,"244.3.160.239",80,90,68664,24,2607,66,66057,89.911638,0.36368800000001045,57345.85688832021,1453047.6672312114
"90.103.17.55",13509,"244.3.160.239",80,165,123120,47,4306,118,118814,90.176728,0.6844279999999969,50331.079383076314,1388768.4314493332
"90.103.17.55",7029,"244.3.160.239",80,16,6847,7,1445,9,5402,90.181306,0.1618079999999935,71442.69751804894,267081.9736972321
"90.103.17.55",5497,"244.3.160.239",80,13,3640,7,1464,6,2176,90.187373,0.12536100000001227,93426.18517719908,138862.96376064562
"90.103.17.55",14044,"244.3.160.239",80,114,93913,27,2863,87,91050,90.187403,0.38686400000000276,59204.268166590424,1882832.2097687942
"90.103.17.55",8997,"244.3.160.239",80,13,3135,7,1311,6,1824,90.187407,0.26608700000001306,39415.679834037306,54839.20672561712
"90.103.17.55",10910,"244.3.160.239",80,160,136151,33,3271,127,132880,90.187419,0.4734989999999897,55265.16423477256,2245073.37924689
"90.103.17.55",2098,"244.3.160.239",80,20,10081,8,1512,12,8569,90.312604,0.171284,70619.55582541277,400224.18906611245
"90.103.17.55",4355,"244.3.160.239",80,13,3413,7,1454,6,1959,90.343139,0.13069800000000953,88999.06655036153,119910.02157644996
"90.103.17.55",2858,"244.3.160.239",80,43,28908,14,1954,29,26954,90.350259,0.2534660000000031,61672.965999383785,850733.4317028611
"90.103.17.55",9138,"244.3.160.239",80,18,8259,8,1515,10,6744,90.473756,0.16162700000000996,74987.47115271121,333805.61416097975
"90.103.17.55",8020,"244.3.160.239",80,13,2660,6,1359,7,1301,91.075712,0.16366800000000126,66427.15741623235,63592.14996211795
"90.103.17.55",11813,"244.3.160.239",80,13,2942,7,1436,6,1506,91.075717,0.16368900000000508,70181.86927649166,73602.99103788054
"90.103.17.55",16074,"244.3.160.239",80,18,8415,10,6973,8,1442,102.110623,0.399052999999995,139790.95508616825,28908.44073343677
"90.103.17.55",12176,"244.3.160.239",80,364,304210,76,6543,288,297667,102.513418,1.8077090000000027,28955.987938324102,1317322.6442972827
"90.103.17.55",10430,"244.3.160.239",80,37,24837,12,1937,25,22900,103.893765,1.0053309999999982,15413.828878250077,182228.53965509898
"90.103.17.55",2664,"244.3.160.239",80,60,45664,18,2344,42,43320,103.926984,0.28437499999999716,65941.09890109955,1218672.5274725396
"90.103.17.55",13392,"244.3.160.239",80,25,13601,10,1778,15,11823,103.935029,0.20812499999999545,68343.54354354503,454457.6576576676
"90.103.17.55",15343,"244.3.160.239",80,13,4585,6,1501,7,3084,103.935115,0.14835600000000682,80940.44056188795,166302.67734367916
"90.103.17.55",8726,"244.3.160.239",80,11,2754,6,1513,5,1241,103.935119,0.14842000000000155,81552.3514351157,66891.2545479039
"90.103.17.55",10097,"244.3.160.239",80,12,4071,5,1432,7,2639,103.935123,0.14844499999999528,77173.36387214366,142221.02462191836
"90.103.17.55",6779,"244.3.160.239",80,14,4251,7,1579,7,2672,103.935128,0.15875399999998763,79569.64863878065,134648.57578392775
"90.103.17.55",14425,"244.3.160.239",80,13,3341,7,1571,6,1770,105.091727,0.3284669999999892,38262.595633657,43109.35345103303
"90.103.17.55",8204,"244.3.160.239",80,14,3842,7,1565,7,2277,105.091732,0.3284670000000034,38116.462232126425,55457.625880224834
"90.103.17.55",16338,"244.3.160.239",80,13,2305,7,1563,6,742,105.095662,0.3245409999999964,38528.25991169109,18290.447123784255
"90.103.17.55",11538,"244.3.160.239",80,14,3921,7,1627,7,2294,105.105989,0.314218000000011,41423.470329515,58405.31096245078
"90.103.17.55",13871,"244.3.160.239",80,13,3881,7,1636,6,2245,105.105993,0.3142179999999968,41652.61060792232,57157.769446690465
"90.103.17.55",12570,"244.3.160.239",80,15,4132,8,1718,7,2414,105.129299,0.3880619999999908,35417.02099149189,49765.24369817312
"90.103.17.55",10570,"244.3.160.239",80,14,4344,7,1636,7,2708,105.317807,0.25208800000000053,51918.37770937122,85938.24378788342
"90.103.17.55",12657,"244.3.160.239",80,14,4245,7,1636,7,2609,105.323708,0.24619100000001026,53161.97586426577,84779.70356348985
"90.103.17.55",15240,"244.3.160.239",80,13,3695,7,1635,6,2060,105.328593,0.24130999999999858,54204.13575898254,68293.8958186569
"90.103.17.55",7720,"244.3.160.239",80,14,4144,7,1635,7,2509,105.328667,0.24124000000000478,54219.86403581388,83203.44884761897
"90.103.17.55",7927,"244.3.160.239",80,13,3688,7,1635,6,2053,105.328672,0.34203600000000733,38241.58860470745,48018.337251048564
"90.103.17.55",7159,"244.3.160.239",80,14,4256,7,1635,7,2621,105.396107,0.2745960000000025,47633.61447362627,76359.45170359295
"90.103.17.55",8066,"244.3.160.239",80,14,4654,7,1635,7,3019,105.528494,0.18610500000001196,70282.90481179528,129776.20160661158
"90.103.17.55",5246,"244.3.160.239",80,13,3922,7,1635,6,2287,105.534686,0.19520400000000393,67006.82363066195,93727.58754943358
"90.103.17.55",12257,"244.3.160.239",80,13,2157,7,1423,6,734,105.53469,0.17967900000000725,63357.43186460043,32680.502451592914
"90.103.17.55",2902,"244.3.160.239",80,13,2260,7,1420,6,840,105.534695,0.17990799999999751,63143.38439647018,37352.42457255982
"90.103.17.55",2279,"244.3.160.239",80,13,2274,7,1423,6,851,105.580323,0.14957099999999457,76111.01082429357,45516.84484291906
"90.103.17.55",14423,"244.3.160.239",80,13,2278,7,1423,6,855,105.580377,0.14952100000000712,76136.46243671095,45746.08249008282
"90.103.17.55",13975,"244.3.160.239",80,14,4499,7,1589,7,2910,105.666767,0.11558899999999994,109975.86275510651,201403.2477138829
"90.103.17.55",10568,"244.3.160.239",80,13,2263,7,1423,6,840,105.68144,0.15640300000001162,72786.32762798127,42965.92776353076
"90.103.17.55",10176,"244.3.160.239",80,13,3348,7,1589,6,1759,105.681445,0.15655499999999734,81198.30091661216,89885.34380888658
"90.103.17.55",4703,"244.3.160.239",80,13,2941,7,1435,6,1506,105.72575,0.12253499999999917,93687.5178520429,98322.92814298022
"90.103.17.55",5826,"244.3.160.239",80,13,2229,7,1434,6,795,105.725756,0.12742599999999982,90028.72255269738,49911.321080470305
"90.103.17.55",7727,"244.3.160.239",80,13,2767,7,1434,6,1333,105.72576,0.16457499999999925,69706.82059851164,64797.20492176848
"90.103.17.55",2188,"244.3.160.239",80,13,2390,7,1427,6,963,105.782289,0.31937499999999375,35744.81409002027,24122.113502935892
"90.103.17.55",9813,"244.3.160.239",80,13,3240,7,1422,6,1818,105.837852,0.25952499999999645,43833.927367306256,56040.843849340905
"90.103.17.55",5494,"244.3.160.239",80,13,3244,7,1423,6,1821,105.837881,0.26395000000000834,43129.380564499486,55192.27126349513
"90.103.17.55",16088,"244.3.160.239",80,13,3357,7,1427,6,1930,105.848236,0.25359899999999413,45015.95037835427,60883.5208340741
"90.103.17.55",5763,"244.3.160.239",80,13,3122,7,1423,6,1699,105.8531,0.24873999999999796,45766.66398649229,54643.402749859735
"90.103.17.55",6971,"244.3.160.239",80,30,23678,20,22346,10,1332,182.393498,0.28859700000001,619438.1784980226,36923.460742833886
"90.103.17.55",9505,"244.3.160.239",80,93,69093,27,3089,66,66004,182.687233,0.3891100000000165,63509.03343527268,1357025.005782369
"90.103.17.55",11787,"244.3.160.239",80,18,8465,10,6967,8,1498,191.223182,0.22398599999999647,248836.98088273767,53503.34395899828
"90.103.17.55",7993,"244.3.160.239",80,352,297796,68,6011,284,291785,191.452905,1.7347330000000056,27720.692463912223,1345613.4171656345
"90.103.17.55",3390,"244.3.160.239",80,13,2254,7,1416,6,838,193.001653,0.24508399999999142,46220.887532439476,27353.886830638618
"90.210.15.13",50466,"244.3.210.197",80,9,630,2,140,7,490,61.37537,9.305730000000004,120.35595273019952,421.2458345556983
"90.210.15.13",50465,"244.3.210.197",80,9,630,2,140,7,490,61.375375,15.438541000000008,72.54571529783802,253.91000354243306
"90.210.15.13",50463,"244.3.210.197",80,2191,153364,1093,76510,1098,76854,61.375406,18.874723000000003,32428.555375355703,32574.35883959727
"90.210.15.13",50462,"244.3.210.197",80,2217,155184,1106,77420,1111,77764,61.375411,18.874758,32814.19555154032,32959.99874541438
"90.210.15.13",50461,"244.3.210.197",80,2,134,1,70,1,64,61.399175,9.200000000220143e-5,0,0
"90.210.15.13",50459,"244.3.210.197",80,2,134,1,70,1,64,61.39921,0.00012800000000368073,0,0
"90.210.201.210",3898,"244.3.160.239",80,10,1590,5,745,5,845,4.352625,0.0318360000000002,187209.44842316757,212338.23344641156
"90.210.201.210",3851,"244.3.160.239",80,10,1724,5,762,5,962,4.432429,0.03837299999999999,158861.69963255417,200557.6837880802
"90.218.72.90",58337,"41.177.98.176",80,113,114439,30,6620,83,107819,146.933402,20.464199000000008,2587.9341771451686,42149.31647214727
"90.218.72.90",58338,"41.177.98.176",80,45,31582,19,5073,26,26509,149.895947,17.501694999999984,2318.861116023336,12117.226360075421
"90.218.72.90",58339,"41.177.98.176",80,46,31108,19,5193,27,25915,149.899686,17.49785,2374.2345488159976,11848.312792714534
"90.218.72.90",58343,"41.177.98.176",80,22,13905,10,1572,12,12333,178.879253,18.110667000000007,694.3973957447286,5447.8391105087385
"90.218.72.90",58345,"41.177.98.176",80,27,22717,9,2190,18,20527,196.989803,8.699439000000012,2013.922966756819,18876.619515350332
"90.218.72.95",10556,"244.3.160.239",80,1,64,0,0,1,64,28.147786,0,0,0
"91.33.123.241",1719,"41.177.98.142",80,18,8986,9,839,9,8147,120.172208,17.828207000000006,376.4820545330216,3655.779854923155
"92.161.55.223",2317,"244.3.61.124",445,2,132,2,132,0,0,128.727928,3.0289669999999944,348.6337091160128,0
"94.145.84.241",2337,"244.3.210.197",80,7,1606,5,1132,2,474,136.239384,60.087473999999986,150.71360796428223,63.10799485430193
"94.145.84.241",2338,"244.3.210.197",80,431,376883,176,52969,255,323914,136.308316,72.14473700000002,5873.637047148704,35918.24030074431
"94.145.84.241",2339,"244.3.210.197",80,494,442670,193,51632,301,391038,136.995353,71.45767800000002,5780.428521620866,43778.416645444304
"94.145.155.55",4147,"244.3.41.84",23,36,8644,18,1289,18,7355,18.487421,183.937063,56.06265443087998,319.89202741592106
"94.145.155.106",1933,"244.3.41.84",23,4,797,2,160,2,637,64.497433,0.19956299999999771,6414.014621949032,25535.795713634583
"94.145.155.251",1113,"244.3.41.84",23,5,320,2,128,3,192,18.488798,0.28425100000000114,3602.4499474056233,5403.674921108435
"100.176.176.193",56722,"41.177.26.176",80,32,13442,16,1706,16,11736,122.492609,2.4040430000000015,5677.103113380248,39054.20992885732
"103.43.113.211",51563,"41.177.26.91",8000,3,210,0,0,3,210,43.653079,120.02157600000001,0,13.997483252511197
"105.144.38.57",51717,"41.177.26.15",80,11,1653,5,637,6,1016,25.194244,0.671130999999999,7593.152454587864,12110.899362419575
"105.144.38.77",51635,"41.177.26.15",80,10,1543,5,614,5,929,23.480535,0.6674110000000013,7359.782802500993,11135.567139288962
"105.144.38.116",41458,"41.177.26.46",80,855,787553,314,20722,541,766831,0.183662,35.655646000000004,4649.361843002367,172052.63929308698
"105.144.38.197",51753,"41.177.26.15",80,11,1625,5,623,6,1002,26.178779,4.026036000000001,1237.9422339989007,1991.0403185664504
"105.144.38.254",51680,"41.177.26.15",80,10,1531,5,608,5,923,24.383138,0.6724689999999995,7233.047173921776,10980.431811726645
"106.37.77.3",57085,"41.177.26.46",80,4,274,3,204,1,70,0.044367,0.16468100000000002,9910.068556785542,3400.513720465627
"106.37.181.3",58841,"244.3.210.197",80,24,12615,13,1278,11,11337,23.188002,1.2863589999999974,7948.014512278471,70505.97850211347
"106.37.181.3",55813,"244.3.210.197",80,29,18754,14,1308,15,17446,78.799898,1.407785000000004,7432.953185323022,99140.13858650262
"106.37.181.3",54286,"244.3.210.197",80,27,16180,13,1225,14,14955,134.529599,1.3141530000000046,7457.274761766678,91039.62780589443
"106.37.181.3",51202,"244.3.210.197",80,10,1278,6,772,4,506,190.163249,0.4972569999999905,12420.13687087385,8140.659658888819
"106.241.40.176",2962,"244.3.61.16",445,2,132,2,132,0,0,209.034555,3.009881999999976,350.84431881383006,0
"111.176.57.33",62961,"41.177.98.251",59188,1,64,1,64,0,0,132.37212,0,0,0
"111.210.145.43",4105,"244.3.31.40",445,2,132,2,132,0,0,50.87456,2.9723929999999967,355.26930658227263,0
"117.3.4.67",49480,"41.177.26.15",80,1056,1262868,183,13354,873,1249514,141.660584,29.68888899999999,3598.3832200659326,336695.3879614695
"117.4.3.176",3045,"41.177.98.127",210,23,4671,10,890,13,3781,80.228824,6.870808999999994,1036.268072653454,4402.392789553606
"117.41.3.90",51440,"244.3.210.197",80,5,350,3,210,2,140,71.319373,0.04424699999999859,37968.6758424312,25312.4505616208
"117.41.3.90",51443,"244.3.210.197",80,5,350,3,210,2,140,71.320977,0.04522300000000712,37149.238219484236,24766.158812989488
"117.75.93.67",61014,"41.177.98.142",80,23,14320,10,1853,13,12467,82.934012,18.998036,780.2911837834185,5249.805822033393
"117.75.93.67",61015,"41.177.98.142",80,11,2146,6,1230,5,916,83.544049,18.392083,535.0128095876905,398.4323037254671
"117.75.93.67",61016,"41.177.98.142",80,31,22396,13,2006,18,20390,101.936053,16.494086999999993,972.9547322019101,9889.604680756205
"117.75.93.67",61017,"41.177.98.142",80,26,18867,11,1903,15,16964,122.002021,26.438126999999994,575.8350430800186,5133.192680404328
"117.75.93.67",61018,"41.177.98.142",80,11,2084,6,1218,5,866,122.542331,25.898178999999985,376.24266941702757,267.50915575956145
"117.75.93.67",61019,"41.177.98.142",80,11,2076,6,1219,5,857,122.545972,25.890231999999997,376.66715385169204,264.81029602206735
"117.75.93.67",61020,"41.177.98.142",80,71,64433,23,2704,48,61729,197.837967,1.0140740000000221,21331.776576462395,486978.26785815356
"117.98.46.22",25602,"244.3.210.197",80,4,256,2,128,2,128,0.164461,0.010986999999999997,93201.05579321018,93201.05579321018
"117.98.46.22",25603,"244.3.210.197",80,4,256,2,128,2,128,0.165539,0.011624999999999996,88086.02150537637,88086.02150537637
"117.98.46.22",25606,"244.3.210.197",80,1307,1260118,489,110765,818,1149353,11.77568,201.251014,4403.058560490035,45688.336258519426
"117.98.46.22",25607,"244.3.210.197",80,274,229440,108,22761,166,206679,12.839544,193.977371,938.7074330438265,8523.839618385176
"117.105.254.41",46177,"41.177.98.176",80,80,58291,35,7640,45,50651,61.147726,22.145068000000002,2759.9824936188948,18297.889173336473
"117.181.203.106",1309,"41.177.26.176",80,3,192,2,128,1,64,11.035424,0.05098199999999942,20085.520379742098,10042.760189871049
"117.181.203.106",1310,"41.177.26.176",80,3,192,2,128,1,64,11.055374,5.015286,204.17579376330684,102.08789688165342
"117.181.203.106",1317,"41.177.26.176",80,231,204197,84,13705,147,190492,54.35758,20.415915,5370.320164440341,74644.51140201162
"117.181.203.106",1318,"41.177.26.176",80,164,143638,60,8824,104,134814,54.828885,19.946338999999995,3539.0955703700824,54070.674322741645
"117.181.203.106",1322,"41.177.26.176",80,347,312250,126,20568,221,291682,80.332065,37.4256,4396.562780556624,62349.19413449617
"117.181.203.106",1323,"41.177.26.176",80,324,288810,117,17904,207,270906,80.659968,37.099430999999996,3860.760020820805,58417.2840817963
"117.181.203.106",1331,"41.177.26.176",80,212,186324,77,12438,135,173886,153.300999,29.049982999999997,3425.268785871579,47886.01769577628
"117.181.203.106",1332,"41.177.26.176",80,162,140890,59,8770,103,132120,153.629914,28.72280599999999,2442.6582834560113,36798.633114048826
"117.181.203.106",1337,"41.177.26.176",80,271,246434,96,15320,175,231114,183.551096,29.508476,4153.382912760388,62656.98031982403
"117.181.203.106",1338,"41.177.26.176",80,151,129445,56,8989,95,120456,183.868942,28.987348999999995,2480.806368322954,33243.74367590497
"117.181.203.106",1341,"41.177.26.176",80,2,132,1,66,1,66,213.03002,0.00027199999999538704,0,0
"117.194.0.71",3215,"244.3.210.197",25,1,64,1,64,0,0,127.773523,0,0,0
"117.194.184.224",54461,"244.3.210.197",80,1,64,0,0,1,64,113.509241,0,0,0
"117.194.184.224",54460,"244.3.210.197",80,1,64,0,0,1,64,113.509266,0,0,0
"117.194.186.57",49608,"244.3.210.197",80,177,152289,73,12997,104,139292,52.020599,148.318806,701.0304546275811,7513.113340462031
"117.194.186.57",49609,"244.3.210.197",80,140,121323,58,9858,82,111465,52.439491,132.89985099999998,593.4092431751485,6709.714068829167
"117.194.186.57",49610,"244.3.210.197",80,153,140431,61,9067,92,131364,52.440935,137.89846500000002,526.0102061324612,7620.911516310206
"117.194.186.57",49611,"244.3.210.197",80,115,96348,50,9204,65,87144,52.442382,132.896956,554.0533223349375,5245.8086398908945
"117.194.186.57",49612,"244.3.210.197",80,118,95898,53,10407,65,85491,52.443871,132.895475,626.4773123388889,5146.3603256619535
"117.194.186.57",49613,"244.3.210.197",80,203,188005,80,10338,123,177667,52.445353,137.894022,599.7649412242106,10307.451906798397
"117.218.124.66",50276,"41.177.26.15",80,30,17068,16,1806,14,15262,117.428487,0.2684769999999901,53814.66568831048,454772.6620902517
"117.218.124.66",50278,"41.177.26.15",80,2169,2106742,734,51862,1435,2054880,117.639105,25.289005000000003,16406.18126335931,650046.9275086148
"117.255.186.30",55791,"244.3.210.197",80,64,59377,22,3256,42,56121,52.681966,0.7703769999999963,33812.01671389479,582789.9846438849
"117.255.186.30",55794,"244.3.210.197",80,20,12431,9,1392,11,11039,53.311228,0.16570099999999854,67205.38801817791,532959.9700665703
"117.255.186.30",55795,"244.3.210.197",80,52,48243,19,4471,33,43772,53.422097,0.5060780000000022,70676.85218484075,691940.7680238984
"117.255.186.30",55796,"244.3.210.197",80,38,36201,13,2462,25,33739,53.423911,0.20882900000000149,94316.40241537268,1292502.4781040854
"117.255.186.30",55803,"244.3.210.197",80,31,28906,11,1518,20,27388,53.800003,0.16662500000000335,72882.22055513732,1314952.7381845196
"117.255.186.30",55804,"244.3.210.197",80,20,12715,9,1388,11,11327,53.902417,0.16963900000000365,65456.64617216419,534169.619014484
"117.255.186.30",55805,"244.3.210.197",80,31,28907,11,1519,20,27388,53.906337,0.1696409999999986,71633.62630496225,1291574.5603951982
"117.255.186.30",55806,"244.3.210.197",80,35,24424,16,4291,19,20133,54.080548,0.4288749999999979,80041.9702710584,375549.9854269911
"117.255.186.30",55808,"244.3.210.197",80,26,16319,12,2389,14,13930,54.220864,0.21098700000000292,90583.78004331895,528184.2009223244
"117.255.186.30",55811,"244.3.210.197",80,19,11174,9,1388,10,9786,54.492227,0.1742449999999991,63726.36230594885,449298.40167580365
"117.255.186.30",55813,"244.3.210.197",80,32,23084,14,3333,18,19751,54.641654,0.33563999999999794,79442.25956381886,470766.29722321825
"117.255.186.30",55818,"244.3.210.197",80,31,28905,11,1517,20,27388,54.962388,0.1744330000000005,69573.9911599294,1256092.5971576443
"117.255.186.30",55819,"244.3.210.197",80,35,25237,15,3404,20,21833,55.126944,0.31772300000000087,85709.87936032307,549736.7203507443
"117.255.186.30",55832,"244.3.210.197",80,37,27719,16,2585,21,25134,56.513605,126.99568599999999,162.84017710648848,1583.297876748349
"118.13.39.186",3735,"244.3.31.168",445,2,132,2,132,0,0,137.102309,2.950554000000011,357.898889496683,0
"118.41.124.164",1884,"41.177.26.91",80,2,128,1,64,1,64,144.371576,0.00013200000000779255,0,0
"118.41.124.164",2091,"41.177.26.91",80,7,452,4,258,3,194,144.403859,1.7006259999999997,1213.670730660357,912.605123054687
"118.41.124.164",2133,"41.177.26.91",80,3,196,2,130,1,66,186.611814,0.48280900000000315,2154.060922642273,1093.600160726077
"118.110.211.80",2139,"41.177.26.15",80,273,247341,95,6706,178,240635,188.671033,16.657127000000003,3220.7234777041676,115570.95050064754
"118.110.211.80",2141,"41.177.26.15",80,267,249275,89,7048,178,242227,205.097216,7.930210999999986,7110.025193528912,244358.69360853115
"118.110.211.80",2143,"41.177.26.15",80,23,5555,10,1529,13,4026,207.080283,3.93041199999999,3112.1419332120986,8194.560773781497
"118.219.168.16",49815,"41.177.26.91",80,7,743,4,521,3,222,13.280912,22.00345,189.42484019551478,80.71461520806965
"118.219.168.16",49815,"41.177.26.91",8000,9,13590,0,0,9,13590,17.463712,164.681334,0,660.1841104833411
"122.39.210.202",41218,"41.177.26.176",80,5,7190,0,0,5,7190,0.315528,170.579924,0,337.20263587407857
"122.39.210.202",15152,"41.177.26.176",80,4,5752,0,0,4,5752,0.495507,179.999932,0,255.64454102127104
"122.39.210.202",30403,"41.177.26.176",80,27,21159,8,1034,19,20125,0.727091,188.21829,43.948970102746124,855.3897711003538
"122.39.210.202",62394,"41.177.26.176",80,1,1438,0,0,1,1438,1.175553,0,0,0
"122.39.210.202",15424,"41.177.26.176",80,4,5752,0,0,4,5752,1.645505,180.00007699999998,0,255.6443350854789
"122.39.210.202",30268,"41.177.26.176",80,4,5752,0,0,4,5752,2.085456,179.999973,0,255.64448279111684
"122.39.210.202",13447,"41.177.26.176",80,13,4352,7,581,6,3771,2.225838,1.4381080000000002,3232.024298592317,20977.56218587199
"122.39.210.202",57857,"41.177.26.176",80,3,4314,0,0,3,4314,2.615489,119.999973,0,287.6000647100146
"122.39.210.202",29978,"41.177.26.176",80,4,5752,0,0,4,5752,2.695604,179.999896,0,255.64459215020878
"122.39.210.202",48416,"41.177.26.176",80,4,5752,0,0,4,5752,2.87552,154.109944,0,298.59202336742135
"122.39.210.202",35080,"41.177.26.176",80,43,13030,22,2250,21,10780,3.309112,1.511081,11912.00207004125,57071.72547335319
"122.39.210.202",33624,"41.177.26.176",80,6,8628,0,0,6,8628,4.105472,185.59986800000001,0,371.8968162197184
"122.39.210.202",13651,"41.177.26.176",80,1,1438,0,0,1,1438,4.325557,0,0,0
"122.39.210.202",46157,"41.177.26.176",80,4,5752,0,0,4,5752,4.345551,179.999847,0,255.64466174240695
"122.39.210.202",17742,"41.177.26.176",80,32,23242,11,1226,21,22016,4.837698,186.33768600000002,52.63562197504159,945.2086895615951
"122.39.210.202",52912,"41.177.26.15",80,4,5752,0,0,4,5752,5.525427,179.99997299999998,0,255.6444827911169
"122.39.210.202",49556,"41.177.26.176",80,4,5752,0,0,4,5752,6.225426,179.99999,0,255.6444586469144
"122.39.210.202",64774,"41.177.26.176",80,2,2876,0,0,2,2876,6.375547,60.00004200000001,0,383.46639824018786
"122.39.210.202",12823,"41.177.26.176",80,4,5752,0,0,4,5752,7.685465,179.999923,0,255.64455380350358
"122.39.210.202",3847,"41.177.26.176",80,19,5979,10,820,9,5159,7.954246,27.329620000000002,240.03260930814258,1510.1563797813508
"122.39.210.202",15126,"41.177.26.176",80,4,5752,0,0,4,5752,8.305544,179.999803,0,255.64472423339262
"122.39.210.202",58209,"41.177.26.176",80,4,5752,0,0,4,5752,8.655677,179.999862,0,255.64464043866877
"122.39.210.202",55480,"41.177.26.176",80,16,6474,9,1465,7,5009,8.74203,0.7872509999999995,14887.246888222444,50901.173831471824
"122.39.210.202",37850,"41.177.26.176",80,3,4314,0,0,3,4314,9.185442,120.00007099999999,0,287.59982983676736
"122.39.210.202",6793,"41.177.26.176",80,1,1438,0,0,1,1438,9.455461,0,0,0
"122.39.210.202",34156,"41.177.26.176",80,33,10313,17,1169,16,9144,9.654022,33.542022,278.81443760307593,2180.9060884880464
"122.39.210.202",32184,"41.177.26.176",80,21,10278,9,1145,12,9133,9.891551,0.2265290000000011,40436.3238260883,322537.0703088772
"122.39.210.202",18040,"41.177.26.176",80,4,5752,0,0,4,5752,9.985453,180.000025,0,255.64440893827654
"122.39.210.202",4153,"41.177.26.15",80,4,5752,0,0,4,5752,10.415474,179.999882,0,255.6446120336901
"122.39.210.202",37988,"41.177.26.176",80,4,5752,0,0,4,5752,10.94557,179.999901,0,255.64458504896623
"122.39.210.202",15794,"41.177.26.176",80,4,5752,0,0,4,5752,11.09546,156.27993,0,294.4459982801374
"122.39.210.202",2410,"41.177.26.176",80,4,5752,0,0,4,5752,11.235413,179.999974,0,255.64448137086953
"122.39.210.202",5245,"41.177.26.15",80,1,1438,0,0,1,1438,11.715467,0,0,0
"122.39.210.202",13659,"41.177.26.176",80,4,5752,0,0,4,5752,13.665479,180.00002,0,255.6444160395093
"122.39.210.202",27061,"41.177.26.176",80,4,5752,0,0,4,5752,13.875425,179.999938,0,255.64453249978342
"122.39.210.202",36227,"41.177.26.176",80,4,5752,0,0,4,5752,14.045474,180.000016,0,255.64442172049587
"122.39.210.202",47526,"41.177.26.176",80,4,5752,0,0,4,5752,15.035504,179.999891,0,255.64459925145178
"122.39.210.202",13763,"41.177.26.15",80,4,5752,0,0,4,5752,15.415466,151.739958,0,303.25565267389885
"122.39.210.202",58240,"41.177.26.176",80,4,256,0,0,4,256,16.635345,179.999968,0,11.377779800494187
"122.39.210.202",64573,"41.177.26.176",80,4,5752,0,0,4,5752,18.17546,179.999891,0,255.64459925145178
"122.39.210.202",54878,"41.177.26.176",80,4,5752,0,0,4,5752,19.215486,179.999905,0,255.64457936797243
"122.39.210.202",47896,"41.177.26.176",80,3,4314,0,0,3,4314,21.015891,119.999524,0,287.6011408178586
"122.39.210.202",29916,"41.177.26.15",80,1,1438,0,0,1,1438,21.155549,0,0,0
"122.39.210.202",18122,"41.177.26.15",80,1,1438,0,0,1,1438,21.395548,0,0,0
"122.39.210.202",55537,"41.177.26.176",80,3,4314,0,0,3,4314,23.015484,120.00021199999999,0,287.5994919075643
"122.39.210.202",56288,"41.177.26.176",80,4,5752,0,0,4,5752,23.525564,179.999827,0,255.64469014739663
"122.39.210.202",1571,"41.177.26.176",80,4,5752,0,0,4,5752,23.5955,179.999893,0,255.64459641095456
"122.39.210.202",21088,"41.177.26.176",80,4,5752,0,0,4,5752,25.175639,179.99979100000002,0,255.644741276394
"122.39.210.202",18622,"41.177.26.176",80,3,4314,0,0,3,4314,26.325638,119.999774,0,287.6005416476868
"122.39.210.202",26687,"41.177.26.15",80,3,4314,0,0,3,4314,27.835499,120.000009,0,287.5999784300016
"122.39.210.202",14298,"41.177.26.176",80,4,5752,0,0,4,5752,29.215481,180.000056,0,255.64436491064203
"122.39.210.202",53705,"41.177.26.176",80,4,5752,0,0,4,5752,30.465529,179.999881,0,255.64461345393892
"122.39.210.202",17230,"41.177.26.176",80,3,4314,0,0,3,4314,32.125515,119.99993999999998,0,287.6001438000719
"122.39.210.202",56872,"41.177.26.176",80,3,4314,0,0,3,4314,33.155558,119.99987600000001,0,287.6002971869737
"122.39.210.202",38327,"41.177.26.176",80,3,4314,0,0,3,4314,33.165439,120.00019600000002,0,287.59953025410056
"122.39.210.202",45197,"41.177.26.176",80,3,4314,0,0,3,4314,35.515438,120.000017,0,287.59995925667243
"122.39.210.202",7193,"41.177.26.15",80,3,4314,0,0,3,4314,36.195425,120.000012,0,287.5999712400029
"122.39.210.202",19772,"41.177.26.15",80,1,1438,0,0,1,1438,38.695446,0,0,0
"122.39.210.202",14565,"41.177.26.176",80,3,4314,0,0,3,4314,39.175587,119.99979199999999,0,287.6004985075308
"122.39.210.202",46148,"41.177.26.176",80,3,4314,0,0,3,4314,39.735463,119.99994999999998,0,287.6001198333833
"122.39.210.202",45776,"41.177.26.176",80,3,4314,0,0,3,4314,41.075568,119.999934,0,287.600158180087
"122.39.210.202",15667,"41.177.26.176",80,3,4314,0,0,3,4314,41.355438,120.000088,0,287.59978909348797
"122.39.210.202",9224,"41.177.26.176",80,3,4314,0,0,3,4314,41.585449,119.999958,0,287.6001006600352
"122.39.210.202",5100,"41.177.26.176",80,1,1438,0,0,1,1438,43.335533,0,0,0
"122.39.210.202",10210,"41.177.26.176",80,3,4314,0,0,3,4314,44.655451,119.99995100000001,0,287.6001174367146
"122.39.210.202",15632,"41.177.26.176",80,3,4314,0,0,3,4314,46.965552,119.99990600000001,0,287.6002252868431
"122.39.210.202",12873,"41.177.26.176",80,3,4314,0,0,3,4314,47.025554,119.999854,0,287.6003499137591
"122.39.210.202",52566,"41.177.26.176",80,3,4314,0,0,3,4314,47.135484,120.00002,0,287.59995206667463
"122.39.210.202",6950,"41.177.26.15",80,3,4314,0,0,3,4314,47.555569,119.99988000000002,0,287.6002876002876
"122.39.210.202",47637,"41.177.26.15",80,3,4314,0,0,3,4314,48.965485,119.99993699999999,0,287.60015099007927
"122.39.210.202",23496,"41.177.26.15",80,3,4314,0,0,3,4314,49.945481,119.999967,0,287.6000790900218
"122.39.210.202",13152,"41.177.26.15",80,3,4314,0,0,3,4314,49.985476,119.99991399999999,0,287.6002061134811
"122.39.210.202",27083,"41.177.26.176",80,3,4314,0,0,3,4314,50.215424,120.000003,0,287.5999928100002
"122.39.210.202",50007,"41.177.26.176",80,2,2876,0,0,2,2876,50.385597,59.99989800000001,0,383.4673185611082
"122.39.210.202",58216,"41.177.26.176",80,3,4314,0,0,3,4314,50.735557,119.99989400000001,0,287.60025404689105
"122.39.210.202",26166,"41.177.26.176",80,3,4314,0,0,3,4314,50.825446,119.99995100000001,0,287.6001174367146
"122.39.210.202",18103,"41.177.26.176",80,3,4314,0,0,3,4314,52.645658,119.999795,0,287.600491317506
"122.39.210.202",9908,"41.177.26.176",80,3,4314,0,0,3,4314,54.915447,120.00000399999999,0,287.59999041333367
"122.39.210.202",28914,"41.177.26.176",80,3,4314,0,0,3,4314,55.845482,119.999944,0,287.60013421339596
"122.39.210.202",15827,"41.177.26.176",80,1,1438,0,0,1,1438,57.545499,0,0,0
"122.39.210.202",25259,"41.177.26.176",80,3,4314,0,0,3,4314,58.035715,119.99974799999998,0,287.60060396126835
"122.39.210.202",34055,"41.177.26.176",80,1,1438,0,0,1,1438,59.625557,0,0,0
"122.77.141.37",13386,"244.3.210.197",80,132,104236,58,8945,74,95291,71.875372,133.464057,536.1743199519253,5711.8599354431435
"122.77.141.37",13395,"244.3.210.197",80,113,91257,48,7019,65,84238,72.302971,133.036496,422.07966752221137,5065.557349014965
"122.77.141.37",13393,"244.3.210.197",80,109,86942,47,7353,62,79589,72.303151,133.03623499999998,442.16524918944083,4786.004354377588
"122.77.141.37",13396,"244.3.210.197",80,119,95800,51,7198,68,88602,72.303177,133.036257,432.84440872385636,5327.991150562812
"122.77.141.37",13394,"244.3.210.197",80,132,108383,56,7571,76,100812,72.303341,133.03613,455.2748189533174,6062.232868619975
"122.77.141.37",13397,"244.3.210.197",80,189,158612,79,8577,110,150035,72.303382,133.036105,515.769760396999,9022.212428723768
"122.155.95.176",53533,"41.177.26.176",80,34,22226,17,2360,17,19866,11.854147,0.18050700000000042,104594.28166220676,880453.3896192372
"122.155.95.176",53539,"41.177.26.176",80,97,68574,46,5260,51,63314,12.058649,11.435104,3679.8965711199476,44294.481274503494
"122.155.95.176",53822,"41.177.26.176",80,45,29788,19,3936,26,25852,23.575159,15.275700999999998,2061.3129309090305,13538.887675269372
"122.155.95.176",53823,"41.177.26.176",80,53,31711,25,4356,28,27355,23.579703,15.772780999999998,2209.375759417442,13874.53487118093
"122.155.95.176",53825,"41.177.26.176",80,48,31575,21,4076,27,27499,23.590025,15.267548999999999,2135.7717600906344,14409.123560042284
"122.155.95.176",53826,"41.177.26.176",80,49,31874,21,4076,28,27798,23.59152,15.779066000000004,2066.5354970946946,14093.609849911265
"122.155.95.176",54355,"41.177.26.176",80,36,23360,18,2433,18,20927,49.304492,0.17177499999999668,113311.01731916971,974623.7811090277
"122.155.95.176",54357,"41.177.26.176",80,51,32501,25,2594,26,29907,49.496156,15.112983999999997,1373.1239310516046,15831.155515019405
"122.155.95.176",54845,"41.177.26.176",80,50,33911,25,2957,25,30954,75.167467,0.22525999999999158,105016.4254639123,1099316.3455562873
"122.155.95.176",54851,"41.177.26.176",80,44,28190,19,3936,25,24254,75.363269,15.255583000000001,2064.0312467901094,12718.753521251858
"122.155.95.176",54853,"41.177.26.176",80,57,38334,24,5152,33,33182,75.365694,15.291877,2695.2871776303195,17359.28166306857
"122.155.95.176",54854,"41.177.26.176",80,46,28655,20,4006,26,24649,75.367587,15.223445999999996,2105.1738220111274,12953.177618260679
"122.155.95.176",54855,"41.177.26.176",80,31,17337,14,2720,17,14617,75.401692,15.196049000000002,1431.951160462828,7695.1581295901315
"122.155.95.176",55258,"41.177.26.176",80,36,22931,18,2411,18,20520,91.030635,0.17149999999999466,112466.4723032105,957201.1661807878
"122.155.95.176",55265,"41.177.26.176",80,104,74915,49,5451,55,69464,91.233904,13.312984999999998,3275.598973483408,41742.10366796028
"122.155.95.176",55496,"41.177.26.176",80,51,28931,26,4426,25,24505,104.63824,0.3783159999999981,93593.71530678104,518191.1417968074
"122.155.95.176",55497,"41.177.26.176",80,52,30238,27,4496,25,25742,104.638245,15.447068999999999,2328.467620621103,13331.7200823017
"122.155.95.176",55498,"41.177.26.176",80,55,31969,26,4426,29,27543,104.641474,16.054813999999993,2205.4444230870577,13724.481641456581
"122.155.95.176",55499,"41.177.26.176",80,54,31889,27,4496,27,27393,104.641479,15.326343999999992,2346.8088671375262,14298.517637343917
"122.155.95.176",56223,"41.177.26.176",80,36,22639,18,2433,18,20206,132.988823,0.1657289999999989,117444.74413047885,975375.4623511942
"122.155.95.176",56226,"41.177.26.176",80,84,56329,42,4873,42,51456,133.209554,9.611153999999999,4056.120628178469,42830.2366188285
"122.155.95.176",56420,"41.177.26.176",80,111,109323,32,3038,79,106285,142.907885,15.252627000000018,1593.430430049851,55746.46256018711
"122.155.95.176",56421,"41.177.26.176",80,10,1943,5,1138,5,805,142.910015,15.083082000000019,603.5901681102038,426.9684405348981
"122.155.95.176",56422,"41.177.26.176",80,10,1950,5,1139,5,811,142.911696,15.081558999999999,604.181570353569,430.1942524642181
"122.155.95.176",56821,"41.177.26.176",80,49,33821,24,2887,25,30934,166.060825,0.2115220000000022,109189.58784428929,1169958.680420937
"122.155.95.176",56826,"41.177.26.176",80,67,50377,26,6158,41,44219,166.253021,15.435322000000014,3191.640576076091,22918.342746591206
"122.155.95.176",56827,"41.177.26.176",80,60,38328,27,5362,33,32966,166.25647,15.34134899999998,2796.1035238817694,17190.665566633048
"122.155.95.176",56829,"41.177.26.176",80,38,19778,19,3070,19,16708,166.272021,15.325934000000018,1602.5124472022371,8721.426048161231
"122.155.95.176",56830,"41.177.26.176",80,22,10139,11,1644,11,8495,166.285156,15.314137999999986,858.8142538613673,4437.729371382187
"122.155.95.176",57379,"41.177.26.176",80,53,35952,26,3111,27,32841,191.21995,0.26771599999997875,92964.18592837923,981368.3156778858
"122.155.95.176",57382,"41.177.26.176",80,49,27446,24,4286,25,23160,191.445255,16.298779999999994,2103.7157382331693,11367.722001278627
"122.155.95.176",57383,"41.177.26.176",80,56,31670,28,4566,28,27104,191.462246,16.284854999999993,2243.0657196517877,13314.948152746836
"122.155.95.176",57384,"41.177.26.176",80,56,30478,29,4636,27,25842,191.464612,16.288119000000023,2276.9971167327517,12692.441650260518
"122.155.95.176",57386,"41.177.26.176",80,49,30271,23,4216,26,26055,191.498938,16.27385799999999,2072.526379423983,12808.27201515462
"122.155.95.176",57694,"41.177.26.176",80,47,33744,22,2747,25,30997,208.09723,0.27397700000000214,80211.11261164196,905097.8731791284
"122.155.95.176",57727,"41.177.26.176",80,25,12198,13,1784,12,10414,208.418275,0.2281200000000183,62563.56303699305,365211.29230226774
"122.155.95.176",57728,"41.177.26.176",80,62,42990,28,5468,34,37522,208.418496,0.5999909999999886,72907.76028307229,500300.8378459105
"122.155.95.176",57729,"41.177.26.176",80,23,10421,12,1714,11,8707,208.418608,0.22973400000000765,59686.419946544884,303202.8345825941
"122.155.95.176",57731,"41.177.26.176",80,21,9483,11,1644,10,7839,208.425784,0.22262900000001196,59075.86163527345,281688.3694397254
"122.155.95.176",57751,"41.177.26.176",80,31,20830,14,2756,17,18074,208.656652,0.35925899999998023,61370.765937669516,402472.86776394735
"122.155.95.176",57754,"41.177.26.176",80,21,12312,10,1598,11,10714,208.661331,0.7915570000000116,16150.447788346022,108282.78948957402
"122.155.95.176",57755,"41.177.26.176",80,37,20762,19,3070,18,17692,208.683581,0.2756899999999973,89085.56712249352,513388.2259059138
"122.155.141.12",6108,"244.3.160.239",80,11,2569,6,1534,5,1035,32.469816,0.5142159999999976,23865.457317547603,16102.182740327098
"122.155.141.12",6575,"244.3.160.239",80,15,6062,7,1588,8,4474,33.037575,1.1284750000000017,11257.670750348905,31717.14038857746
"122.155.141.12",7701,"244.3.160.239",80,14,4596,7,1577,7,3019,34.233056,0.5950630000000032,21201.116520435535,40587.299159920665
"122.155.141.12",9061,"244.3.160.239",80,28,13592,12,1961,16,11631,34.233508,0.8236920000000012,19045.954070210682,112964.55471219808
"122.155.141.12",2610,"244.3.160.239",80,26,12833,11,1889,15,10944,34.234011,0.6716419999999985,22500.08188886346,130355.1594450618
"122.155.141.12",2376,"244.3.160.239",80,30,15906,13,2027,17,13879,34.234338,0.8735700000000008,18562.908524789065,127101.43434412799
"122.155.141.12",15977,"244.3.160.239",80,34,18859,14,2099,20,16760,34.234617,0.9274899999999988,18104.777409999053,144562.2055224317
"122.155.141.12",13280,"244.3.160.239",80,14,3103,8,1535,6,1568,35.220772,0.4040870000000041,30389.495331450595,31042.81998678471
"122.155.141.12",15483,"244.3.160.239",80,27,16280,11,1963,16,14317,55.561207,0.8598909999999975,18262.77981744203,133198.27745609658
"122.155.141.12",6700,"244.3.160.239",80,11,2526,6,1591,5,935,60.313011,1.138500999999998,11179.612490458965,6570.042538390404
"122.155.141.12",5121,"244.3.160.239",80,15,5862,7,1593,8,4269,61.505417,0.7680760000000006,16592.10807263863,44464.34988204289
"122.155.141.12",11706,"244.3.160.239",80,14,4531,7,1518,7,3013,62.346676,0.7481689999999972,16231.626811589422,32217.319883609307
"122.155.141.12",6405,"244.3.160.239",80,12,2346,6,1378,6,968,62.346828,4.124258999999995,2672.965010199411,1877.6706312576416
"122.155.141.12",3521,"244.3.160.239",80,14,4501,7,1544,7,2957,62.346981,0.7440849999999983,16600.254003238915,31792.06676656572
"122.155.141.12",4621,"244.3.160.239",80,22,10822,10,1752,12,9070,62.347198,0.7895370000000028,17752.176275462643,91901.96279591677
"122.155.141.12",11668,"244.3.160.239",80,21,10709,9,1684,12,9025,62.347318,0.7952489999999983,16940.606024025215,90789.1742083299
"122.186.121.241",3576,"41.177.26.91",80,11,5253,6,569,5,4684,50.440863,0.15676799999999957,29036.538068993752,239028.37313737563
"122.186.121.241",3578,"41.177.26.91",80,1768,1787817,614,39717,1154,1748100,50.637823,20.471623000000008,15520.80164821323,683130.9857552572
"122.244.155.71",52380,"41.177.98.127",210,100,20446,58,6832,42,13614,12.305565,195.960965,278.91269059631344,555.7841583399021
"122.244.155.71",46199,"41.177.98.127",210,4,280,2,140,2,140,65.068642,0.07817000000000007,14327.747217602648,14327.747217602648
"122.255.92.224",36487,"244.3.210.197",80,30,19354,16,2683,14,16671,155.932047,0.8149879999999996,26336.58409694377,163644.1272754937
"122.255.92.224",36505,"244.3.210.197",80,6,1522,4,1134,2,388,156.69040999999999,0.1256400000000042,72206.30372492595,24705.50780006285
"122.255.92.224",36506,"244.3.210.197",80,6,1521,4,1133,2,388,156.690901,0.12547200000000203,72239.22468757853,24738.587095128394
"122.255.92.224",36508,"244.3.210.197",80,35,23871,18,2979,17,20892,156.698838,2.189130000000006,10886.516561373668,76348.13830151684
"124.0.218.188",49339,"41.177.26.176",80,10,1029,6,606,4,423,141.139343,25.661632999999995,188.92016731748916,131.87001778101964
"124.152.41.43",18522,"41.177.26.91",80,1610,1639840,539,35264,1071,1604576,142.392057,12.52256300000002,22528.295525444715,1025078.3326065104
"124.152.41.43",18522,"41.177.26.91",8000,6,384,0,0,6,384,184.444919,18.96037100000001,0,162.0221460856435
"124.219.213.92",4552,"244.3.210.197",80,97,76199,43,2752,54,73447,82.214058,130.425783,168.80098009455693,4505.0601689698115
"128.71.90.75",2381,"41.177.98.127",210,20,5011,9,832,11,4179,111.430814,2.3369009999999975,2848.2165055344694,14306.125933447775
"128.71.90.75",2421,"41.177.98.127",210,193,119857,89,7215,104,112642,130.805913,13.500759999999985,4275.314871162813,66747.05720270569
"128.71.90.116",3925,"41.177.98.127",210,146,67764,61,5466,85,62298,37.85208,9.755462999999999,4482.411547253063,51087.68287061312
"128.71.90.255",3438,"41.177.98.127",210,13,1048,6,523,7,525,86.387143,1.6867620000000016,2480.4922093336204,2489.9778391972286
"128.71.90.255",3465,"41.177.98.127",210,13,1049,6,524,7,525,97.478878,1.6850380000000058,2487.7777237071127,2492.5253911187674
"128.71.90.255",3687,"41.177.98.127",210,231,114683,99,7891,132,106792,200.588112,12.388494000000009,5095.696054742405,68962.05462907755
"128.106.80.197",2072,"244.3.210.197",80,4,256,2,128,2,128,3.222375,0.20955199999999996,4886.615255402002,4886.615255402002
"142.38.67.210",1525,"244.3.31.180",445,2,140,2,140,0,0,12.851584,2.8738729999999997,389.7179868421465,0
"142.127.51.151",2199,"244.3.41.120",445,2,132,2,132,0,0,13.58231,2.8993900000000004,364.21454167945666,0
"142.197.48.208",2667,"41.177.98.127",210,15,1249,7,637,8,612,16.104032,1.5395900000000005,3309.9721354386547,3180.0674205470277
"142.197.48.208",2668,"41.177.98.127",210,14,1185,7,637,7,548,17.644571,1.5513949999999994,3284.785628418296,2825.843837320606
"142.205.81.17",54974,"41.177.26.176",80,116,98920,43,4567,73,94353,162.401356,4.399489000000017,8304.600829778154,171570.834703757
"142.205.81.17",54975,"41.177.26.176",80,98,73302,42,4478,56,68824,163.005497,1.9413650000000189,18452.995701477903,283610.7584096729
"142.205.81.17",54976,"41.177.26.176",80,55,43390,21,1908,34,41482,163.006348,4.686566999999997,3256.9682669638587,70810.04069716709
"142.205.81.17",54977,"41.177.26.176",80,88,70474,34,3787,54,66687,163.173525,27.17191699999998,1114.9746997975897,19634.095010668567
"142.205.81.17",54978,"41.177.26.176",80,93,41430,43,4371,50,37059,164.759156,20.18989400000001,1731.955601153725,14684.178133872316
"142.205.81.17",54980,"41.177.26.176",80,58,48078,21,1955,37,46123,184.950697,1.6824340000000007,9296.055595642976,219315.58682242504
"142.205.81.17",54981,"41.177.26.176",80,62,56014,19,2222,43,53792,184.95343,1.5500389999999982,11468.098544617278,277629.14352477615
"142.205.81.17",54982,"41.177.26.176",80,76,70326,22,2415,54,67911,184.954121,22.181421,870.9992024406371,24492.930367265468
"142.205.81.17",54983,"41.177.26.176",80,87,76191,32,2863,55,73328,184.955,2.35754399999999,9715.195135276414,248828.4418021477
"145.41.176.124",51438,"41.177.26.176",80,23,12259,7,2843,16,9416,46.270097,0.30980900000000133,73412.97379998612,243143.35606776975
"145.41.176.124",51439,"41.177.26.176",80,195,135719,84,32105,111,103614,54.073771,33.248512999999996,7724.85674772884,24930.7991608527
"145.41.176.124",51440,"41.177.26.176",80,69,39668,32,14088,37,25580,54.681585,34.112774,3303.8649979037177,5998.925798294797
"145.41.176.124",51442,"41.177.26.176",80,22,12084,6,2663,16,9421,88.802008,0.2623909999999938,81191.80917028595,287235.46158214944
"145.41.176.124",51443,"41.177.26.176",80,29,24778,11,1876,18,22902,91.296076,0.9955989999999986,15074.34217993391,184025.89797699702
"145.41.176.124",51444,"41.177.26.176",80,7,1834,4,1461,3,373,91.946069,0.3452490000000097,33853.82723773181,8643.03734406158
"145.41.176.124",51445,"41.177.26.176",80,600,515328,245,99580,355,415748,92.400379,116.49116500000001,6838.630208565602,28551.384132865354
"145.41.176.124",51446,"41.177.26.176",80,411,324517,184,101122,227,223395,92.612026,107.33542999999999,7536.896251312359,16650.2337578561
"145.67.150.3",16062,"244.3.160.239",80,28,15738,10,1181,18,14557,104.836399,0.44019600000000025,21463.166407691107,264554.8800988649
"145.67.150.3",2727,"244.3.160.239",80,66,64962,19,1784,47,63178,105.280365,0.7081620000000015,20153.580677867452,713712.3991403081
"145.67.150.3",5612,"244.3.160.239",80,10,1407,5,963,5,444,105.898461,0.16998000000000957,45322.97917401792,20896.576067771504
"145.67.150.3",5778,"244.3.160.239",80,26,15610,8,1053,18,14557,202.554431,0.5039979999999957,16714.35204107967,231064.4089857519
"145.67.150.3",11332,"244.3.160.239",80,63,62391,18,1720,45,60671,203.050268,0.735982000000007,18696.109415719227,659483.5199773845
"145.67.150.3",13958,"244.3.160.239",80,10,1407,5,963,5,444,203.692535,0.19795700000000238,38917.54269866642,17943.290714649935
"145.67.150.150",3181,"244.3.160.239",80,14,3459,7,2063,7,1396,7.361089,0.10685900000000004,154446.51363011065,104511.552606706
"145.67.150.150",6468,"244.3.160.239",80,109,86124,30,3193,79,82931,12.451948,0.933936000000001,27350.91055489881,710378.4413492994
"145.67.150.150",6311,"244.3.160.239",80,10,2145,5,1724,5,421,13.337287,0.27693999999999974,49801.40102549293,12161.479020726523
"145.67.150.150",10794,"244.3.160.239",80,15,4720,7,2695,8,2025,13.797987,0.1739050000000013,123975.73387769092,93154.30838676219
"145.67.150.150",11139,"244.3.160.239",80,12,2730,6,1732,6,998,14.093806,0.14221599999999945,97429.26253023607,56139.9561230806
"145.67.150.150",15124,"244.3.160.239",80,4,274,0,0,4,274,17.977858,173.997915,0,12.597852106446217
"145.67.150.150",8278,"244.3.160.239",80,12,2754,6,1744,6,1010,36.837852,0.2165250000000043,64435.97736981745,37316.70707770391
"145.67.150.150",5497,"244.3.160.239",80,14,3447,7,2057,7,1390,39.605718,0.3618199999999945,45481.178486540965,30733.51390194066
"145.67.150.150",12452,"244.3.160.239",80,129,95548,44,4279,85,91269,40.333446,3.9201679999999968,8732.27882070361,186255.28293685388
"145.67.150.150",9353,"244.3.160.239",80,116,80279,45,4473,71,75806,41.224041,9.906709999999997,3612.097255294645,61215.882972248124
"145.67.150.150",11684,"244.3.160.239",80,170,116329,71,6725,99,109604,41.224045,9.467629000000002,5682.520935283796,92613.68395402902
"145.67.150.150",15891,"244.3.160.239",80,15,4720,7,2695,8,2025,51.471445,0.31657999999999475,68102.84920083504,51171.89967780741
"145.67.150.150",4008,"244.3.160.239",80,12,2734,6,1734,6,1000,51.760027,0.2659749999999974,52155.277751668895,30078.014851020125
"145.67.150.150",6505,"244.3.160.239",80,16,3488,5,1331,11,2157,79.923838,93.172164,114.28305990617541,185.20552984043604
"145.67.150.150",10490,"244.3.160.239",80,10,1807,5,1381,5,426,80.109727,0.13365199999999788,82662.43677610642,25499.057253165338
"145.67.194.47",49291,"41.177.98.176",80,25,14943,10,2518,15,12425,74.143885,4.755758999999998,4235.706645353562,20900.975007354253
"145.67.194.47",49293,"41.177.98.176",80,49,38295,18,3739,31,34556,78.777844,25.299781999999993,1182.3026775487633,10926.892571643506
"145.67.194.47",49294,"41.177.98.176",80,42,32624,17,1949,25,30675,80.901888,23.142314,673.7442072560247,10603.952569306597
"145.67.194.47",49295,"41.177.98.176",80,48,35317,20,3410,28,31907,111.383798,22.296672000000015,1223.5009780831858,11448.165896686278
"145.67.223.161",10535,"244.3.160.239",80,2,2492,0,0,2,2492,26.897946,59.999363,0,332.2701942685625
"145.95.31.210",2306,"244.3.160.239",80,29,23998,19,22622,10,1376,15.600184,0.612661000000001,295393.37414981483,17967.522006460313
"145.95.31.210",5229,"244.3.160.239",80,296,209565,99,8083,197,201482,16.213034,1.394718000000001,46363.494269092356,1155685.9522856942
"145.95.31.210",12544,"244.3.160.239",80,50,29494,18,2012,32,27482,17.333178,0.3463850000000015,46468.52490725618,634715.7065115379
"145.95.31.210",12578,"244.3.160.239",80,12,3431,6,1248,6,2183,17.337156,0.13670300000000069,73034.24211611999,127751.40267587334
"145.95.31.210",13777,"244.3.160.239",80,10,1626,5,1221,5,405,17.3393,0.13225399999999965,73857.87953483468,24498.31385062084
"145.95.31.210",5838,"244.3.160.239",80,10,1625,5,1220,5,405,17.341188,0.12852000000000174,75941.48770619255,25210.084033613104
"145.95.31.210",10900,"244.3.160.239",80,10,1877,5,1243,5,634,17.343212,0.090247999999999,110185.2672635417,56200.69142806551
"145.95.31.210",11489,"244.3.160.239",80,10,1632,5,1227,5,405,17.478987,0.08449500000000043,116172.55458902834,38345.46422865239
"145.95.31.210",3301,"244.3.160.239",80,10,1631,5,1226,5,405,17.546045,0.08438100000000048,116234.69738448162,38397.269527500044
"145.95.31.210",14402,"244.3.160.239",80,13,4080,6,1232,7,2848,17.550166,0.08953899999999848,110074.93941187825,254458.95084823805
"145.95.31.210",15005,"244.3.160.239",80,38,22536,14,1740,24,20796,17.694686,0.2038429999999991,68287.84898181474,816157.5330033444
"145.95.31.210",5451,"244.3.160.239",80,10,1748,5,1226,5,522,17.919831,0.085364000000002,114896.20917482511,48919.91940396306
"145.95.31.210",13843,"244.3.160.239",80,112,76218,39,3324,73,72894,17.922313,0.3098290000000006,85827.98898747358,1882173.715178369
"145.95.31.210",7651,"244.3.160.239",80,269,186992,91,6646,178,180346,17.928246,0.4748429999999999,111969.64049169938,3038410.590447791
"145.95.31.210",14108,"244.3.160.239",80,10,1622,5,1217,5,405,17.932418,0.08804400000000001,110581.07309981372,36799.7819272182
"145.95.31.210",2391,"244.3.160.239",80,10,1668,5,1198,5,470,17.935124,0.009933000000000192,964864.5927715509,378536.19248967356
"145.95.31.210",8230,"244.3.160.239",80,17,6645,7,1281,10,5364,18.04261,0.12469000000000108,82187.82580800314,344149.49073702487
"145.95.31.210",14851,"244.3.160.239",80,10,2875,5,1144,5,1731,18.044564,0.08534999999999826,107229.05682484109,162249.56063269224
"145.95.31.210",2771,"244.3.160.239",80,10,1622,5,1217,5,405,18.141871,0.08839800000000153,110138.23842168185,36652.41295051861
"145.95.31.210",13789,"244.3.160.239",80,10,1645,5,1240,5,405,18.170512,0.09086500000000086,109172.94888020586,35657.2937874866
"145.95.31.210",14168,"244.3.160.239",80,20,10021,8,1337,12,8684,18.242023,0.1372320000000009,77941.00501340744,506237.61221872113
"145.95.31.210",13846,"244.3.160.239",80,10,2879,5,1142,5,1737,18.298356,0.09123400000000004,100138.10640769884,152311.63820505506
"145.95.31.210",2875,"244.3.160.239",80,10,1623,5,1218,5,405,18.302555,0.08794899999999828,110791.48142673812,36839.53200150159
"145.95.31.210",7340,"244.3.160.239",80,13,3455,6,1244,7,2211,18.383153,0.09546900000000136,104243.2622107685,185274.80124438036
"145.95.31.210",10016,"244.3.160.239",80,10,1618,5,1213,5,405,18.393479,0.08522999999999925,113856.62325472351,38014.78352692747
"145.95.31.210",10497,"244.3.160.239",80,13,3770,6,1216,7,2554,18.570826,0.08598100000000031,113141.27539805265,237633.89586071257
"145.95.31.210",6127,"244.3.160.239",80,10,1608,5,1203,5,405,18.864011,0.08366999999999791,115023.30584439154,38723.55683040613
"145.95.31.210",7630,"244.3.160.239",80,10,1626,5,1221,5,405,18.994186,0.08724499999999935,111960.57080635076,37136.79867041119
"145.95.31.210",11715,"244.3.160.239",80,10,1618,5,1213,5,405,18.996619,0.09067200000000142,107023.11628727555,35733.1921651662
"145.95.31.210",6027,"244.3.160.239",80,10,1615,5,1210,5,405,18.999171,0.08419500000000113,114971.19781459552,38482.095136290234
"145.95.31.210",10049,"244.3.160.239",80,10,1621,5,1216,5,405,19.040531,0.08405299999999727,115736.49958954845,38547.10718237428
"145.95.31.210",10891,"244.3.160.239",80,10,1616,5,1211,5,405,19.086113,0.08596899999999863,112691.78424781206,37688.00381532938
"145.95.31.210",9232,"244.3.160.239",80,10,1614,5,1209,5,405,19.090059,0.08659000000000106,111698.81048619797,37417.715671555154
"145.95.31.210",3890,"244.3.160.239",80,10,1615,5,1210,5,405,19.092183,0.08662400000000048,111747.32175840352,37403.02918359787
"145.95.31.210",8249,"244.3.160.239",80,11,1813,5,1135,6,678,19.127535,0.08304899999999904,109333.0443473143,65310.8405880873
"145.95.31.210",6231,"244.3.160.239",80,11,1863,5,1136,6,727,19.175482,0.0932220000000008,97487.7174915784,62388.706528501316
"145.95.31.210",14084,"244.3.160.239",80,10,1616,5,1211,5,405,19.187761,0.0830510000000011,116651.21431409461,39012.17324294659
"145.95.31.210",13380,"244.3.160.239",80,12,2654,6,1190,6,1464,19.19126,0.11786500000000188,80770.37288423067,99367.9209264821
"145.95.31.210",7973,"244.3.160.239",80,12,2654,6,1190,6,1464,19.215906,0.09208399999999983,103383.8669041312,127188.21945180511
"145.95.31.210",3202,"244.3.160.239",80,10,1615,5,1210,5,405,19.274926,0.08757299999999901,110536.35252874868,36997.70477201919
"145.95.31.210",8891,"244.3.160.239",80,10,1614,5,1209,5,405,19.2787,0.08535799999999938,113310.99604020795,37957.77782984634
"145.95.31.210",12729,"244.3.160.239",80,12,2718,6,1196,6,1522,19.458445,0.08905999999999992,107433.1911071189,136716.82012126668
"145.95.31.210",11041,"244.3.160.239",80,13,3666,6,1202,7,2464,19.460814,0.08743899999999982,109973.8103134759,225437.1619071586
"145.95.31.210",9467,"244.3.160.239",80,10,1613,5,1208,5,405,19.485528,0.09385300000000285,102969.53746816517,34522.0717505024
"145.95.31.210",14428,"244.3.160.239",80,10,1619,5,1214,5,405,19.489473,0.0912380000000006,106446.87520550578,35511.51932308883
"145.95.31.210",15912,"244.3.160.239",80,13,3541,6,1199,7,2342,19.551098,0.11865900000000096,80836.68326886222,157897.84171449151
"145.95.31.210",8976,"244.3.160.239",80,13,3628,6,1199,7,2429,19.554688,0.11570100000000139,82903.34569277609,167950.1473625964
"145.95.31.210",4523,"244.3.160.239",80,13,3430,6,1198,7,2232,19.582559,0.0886010000000006,108170.33667791488,201532.71407771786
"145.95.31.210",7546,"244.3.160.239",80,11,3154,5,1134,6,2020,19.586105,0.0877839999999992,103344.57304292449,184088.21653148805
"145.95.31.210",10043,"244.3.160.239",80,13,3385,6,1200,7,2185,19.677939,0.0969520000000017,99018.07079791887,180295.40391121063
"145.95.31.210",14333,"244.3.160.239",80,13,3682,6,1202,7,2480,19.68021,0.0930470000000021,103345.6210302297,213225.57417218774
"145.95.31.210",14792,"244.3.160.239",80,13,3583,6,1200,7,2383,19.682497,0.09286799999999928,103372.52875048536,205280.61334367216
"145.95.31.210",3891,"244.3.160.239",80,11,3089,5,1137,6,1952,19.685402,0.09081799999999873,100156.35666938411,171948.29218877555
"145.95.31.210",16168,"244.3.160.239",80,12,1865,6,1201,6,664,19.770747,0.09934900000000013,96709.57936164418,53468.07718245773
"145.95.31.210",15771,"244.3.160.239",80,12,1937,6,1201,6,736,19.781785,0.0883819999999993,108709.91830915883,66619.8999796344
"145.95.31.210",12333,"244.3.160.239",80,12,2327,6,1207,6,1120,19.7841,0.13545900000000088,71283.5618157519,66145.47575281038
"145.95.31.210",12863,"244.3.160.239",80,10,1615,5,1210,5,405,19.913399,0.08299200000000084,116637.7482166944,39039.907460959694
"145.95.31.210",7285,"244.3.160.239",80,20,10744,11,9432,9,1312,45.165737,0.9661490000000015,78099.75479972539,10863.748759249333
"145.95.31.210",4896,"244.3.160.239",80,151,105691,52,4362,99,101329,46.133161,1.1025589999999994,31650.00693840422,735227.7746587715
"145.95.31.210",5057,"244.3.160.239",80,10,1626,5,1221,5,405,47.096384,0.08781199999999956,111237.64405776032,36897.007242746055
"145.95.31.210",12608,"244.3.160.239",80,10,1625,5,1220,5,405,47.101297,0.08453999999999695,115448.30849302522,38325.05322924198
"145.95.31.210",10281,"244.3.160.239",80,10,1632,5,1227,5,405,47.1065,0.0896980000000056,109433.87812436605,36121.206715866545
"145.95.31.210",12309,"244.3.160.239",80,10,1748,5,1226,5,522,47.10992,0.08796199999999743,111502.69434528872,47475.046042610695
"145.95.31.210",7725,"244.3.160.239",80,10,1631,5,1226,5,405,47.262971,0.08347299999999791,117499.07155607497,38814.94615025315
"145.95.31.210",13277,"244.3.160.239",80,10,1668,5,1198,5,470,47.320505,0.013532000000004984,708247.1179423935,277859.88767356006
"145.95.31.210",3191,"244.3.160.239",80,10,1608,5,1203,5,405,47.325295,0.08976100000000287,107218.0568398268,36095.85454707386
"145.95.31.210",8839,"244.3.160.239",80,10,1778,5,1256,5,522,47.328083,0.09072700000000111,110749.83191332103,46028.19447352992
"145.95.31.210",12656,"244.3.160.239",80,10,1618,5,1213,5,405,47.33282,0.08487000000000222,114339.57817838748,38176.03393425138
"145.95.31.210",5844,"244.3.160.239",80,10,1622,5,1217,5,405,47.376055,0.0840469999999982,115839.94669649372,38549.85900746093
"145.95.31.210",7465,"244.3.160.239",80,10,1632,5,1227,5,405,47.463558,0.08262200000000064,118806.12911815163,39214.736994988925
"145.95.31.210",9029,"244.3.160.239",80,10,1740,5,1218,5,522,47.556907,0.08595099999999434,113366.91836046866,48585.82215448657
"145.95.31.210",15039,"244.3.160.239",80,10,1626,5,1221,5,405,47.647029,0.08222999999999558,118788.76322510671,39401.67821962999
"145.95.31.210",6250,"244.3.160.239",80,18,7695,8,1337,10,6358,47.733113,0.12365799999999894,86496.62779601879,411328.0175969241
"145.95.31.210",11540,"244.3.160.239",80,11,3566,5,1148,6,2418,47.861983,0.0857379999999992,107117.03095477018,225617.57913644103
"145.95.31.210",8388,"244.3.160.239",80,10,2847,5,1171,5,1676,48.074364,0.0882129999999961,106197.49923481136,151995.7375897044
"145.95.31.210",5050,"244.3.160.239",80,10,1608,5,1203,5,405,48.076799,0.08760300000000143,109859.25139549836,36985.03475908299
"145.95.31.210",6146,"244.3.160.239",80,10,1626,5,1221,5,405,48.079733,0.08913400000000138,109587.81160948514,36349.765521573696
"145.95.31.210",10107,"244.3.160.239",80,10,1618,5,1213,5,405,48.082103,0.08845200000000375,109709.22082032727,36630.03663003508
"145.95.31.210",3566,"244.3.160.239",80,10,1615,5,1210,5,405,48.167764,0.09548399999999901,101378.24138075594,33932.38657785633
"145.95.31.210",14394,"244.3.160.239",80,10,2274,5,1152,5,1122,48.172884,0.09375999999999607,98293.5153583659,95733.78839590846
"145.95.31.210",8272,"244.3.160.239",80,10,1621,5,1216,5,405,48.175218,0.08933100000000138,108898.36674838353,36269.604056821816
"145.95.31.210",7244,"244.3.160.239",80,10,1616,5,1211,5,405,48.179089,0.0907359999999997,106771.2925409984,35707.988009169574
"145.95.31.210",8016,"244.3.160.239",80,12,2654,6,1190,6,1464,48.268227,0.24986299999999773,38100.8792818468,46873.68678035606
"145.95.31.210",11882,"244.3.160.239",80,10,1615,5,1210,5,405,48.272697,0.08351599999999593,115905.93419225625,38794.96144451552
"145.95.31.210",7694,"244.3.160.239",80,10,1617,5,1212,5,405,48.276379,0.08492000000000388,114178.04992934005,38153.556288269574
"145.95.31.210",2702,"244.3.160.239",80,10,1615,5,1210,5,405,48.278971,0.08435500000000218,114753.12666705885,38409.10438029656
"145.95.31.210",11956,"244.3.160.239",80,10,1950,5,1148,5,802,48.35903,0.0857120000000009,107149.5239873052,74855.3294754519
"145.95.31.210",9369,"244.3.160.239",80,10,2630,5,1153,5,1477,48.645492,0.084341000000002,109365.55174825745,140097.93576077733
"145.95.31.210",16050,"244.3.160.239",80,12,3690,6,2276,6,1414,55.695666,0.25824599999999975,70506.41636269301,43803.195402833
"145.95.31.210",16351,"244.3.160.239",80,14,5582,7,4196,7,1386,68.565635,0.7638139999999964,43947.87212593662,14516.623156946654
"145.95.31.210",6649,"244.3.160.239",80,281,193158,95,7202,186,185956,69.331122,2.284140000000008,25224.373287101404,651294.5791413814
"145.95.31.210",12681,"244.3.160.239",80,10,1714,5,1309,5,405,71.324893,0.08713899999999342,120175.81106049864,37181.97362834374
"145.95.31.210",2098,"244.3.160.239",80,10,1713,5,1308,5,405,71.330453,0.08659099999999853,120843.96761788381,37417.28355140898
"145.95.31.210",12053,"244.3.160.239",80,10,1720,5,1315,5,405,71.335625,0.08541100000000768,123169.14683119334,37934.22392899871
"145.95.31.210",13758,"244.3.160.239",80,10,1836,5,1314,5,522,71.339494,0.0890940000000029,117987.74328237209,46871.843221764255
"145.95.31.210",10288,"244.3.160.239",80,10,1965,5,1331,5,634,71.342143,0.08793800000000829,121085.31010483518,57676.99970433171
"145.95.31.210",3221,"244.3.160.239",80,10,1836,5,1314,5,522,71.55425,0.08413200000001098,124946.51262300467,49636.2858365361
"145.95.31.210",15414,"244.3.160.239",80,10,1756,5,1286,5,470,71.559521,0.008563999999992689,1201307.8000944399,439047.1742180301
"145.95.31.210",9172,"244.3.160.239",80,10,1711,5,1306,5,405,71.587057,0.08371800000000462,124799.92355287302,38701.35454740702
"145.95.31.210",13853,"244.3.160.239",80,10,1702,5,1297,5,405,71.590729,0.0863690000000048,120135.69683566352,37513.45969039609
"145.95.31.210",3600,"244.3.160.239",80,10,1696,5,1291,5,405,71.592646,0.08314000000000021,124224.20014433454,38970.41135434197
"145.95.31.210",13892,"244.3.160.239",80,10,1723,5,1318,5,405,71.668049,0.08369299999999669,125984.25196850892,38712.91505860858
"145.95.31.210",8695,"244.3.160.239",80,10,1694,5,1289,5,405,71.673304,0.08326699999999221,123842.57869265093,38910.9731346188
"145.95.31.210",6022,"244.3.160.239",80,10,1706,5,1301,5,405,71.680924,0.08266100000000165,125911.8568611533,39196.235225800985
"145.95.31.210",6908,"244.3.160.239",80,10,1717,5,1312,5,405,71.761177,0.08423100000000261,124609.70426564655,38465.64803931925
"145.95.31.210",13445,"244.3.160.239",80,10,1710,5,1305,5,405,71.849618,0.08302299999999718,125748.2866193748,39025.3303301508
"145.95.31.210",3560,"244.3.160.239",80,10,1720,5,1315,5,405,71.936685,0.08648600000000783,121638.18421477519,37462.71072774445
"145.95.31.210",2826,"244.3.160.239",80,10,1713,5,1308,5,405,72.032501,0.08320700000000159,125758.65011356978,38939.0315718622
"145.95.31.210",13924,"244.3.160.239",80,10,1720,5,1315,5,405,72.119349,0.08394900000000405,125314.17884667468,38594.861165705894
"145.95.31.210",3453,"244.3.160.239",80,10,1732,5,1327,5,405,72.206793,0.08266999999999314,128414.17684771841,39191.96806580705
"145.95.31.210",8077,"244.3.160.239",80,10,1733,5,1328,5,405,72.294038,0.08276600000000656,128361.88773166708,39146.50943623883
"145.95.31.210",2419,"244.3.160.239",80,10,1716,5,1311,5,405,72.380112,0.08542599999999823,122772.92627537539,37927.56303701528
"145.95.31.210",12186,"244.3.160.239",80,10,1738,5,1333,5,405,72.699253,0.08343600000000606,127810.53741789186,38832.158780379745
"145.95.31.210",8834,"244.3.160.239",80,10,1696,5,1291,5,405,72.705878,0.08517200000000003,121260.50814821769,38040.67064293429
"145.95.31.210",15479,"244.3.160.239",80,10,1714,5,1309,5,405,72.708424,0.08727700000000027,119985.79236224855,37123.182510856124
"145.95.31.210",4457,"244.3.160.239",80,10,1706,5,1301,5,405,72.711527,0.08568400000000054,121469.58592035777,37813.36072078777
"145.95.31.210",8337,"244.3.160.239",80,10,1703,5,1298,5,405,72.785849,0.08364600000000166,124142.21839657357,38734.667527436286
"145.95.31.210",5188,"244.3.160.239",80,10,1709,5,1304,5,405,72.794423,0.085353000000012,122221.83168721115,37960.00140592064
"145.95.31.210",6563,"244.3.160.239",80,10,1704,5,1299,5,405,72.800963,0.0843100000000021,123259.39983394307,38429.60502905846
"145.95.31.210",4012,"244.3.160.239",80,10,1702,5,1297,5,405,72.804955,0.08465699999999288,122565.17476405817,38272.08618307137
"145.95.31.210",12700,"244.3.160.239",80,10,1704,5,1299,5,405,72.872691,0.08231499999999414,126246.73510296713,39360.99131385811
"145.95.31.210",2589,"244.3.160.239",80,10,1701,5,1296,5,405,72.883136,0.0863470000000035,120073.65629378645,37523.01759180827
"145.95.31.210",12351,"244.3.160.239",80,10,1703,5,1298,5,405,72.902408,0.08304600000001017,125039.13493724838,39014.52207209984
"145.95.31.210",13038,"244.3.160.239",80,10,1705,5,1300,5,405,72.909203,0.08297100000000057,125345.00006026115,39049.78848031213
"145.95.31.210",11868,"244.3.160.239",80,10,1695,5,1290,5,405,72.958239,0.08418100000000095,122592.9841650715,38488.495028568956
"145.95.31.210",8759,"244.3.160.239",80,10,1704,5,1299,5,405,72.972687,0.08380500000001234,124002.14784318919,38661.17773401972
"145.95.31.210",10230,"244.3.160.239",80,10,1704,5,1299,5,405,72.988839,0.0823079999999976,126257.47193468803,39364.338824902734
"145.95.31.210",13783,"244.3.160.239",80,10,1704,5,1299,5,405,72.99569,0.08390900000000556,123848.45487372404,38613.259602662234
"145.95.31.210",8857,"244.3.160.239",80,10,1708,5,1303,5,405,73.045193,0.08604200000000617,121150.13598009406,37656.02845121879
"145.95.31.210",11302,"244.3.160.239",80,10,1704,5,1299,5,405,73.062155,0.08371599999999546,124133.97677863925,38702.27913421778
"145.95.31.210",11074,"244.3.160.239",80,10,1703,5,1298,5,405,73.074415,0.08511899999999173,121993.91440220173,38064.356959084515
"145.95.31.210",13866,"244.3.160.239",80,10,1703,5,1298,5,405,73.087763,0.089059000000006,116596.86275389687,36380.37705341158
"145.95.31.210",3133,"244.3.160.239",80,10,1708,5,1303,5,405,73.134561,0.08312399999999798,125403.01236706912,38977.91251624175
"145.95.31.210",5128,"244.3.160.239",80,10,1708,5,1303,5,405,73.149944,0.08648499999999615,120529.57160201728,37463.14389778741
"145.95.31.210",4346,"244.3.160.239",80,10,1704,5,1299,5,405,73.162857,0.08411999999999864,123537.80313837575,38516.40513552131
"145.95.31.210",10280,"244.3.160.239",80,10,1705,5,1300,5,405,73.18206,0.08388199999998847,123983.69137599759,38625.68846713771
"145.95.31.210",2095,"244.3.160.239",80,10,1702,5,1297,5,405,73.221729,0.08344900000000166,124339.4168893551,38826.10936020726
"145.95.31.210",7437,"244.3.160.239",80,10,1707,5,1302,5,405,73.242929,0.08513499999999397,122346.8608680418,38057.20326540471
"145.95.31.210",14871,"244.3.160.239",80,10,1708,5,1303,5,405,73.249996,0.08370500000000902,124532.58467234785,38707.365151420476
"145.95.31.210",3650,"244.3.160.239",80,10,1701,5,1296,5,405,73.269456,0.08553200000000061,121217.78983304408,37880.55932282627
"145.95.31.210",10660,"244.3.160.239",80,10,1707,5,1302,5,405,73.308938,0.08266600000000324,126001.01613722197,39193.86446664739
"145.95.31.210",11287,"244.3.160.239",80,10,1709,5,1304,5,405,73.331651,0.0831890000000044,125401.19486950737,38947.45699551418
"145.95.31.210",2063,"244.3.160.239",80,10,1703,5,1298,5,405,73.336298,0.08420700000000636,123315.16382247575,38476.61120809143
"145.95.31.210",14565,"244.3.160.239",80,19,10724,11,9476,8,1248,89.555328,0.839145000000002,90339.57182608466,11897.824571438758
"145.95.31.210",7127,"244.3.160.239",80,295,206202,99,7370,196,198832,90.395917,1.3981550000000027,42169.859564926555,1137682.159703321
"145.95.31.210",6686,"244.3.160.239",80,10,1661,5,1256,5,405,91.485535,0.08407599999999604,119510.91869261707,38536.562158049295
"145.95.31.210",5532,"244.3.160.239",80,10,1665,5,1260,5,405,91.490992,0.08388799999998753,120160.2136181754,38622.9258058421
"145.95.31.210",6240,"244.3.160.239",80,10,1626,5,1221,5,405,91.494945,0.08420900000000131,115997.10244748005,38475.69737201427
"145.95.31.210",2825,"244.3.160.239",80,10,1625,5,1220,5,405,91.499007,0.08410599999999135,116044.03966424515,38522.81644591745
"145.95.31.210",13287,"244.3.160.239",80,10,1877,5,1243,5,634,91.50666,0.087403000000009,113771.83849523443,58030.044735300595
"145.95.31.210",7962,"244.3.160.239",80,10,1632,5,1227,5,405,91.577607,0.08845700000000534,110969.17146183352,36627.96613043405
"145.95.31.210",14331,"244.3.160.239",80,10,1631,5,1226,5,405,91.589599,0.09741999999999962,100677.4789570934,33258.05789365646
"145.95.31.210",15276,"244.3.160.239",80,10,1762,5,1240,5,522,91.652782,0.08469599999999389,117124.77566828087,49305.7523377763
"145.95.31.210",10024,"244.3.160.239",80,10,1649,5,1244,5,405,91.660074,0.08658499999999947,114939.07720736919,37419.87642201328
"145.95.31.210",3211,"244.3.160.239",80,10,1631,5,1226,5,405,91.781202,0.08292500000000302,118275.55019595589,39071.45010551561
"145.95.31.210",14433,"244.3.160.239",80,10,1618,5,1213,5,405,91.804257,0.08359299999999337,116086.27516659015,38759.226251004955
"145.95.31.210",6170,"244.3.160.239",80,10,1629,5,1224,5,405,91.898096,0.08296100000001161,118031.36413493846,39054.495485825224
"145.95.31.210",12425,"244.3.160.239",80,10,1623,5,1218,5,405,91.992893,0.08345100000001082,116763.13045977564,38825.17884746234
"145.95.31.210",3907,"244.3.160.239",80,10,1633,5,1228,5,405,92.113007,0.08302000000000476,118332.93182365017,39026.74054444489
"145.95.31.210",14558,"244.3.160.239",80,10,1622,5,1217,5,405,92.119699,0.08369000000000426,116334.09009439006,38714.30278408215
"145.95.31.210",7638,"244.3.160.239",80,10,1634,5,1229,5,405,92.207218,0.08341900000000635,117862.83700355137,38840.07240556412
"145.95.31.210",7441,"244.3.160.239",80,10,1742,5,1220,5,522,92.293777,0.08341999999998961,116998.32174539937,50059.93766483481
"145.95.31.210",2426,"244.3.160.239",80,10,1622,5,1217,5,405,92.380818,0.08376199999999301,116234.09183162785,38681.024808388895
"145.95.31.210",6959,"244.3.160.239",80,10,1645,5,1240,5,405,92.467811,0.08319799999999589,119233.63542393435,38943.24382797856
"145.95.31.210",15314,"244.3.160.239",80,10,1626,5,1221,5,405,92.555633,0.0827160000000049,118090.81677062988,39170.17263890672
"145.95.31.210",7387,"244.3.160.239",80,10,1740,5,1218,5,522,92.642368,0.08335900000000152,116891.9972648403,50096.57025636013
"145.95.31.210",8538,"244.3.160.239",80,10,1668,5,1198,5,470,92.772012,0.007581000000001836,1264213.1644898665,495976.7840653066
"145.95.31.210",12146,"244.3.160.239",80,10,1608,5,1203,5,405,93.015359,0.09268399999999133,103836.69241725541,34957.48996590893
"145.95.31.210",12430,"244.3.160.239",80,10,1626,5,1221,5,405,93.017873,0.09157600000000343,106665.50187821737,35380.449025944334
"145.95.31.210",13358,"244.3.160.239",80,10,1618,5,1213,5,405,93.020432,0.09191300000000524,105578.10103031613,35250.72623023746
"145.95.31.210",11541,"244.3.160.239",80,10,1615,5,1210,5,405,93.022799,0.08821999999999264,109725.68578554531,36726.365903426326
"145.95.31.210",8445,"244.3.160.239",80,10,1621,5,1216,5,405,93.161213,0.08897999999999229,109327.93886267525,36412.677006071935
"145.95.31.210",14290,"244.3.160.239",80,10,1616,5,1211,5,405,93.165096,0.09170799999999701,105639.63885375665,35329.524141842645
"145.95.31.210",8032,"244.3.160.239",80,10,1614,5,1209,5,405,93.170764,0.09073999999999671,106590.25787966003,35706.41392991092
"145.95.31.210",2178,"244.3.160.239",80,10,1623,5,1218,5,405,93.173189,0.08998500000001286,108284.71411900436,36006.00100016155
"145.95.31.210",9805,"244.3.160.239",80,10,1615,5,1210,5,405,93.254074,0.08243500000000381,117425.8506702196,39303.69381937102
"145.95.31.210",12231,"244.3.160.239",80,10,1616,5,1211,5,405,93.260171,0.08614699999999686,112458.9364690628,37610.13151938104
"145.95.31.210",8749,"244.3.160.239",80,10,1617,5,1212,5,405,93.273933,0.08558200000000227,113294.85172115332,37858.42817414777
"145.95.31.210",6070,"244.3.160.239",80,10,1616,5,1211,5,405,93.276538,0.08425900000000297,114978.8153194277,38452.865569255344
"145.95.31.210",5560,"244.3.160.239",80,10,1607,5,1202,5,405,93.3397,0.08374300000001256,114827.50797079825,38689.80093858011
"145.95.31.210",9511,"244.3.160.239",80,10,1607,5,1202,5,405,93.34984,0.08510800000000529,112985.85326878088,38069.276683740645
"145.95.31.210",6316,"244.3.160.239",80,10,1615,5,1210,5,405,93.363762,0.08258700000000374,117209.73034496423,39231.356024554145
"145.95.31.210",12833,"244.3.160.239",80,10,1614,5,1209,5,405,93.367505,0.08347700000000202,115864.2500329404,38813.08623932247
"145.95.31.210",12995,"244.3.160.239",80,10,1613,5,1208,5,405,93.427732,0.08409899999999482,114912.18682743666,38526.022901582655
"145.95.31.210",6631,"244.3.160.239",80,10,1619,5,1214,5,405,93.455146,0.08484599999999887,114466.20936756158,38186.83261438422
"145.95.31.210",6830,"244.3.160.239",80,10,1613,5,1208,5,405,93.457907,0.08542199999999411,113132.44831543005,37929.33904614997
"145.95.31.210",7236,"244.3.160.239",80,10,1619,5,1214,5,405,93.460684,0.08378100000000188,115921.27093254773,38672.252658716505
"145.95.31.210",11007,"244.3.160.239",80,10,1616,5,1211,5,405,93.634758,0.08538499999998805,113462.55197050249,37945.77501903675
"145.95.31.210",3013,"244.3.160.239",80,10,1616,5,1211,5,405,93.637149,0.08931800000000578,108466.37855750658,36274.88300230402
"145.95.31.210",2712,"244.3.160.239",80,10,1615,5,1210,5,405,93.639949,0.08809200000000317,109885.1201017079,36779.73028197661
"145.95.31.210",2761,"244.3.160.239",80,10,1615,5,1210,5,405,93.641785,0.08773300000000006,110334.76570959609,36930.23149784001
"145.95.31.210",12996,"244.3.160.239",80,10,1617,5,1212,5,405,93.723523,0.0828379999999953,117047.73171733443,39112.48460851522
"145.95.31.210",3837,"244.3.160.239",80,10,1619,5,1214,5,405,93.750049,0.08340799999999149,116439.67005564204,38845.194705547794
"145.95.31.210",13449,"244.3.160.239",80,10,1617,5,1212,5,405,93.75359,0.09124099999999657,106268.01547550294,35510.351705923014
"145.95.31.210",6307,"244.3.160.239",80,10,1618,5,1213,5,405,93.756125,0.08709799999999746,111414.7282371614,37199.476451813985
"145.95.31.210",8217,"244.3.160.239",80,10,1618,5,1213,5,405,93.80936,0.08233099999999638,117865.68850129875,39353.34199754822
"145.95.31.210",8907,"244.3.160.239",80,10,1615,5,1210,5,405,93.836005,0.08405700000000138,115159.9509856388,38545.27285056505
"145.95.31.210",10262,"244.3.160.239",80,20,10744,11,9432,9,1312,145.474711,1.125,67072,9329.777777777777
"145.95.31.210",15266,"244.3.160.239",80,151,105685,51,4298,100,101387,146.601201,1.0640870000000007,32313.1473272392,762245.9441756167
"145.95.31.210",15636,"244.3.160.239",80,10,1626,5,1221,5,405,147.511196,0.08557899999999563,114140.15120532489,37859.75531380555
"145.95.31.210",4406,"244.3.160.239",80,10,1625,5,1220,5,405,147.518109,0.08387799999999856,116359.47447483448,38627.53046090817
"145.95.31.210",4693,"244.3.160.239",80,10,1632,5,1227,5,405,147.52214,0.08325199999998745,117907.07730746985,38917.98395234335
"145.95.31.210",6806,"244.3.160.239",80,10,1631,5,1226,5,405,147.526153,0.08280000000002019,118454.10628016436,39130.43478259916
"145.95.31.210",11953,"244.3.160.239",80,10,1631,5,1226,5,405,147.664738,0.08928000000000225,109856.63082436999,36290.32258064425
"145.95.31.210",2791,"244.3.160.239",80,10,1668,5,1198,5,470,147.733269,0.011036999999987529,868351.9072221464,340672.2841355666
"145.95.31.210",15099,"244.3.160.239",80,10,1608,5,1203,5,405,147.738247,0.08883900000000722,108330.80066186267,36470.46905075177
"145.95.31.210",10092,"244.3.160.239",80,10,1778,5,1256,5,522,147.740535,0.0881559999999979,113979.76314715095,47370.57035255796
"145.95.31.210",3006,"244.3.160.239",80,10,1618,5,1213,5,405,147.742931,0.08682500000000459,111765.04462999696,37316.44111718777
"145.95.31.210",7297,"244.3.160.239",80,10,1622,5,1217,5,405,147.784407,0.08339800000001674,116741.40866685107,38849.852514440994
"145.95.31.210",4087,"244.3.160.239",80,10,1632,5,1227,5,405,147.871384,0.08343099999999026,117654.10938381591,38834.48598243313
"145.95.31.210",10632,"244.3.160.239",80,10,1740,5,1218,5,522,147.964924,0.08323400000000447,117067.54451305328,50171.80479130855
"145.95.31.210",3792,"244.3.160.239",80,10,1626,5,1221,5,405,148.052567,0.08298299999998449,117710.85644049777,39044.14157117248
"145.95.31.210",13685,"244.3.160.239",80,10,1626,5,1221,5,405,148.139713,0.08369500000000585,116709.48085308941,38711.989963555454
"145.95.31.210",8474,"244.3.160.239",80,10,1629,5,1224,5,405,148.227081,0.08312000000000808,117805.58229065266,38979.78825793654
"145.95.31.210",13267,"244.3.160.239",80,10,1652,5,1247,5,405,148.425505,0.0850510000000213,117294.32928475269,38094.79018470316
"145.95.31.210",10002,"244.3.160.239",80,10,1608,5,1203,5,405,148.428184,0.08801700000000778,109342.51337808774,36811.07058863303
"145.95.31.210",13222,"244.3.160.239",80,10,1626,5,1221,5,405,148.431025,0.08657399999998461,112828.33183174783,37424.63095156255
"145.95.31.210",7287,"244.3.160.239",80,10,1618,5,1213,5,405,148.433419,0.08810700000000793,110138.80849420735,36773.46862337508
"145.95.31.210",2133,"244.3.160.239",80,10,1615,5,1210,5,405,148.513689,0.08288400000000706,116789.73022536527,39090.77747212639
"145.95.31.210",11881,"244.3.160.239",80,10,1633,5,1228,5,405,148.52029,0.08397800000000188,116983.01936221129,38581.53325870975
"145.95.31.210",8969,"244.3.160.239",80,10,1621,5,1216,5,405,148.524554,0.08478900000000067,114731.86380308676,38212.503980468864
"145.95.31.210",2446,"244.3.160.239",80,10,1616,5,1211,5,405,148.526575,0.08410499999999388,115189.34665002918,38523.274478333464
"145.95.31.210",13127,"244.3.160.239",80,10,1607,5,1202,5,405,148.599122,0.08291400000001659,115975.58916465346,39076.633620369925
"145.95.31.210",7192,"244.3.160.239",80,10,1615,5,1210,5,405,148.607376,0.08282700000000887,116870.1027442617,39117.67901770743
"145.95.31.210",10722,"244.3.160.239",80,10,1629,5,1224,5,405,148.613458,0.08248499999999126,118712.49318059087,39279.86906710727
"145.95.31.210",5170,"244.3.160.239",80,10,1617,5,1212,5,405,148.61697,0.08372799999997937,115803.55436654869,38696.73227595068
"145.95.31.210",6122,"244.3.160.239",80,10,1615,5,1210,5,405,148.685107,0.08301900000000728,116599.81450028489,39027.21063852511
"145.95.31.210",14593,"244.3.160.239",80,10,1634,5,1229,5,405,148.719567,0.08347299999999791,117786.58967570648,38814.94615025315
"145.95.31.210",13541,"244.3.160.239",80,12,3690,6,2276,6,1414,152.612185,0.23840999999998758,76372.63537603687,47447.674174743464
"145.95.31.210",12761,"244.3.160.239",80,14,5582,7,4196,7,1386,155.171367,0.6212400000000002,54033.8677483742,17848.17461850492
"145.95.31.210",5710,"244.3.160.239",80,271,192554,91,6946,180,185608,155.794121,1.9022250000000156,29212.106874843692,780593.2526383513
"145.95.31.210",15626,"244.3.160.239",80,10,1714,5,1309,5,405,157.415508,0.08948399999999879,117026.50753207436,36207.59018372049
"145.95.31.210",6064,"244.3.160.239",80,10,1713,5,1308,5,405,157.424653,0.09051099999999224,115610.25731680014,35796.75398570646
"145.95.31.210",14745,"244.3.160.239",80,10,1720,5,1315,5,405,157.428252,0.0882050000000163,119267.61521453496,36732.611529951835
"145.95.31.210",5541,"244.3.160.239",80,10,1719,5,1314,5,405,157.430615,0.0895580000000109,117376.44878178074,36177.67256972694
"145.95.31.210",8663,"244.3.160.239",80,10,1965,5,1331,5,634,157.436467,0.09433400000000347,112875.52738142778,53766.40447770489
"145.95.31.210",5628,"244.3.160.239",80,10,1719,5,1314,5,405,157.643925,0.08305599999999913,126565.20901560526,39009.82469659066
"145.95.31.210",15330,"244.3.160.239",80,10,1756,5,1286,5,470,157.649583,0.014149000000003298,727118.5242771646,265743.16206086107
"145.95.31.210",8705,"244.3.160.239",80,10,1711,5,1306,5,405,157.675683,0.0877100000000155,119119.82670160933,36939.91563105037
"145.95.31.210",2363,"244.3.160.239",80,10,1702,5,1297,5,405,157.677537,0.09038100000000782,114802.88998793002,35848.24244033281
"145.95.31.210",16074,"244.3.160.239",80,10,1696,5,1291,5,405,157.679319,0.08566200000001345,120566.87912958347,37823.07207395918
"145.95.31.210",16193,"244.3.160.239",80,10,1723,5,1318,5,405,157.757082,0.08287200000000894,127232.35833573298,39096.43788010004
"145.95.31.210",11269,"244.3.160.239",80,10,1694,5,1289,5,405,157.767194,0.08727799999999775,118151.19503196987,37122.757166755466
"145.95.31.210",12589,"244.3.160.239",80,10,1706,5,1301,5,405,157.770063,0.08616700000001742,120788.70101080339,37601.40192880505
"145.95.31.210",5987,"244.3.160.239",80,10,1717,5,1312,5,405,157.873523,0.08304699999999343,126386.26320036642,39014.0522836497
"145.95.31.210",4703,"244.3.160.239",80,10,1710,5,1305,5,405,157.967523,0.08269999999998845,126239.41958889308,39177.750906897854
"145.95.31.210",7133,"244.3.160.239",80,10,1720,5,1315,5,405,158.053574,0.08262200000001485,127326.86209481869,39214.73699498218
"145.95.31.210",7769,"244.3.160.239",80,10,1713,5,1308,5,405,158.145656,0.08594700000000444,121749.45024258508,37697.650877864646
"145.95.31.210",11392,"244.3.160.239",80,10,1720,5,1315,5,405,158.236452,0.08273799999997777,127148.34779669349,39159.75730620598
"145.95.31.210",3704,"244.3.160.239",80,10,1732,5,1327,5,405,158.323384,0.0833329999999819,127392.50957006596,38880.15552063053
"145.95.31.210",6464,"244.3.160.239",80,10,1733,5,1328,5,405,158.410485,0.08298800000000028,128018.50870005258,39041.78917433832
"145.95.31.210",8438,"244.3.160.239",80,10,1716,5,1311,5,405,158.496695,0.08371600000000967,125280.7109751874,38702.27913421121
"145.95.31.210",8405,"244.3.160.239",80,10,1738,5,1333,5,405,158.818839,0.08695000000000164,122645.19838987692,37262.79470960252
"145.95.31.210",5342,"244.3.160.239",80,10,1696,5,1291,5,405,158.828445,0.08698200000000611,118737.2099974624,37249.08601779417
"145.95.31.210",7369,"244.3.160.239",80,10,1714,5,1309,5,405,158.831067,0.0866359999999986,120873.53986795523,37397.84846945903
"145.95.31.210",13414,"244.3.160.239",80,10,1706,5,1301,5,405,158.833588,0.08555200000000696,121657.00392742605,37871.703759114185
"145.95.31.210",12196,"244.3.160.239",80,10,1703,5,1298,5,405,158.909048,0.08338799999998514,124526.31074017665,38854.511440501956
"145.95.31.210",8983,"244.3.160.239",80,10,1709,5,1304,5,405,158.923845,0.08541299999998841,122135.97461746357,37933.33567490241
"145.95.31.210",13029,"244.3.160.239",80,10,1704,5,1299,5,405,158.926543,0.08848199999999906,117447.61646436687,36617.617142470044
"145.95.31.210",6512,"244.3.160.239",80,10,1702,5,1297,5,405,158.929372,0.08836999999999762,117415.41247029851,36664.02625325436
"145.95.31.210",7721,"244.3.160.239",80,10,1704,5,1299,5,405,158.995153,0.08247700000001146,125998.76329156682,39283.679086285265
"145.95.31.210",10057,"244.3.160.239",80,10,1701,5,1296,5,405,159.012682,0.08938499999999294,115992.61621078278,36247.69256586962
"145.95.31.210",10100,"244.3.160.239",80,10,1703,5,1298,5,405,159.03316,0.09230599999997935,112495.39574894724,35100.64351180557
"145.95.31.210",10208,"244.3.160.239",80,10,1705,5,1300,5,405,159.035927,0.08385800000002064,124019.17527245391,38636.743065649105
"145.95.31.210",8709,"244.3.160.239",80,10,1695,5,1290,5,405,159.080905,0.08249599999999191,125096.974398771,39274.63149728857
"145.95.31.210",9380,"244.3.160.239",80,10,1704,5,1299,5,405,159.105382,0.08280400000001009,125501.18351768916,39128.544514752975
"145.95.31.210",5517,"244.3.160.239",80,10,1704,5,1299,5,405,159.128163,0.08248800000001211,125981.96101249242,39278.44050043066
"145.95.31.210",12599,"244.3.160.239",80,10,1704,5,1299,5,405,159.138452,0.08489099999999894,122415.80379545687,38166.590097890716
"145.95.31.210",10733,"244.3.160.239",80,10,1708,5,1303,5,405,159.166292,0.08996099999998819,115872.43361013515,36015.606762935335
"145.95.31.210",11891,"244.3.160.239",80,10,1704,5,1299,5,405,159.191557,0.08319500000001767,124911.35284569737,38944.648115864074
"145.95.31.210",7703,"244.3.160.239",80,10,1703,5,1298,5,405,159.214137,0.08420599999999467,123316.62826877725,38477.06814241509
"145.95.31.210",8372,"244.3.160.239",80,10,1703,5,1298,5,405,159.22969,0.08322100000000887,124776.19831531576,38932.48098436277
"145.95.31.210",15685,"244.3.160.239",80,10,1708,5,1303,5,405,159.259694,0.08358499999999935,124711.37165759502,38762.93593348119
"145.95.31.210",7579,"244.3.160.239",80,10,1708,5,1303,5,405,159.27817,0.08331000000001154,125123.03444962857,38890.88944904035
"145.95.31.210",15405,"244.3.160.239",80,10,1704,5,1299,5,405,159.301729,0.082618999999994,125782.20506179878,39216.16093150771
"145.95.31.210",13385,"244.3.160.239",80,10,1705,5,1300,5,405,159.315923,0.08283499999998867,125550.79374662187,39113.90112875528
"145.95.31.210",8587,"244.3.160.239",80,10,1702,5,1297,5,405,159.346844,0.08431199999998285,123066.70462095682,38428.69342443139
"145.95.31.210",5369,"244.3.160.239",80,10,1707,5,1302,5,405,159.364733,0.08307099999998968,125386.71738634775,39002.780753817846
"145.95.31.210",4854,"244.3.160.239",80,10,1708,5,1303,5,405,159.387751,0.08328000000000202,125168.10758885383,38904.89913544574
"145.95.31.210",5680,"244.3.160.239",80,10,1701,5,1296,5,405,159.401499,0.08335600000000909,124382.16805027676,38869.42751571149
"145.95.31.210",13888,"244.3.160.239",80,10,1707,5,1302,5,405,159.43377,0.08399399999998991,124008.8577755703,38574.183870281086
"145.95.31.210",15384,"244.3.160.239",80,10,1709,5,1304,5,405,159.450848,0.0825619999999958,126353.52825755833,39243.23538674165
"145.95.31.210",8476,"244.3.160.239",80,10,1703,5,1298,5,405,159.473895,0.08384900000001494,123841.66775987967,38640.89017161114
"145.95.31.210",7712,"244.3.160.239",80,23,14063,13,12687,10,1376,174.856784,1.5965829999999812,63570.76331139765,6894.724546108865
"145.95.31.210",6020,"244.3.160.239",80,281,198194,95,7202,186,190992,176.4546,1.6127130000000136,35726.13354018943,947432.0601371645
"145.95.31.210",15392,"244.3.160.239",80,10,1661,5,1256,5,405,177.778687,0.0877839999999992,114462.77225918268,36908.77608675874
"145.95.31.210",6574,"244.3.160.239",80,10,1665,5,1260,5,405,177.789099,0.0886780000000158,113669.6813189089,36536.683281077865
"145.95.31.210",8870,"244.3.160.239",80,10,1626,5,1221,5,405,177.792775,0.10159299999997984,96148.35667813667,31891.961060315603
"145.95.31.210",13436,"244.3.160.239",80,10,1625,5,1220,5,405,177.796927,0.09886699999998427,98718.48038275211,32771.29881558574
"145.95.31.210",4112,"244.3.160.239",80,10,1877,5,1243,5,634,177.803431,0.09384500000001594,105961.95854865268,54046.566146295896
"145.95.31.210",15141,"244.3.160.239",80,10,1632,5,1227,5,405,177.871671,0.08458300000000918,116051.68887363814,38305.569677117724
"145.95.31.210",12523,"244.3.160.239",80,10,1631,5,1226,5,405,177.892278,0.08951600000000326,109567.00478126416,36194.646767057086
"145.95.31.210",5513,"244.3.160.239",80,10,1762,5,1240,5,522,177.968349,0.08729700000000662,113635.06191506292,47836.69541908294
"145.95.31.210",7791,"244.3.160.239",80,10,1649,5,1244,5,405,177.975584,0.0903509999999983,110148.19979856546,35860.14543281271
"145.95.31.210",15982,"244.3.160.239",80,10,1631,5,1226,5,405,178.08991,0.08298299999998449,118192.88287964804,39044.14157117248
"145.95.31.210",9037,"244.3.160.239",80,10,1629,5,1224,5,405,178.20218,0.08341999999998961,117381.92280030232,38839.60680892356
"145.95.31.210",13845,"244.3.160.239",80,10,1623,5,1218,5,405,178.297109,0.0831929999999943,117125.23890231951,38945.58436407176
"145.95.31.210",11684,"244.3.160.239",80,10,1633,5,1228,5,405,178.415865,0.0825269999999989,119039.82938917118,39259.87858519082
"145.95.31.210",9150,"244.3.160.239",80,10,1622,5,1217,5,405,178.422047,0.08334200000001601,116819.85073550105,38875.95690047488
"145.95.31.210",10254,"244.3.160.239",80,10,1634,5,1229,5,405,178.508721,0.08275000000000432,118815.70996978231,39154.0785498469
"145.95.31.210",2627,"244.3.160.239",80,10,1625,5,1220,5,405,178.594525,0.08317700000000627,117340.1300840288,38953.075970517755
"145.95.31.210",11567,"244.3.160.239",80,10,1622,5,1217,5,405,178.681264,0.08351099999998723,116583.44409720262,38797.28419011262
"145.95.31.210",13981,"244.3.160.239",80,10,1645,5,1240,5,405,178.769206,0.08325999999999567,119144.84746577607,38914.24453519299
"145.95.31.210",4670,"244.3.160.239",80,10,1743,5,1221,5,522,178.856123,0.08590200000000436,113710.97296919169,48613.53635537924
"145.95.31.210",15451,"244.3.160.239",80,10,1623,5,1218,5,405,178.948028,0.08309400000001688,117264.7844609481,38991.98498085712
"145.95.31.210",14174,"244.3.160.239",80,10,1668,5,1198,5,470,179.077339,0.007553000000001475,1268899.7749236235,497815.43757437647
"145.95.31.210",2529,"244.3.160.239",80,10,1608,5,1203,5,405,179.241918,0.09164899999998966,105009.32907070548,35352.267891634016
"145.95.31.210",6161,"244.3.160.239",80,10,1626,5,1221,5,405,179.244586,0.09042500000001041,108023.22366600913,35830.7990046959
"145.95.31.210",4845,"244.3.160.239",80,10,1618,5,1213,5,405,179.246939,0.08943800000000124,108499.74283861296,36226.21257183697
"145.95.31.210",7867,"244.3.160.239",80,10,1615,5,1210,5,405,179.249475,0.08803700000001413,109953.76943783235,36802.70795233231
"145.95.31.210",3768,"244.3.160.239",80,10,1621,5,1216,5,405,179.371094,0.08421500000000037,115513.8633260103,38472.95612420573
"145.95.31.210",9566,"244.3.160.239",80,10,1616,5,1211,5,405,179.375039,0.08658900000000358,111884.88145144995,37418.14780168227
"145.95.31.210",8061,"244.3.160.239",80,10,1614,5,1209,5,405,179.377449,0.08889899999999784,108797.6242702419,36445.85428407607
"145.95.31.210",14599,"244.3.160.239",80,10,1623,5,1218,5,405,179.379862,0.08810600000001045,110594.05715840969,36773.88600094903
"145.95.31.210",3401,"244.3.160.239",80,10,1615,5,1210,5,405,179.458369,0.08346699999998464,115973.97773972686,38817.73635090031
"145.95.31.210",14206,"244.3.160.239",80,10,1616,5,1211,5,405,179.465036,0.08605099999999766,112584.39762466752,37652.09003962869
"145.95.31.210",14761,"244.3.160.239",80,10,1617,5,1212,5,405,179.477805,0.08479900000000384,114340.97100201136,38207.99773582062
"145.95.31.210",15359,"244.3.160.239",80,10,1616,5,1211,5,405,179.480121,0.08387300000001119,115507.97038377913,38629.833200190384
"145.95.31.210",7125,"244.3.160.239",80,10,1607,5,1202,5,405,179.544961,0.08286499999999819,116044.16822542943,39099.740541846026
"145.95.31.210",10203,"244.3.160.239",80,10,1607,5,1202,5,405,179.554173,0.08424400000001242,114144.62751054773,38459.71226436924
"145.95.31.210",13709,"244.3.160.239",80,10,1615,5,1210,5,405,179.566755,0.08425399999998717,114890.6876825014,38455.14753009345
"145.95.31.210",11245,"244.3.160.239",80,10,1614,5,1209,5,405,179.570783,0.08903399999999806,108632.65718714436,36390.5923579764
"145.95.31.210",4249,"244.3.160.239",80,10,1613,5,1208,5,405,179.631135,0.08337299999999459,115912.82549507187,38861.50192508618
"145.95.31.210",9928,"244.3.160.239",80,10,1619,5,1214,5,405,179.658462,0.0841180000000179,115456.85822294792,38517.32090633765
"145.95.31.210",5261,"244.3.160.239",80,10,1613,5,1208,5,405,179.665467,0.08448500000000081,114387.16931999654,38350.0029591048
"145.95.31.210",11932,"244.3.160.239",80,10,1619,5,1214,5,405,179.68905,0.08283199999999624,117249.37222330067,39115.317751595365
"145.95.31.210",4413,"244.3.160.239",80,10,1616,5,1211,5,405,179.845246,0.08544599999999036,113381.55092106234,37918.68548557411
"145.95.31.210",10192,"244.3.160.239",80,10,1616,5,1211,5,405,179.847922,0.08778499999999667,110360.53995557746,36908.35564162582
"145.95.31.210",11326,"244.3.160.239",80,10,1615,5,1210,5,405,179.85088,0.08849200000000224,109388.41929213663,36613.47918455813
"145.95.31.210",4909,"244.3.160.239",80,10,1615,5,1210,5,405,179.852929,0.08472100000000182,114257.38600818913,38243.17465563356
"145.95.31.210",6477,"244.3.160.239",80,10,1617,5,1212,5,405,179.934277,0.08618599999999788,112500.87021094191,37593.11257048801
"145.95.31.210",13139,"244.3.160.239",80,10,1619,5,1214,5,405,179.942549,0.08363699999998175,116120.85560221097,38738.83568278043
"145.95.31.210",2323,"244.3.160.239",80,10,1617,5,1212,5,405,179.966179,0.08383499999999344,115655.75237073726,38647.342995172105
"145.95.31.210",5180,"244.3.160.239",80,10,1618,5,1213,5,405,179.972776,0.08293699999998694,117004.47327491383,39065.79693020618
"145.95.31.210",13352,"244.3.160.239",80,10,1618,5,1213,5,405,180.023819,0.08280099999998924,117196.65221436047,39129.962198529254
"145.95.31.210",11904,"244.3.160.239",80,10,1615,5,1210,5,405,180.048886,0.08300699999998074,116616.67088320559,39032.8526509903
"145.95.31.210",3367,"244.3.160.239",80,10,1618,5,1213,5,405,180.053481,0.08403599999999756,115474.32052930033,38554.905040697966
"145.95.31.210",14398,"244.3.160.239",80,19,10796,11,9658,8,1138,205.630935,1.0804620000000114,71510.15028756142,8426.025163309681
"145.95.31.210",3871,"244.3.160.239",80,159,109119,54,4437,105,104682,206.712228,1.0548709999999915,33649.612132668626,793894.2297209866
"145.95.31.210",3375,"244.3.160.239",80,10,1573,5,1168,5,405,207.605769,0.08390199999999481,111368.0246001356,38616.4811327525
"145.95.31.210",9673,"244.3.160.239",80,10,1572,5,1167,5,405,207.610313,0.08498000000000161,109861.14379853875,38126.61802777052
"145.95.31.210",10412,"244.3.160.239",80,10,1579,5,1174,5,405,207.614826,0.08873300000001905,105845.62676792157,36514.036491489125
"145.95.31.210",13395,"244.3.160.239",80,10,1578,5,1173,5,405,207.617072,0.08797599999999761,106665.45421478874,36828.2258797864
"145.95.31.210",8097,"244.3.160.239",80,10,1578,5,1173,5,405,207.765329,0.08409399999999323,111589.41184865455,38528.31355388329
"145.95.31.210",14548,"244.3.160.239",80,10,1615,5,1145,5,470,207.826022,0.008961999999996806,1022093.2827497505,419549.2077662732
"145.95.31.210",6818,"244.3.160.239",80,10,1565,5,1160,5,405,207.839469,0.08509599999999296,109053.30450315842,38074.64510670617
"145.95.31.210",7114,"244.3.160.239",80,10,1573,5,1168,5,405,207.878489,0.08269300000000612,112996.26328708969,39181.067321293944
"145.95.31.210",11557,"244.3.160.239",80,15,5445,7,1220,8,4225,207.964754,0.12287800000001425,79428.37611288326,275069.5812105998
"145.95.31.210",11022,"244.3.160.239",80,10,1555,5,1150,5,405,208.181227,0.08986999999999057,102370.09013019879,36052.07521976566
"145.95.31.210",6253,"244.3.160.239",80,10,1573,5,1168,5,405,208.183692,0.09310999999999581,100354.41950381722,34797.55128342977
"145.95.31.210",13910,"244.3.160.239",80,10,1565,5,1160,5,405,208.186119,0.09200400000000286,100865.17977478927,35215.860179991076
"145.95.31.210",8715,"244.3.160.239",80,10,1562,5,1157,5,405,208.188573,0.09068700000000263,102065.34563939409,35727.28174931254
"145.95.31.210",15608,"244.3.160.239",80,10,1568,5,1163,5,405,208.275117,0.08596900000000574,108225.05786968999,37688.003815326265
"145.95.31.210",10617,"244.3.160.239",80,10,1563,5,1158,5,405,208.282342,0.08263500000001045,112107.46051913631,39208.56779814353
"145.95.31.210",2956,"244.3.160.239",80,10,1554,5,1149,5,405,208.285712,0.08740800000001059,105161.99890168963,37067.545304773106
"145.95.31.210",2910,"244.3.160.239",80,10,1562,5,1157,5,405,208.288176,0.08749900000000821,105784.06610360269,37028.994617077864
"145.95.31.210",2425,"244.3.160.239",80,12,1877,6,1145,6,732,208.363976,0.2823609999999803,32440.74075385991,20739.408062729653
"145.95.31.210",4094,"244.3.160.239",80,10,1561,5,1156,5,405,208.369046,0.08287999999998874,111583.01158302675,39092.6640926694
"145.95.31.210",3766,"244.3.160.239",80,10,1561,5,1156,5,405,208.387836,0.0866929999999968,106675.27943432966,37373.25966341134
"145.95.31.210",5306,"244.3.160.239",80,10,1562,5,1157,5,405,208.391437,0.08444700000001149,109607.20925549447,38367.25993818086
"145.95.31.210",14385,"244.3.160.239",80,15,6116,8,5042,7,1074,211.100102,0.9153070000000127,44068.27436040524,9387.014411557959
"145.95.31.210",2268,"244.3.160.239",80,102,68955,35,3168,67,65787,212.016823,1.01464900000002,24978.0958735479,518697.59887408325
"145.95.31.210",7121,"244.3.160.239",80,10,1573,5,1168,5,405,212.940787,0.0967899999999986,96538.8986465558,33474.53249302662
"145.95.31.210",11722,"244.3.160.239",80,10,1572,5,1167,5,405,212.949157,0.09018499999999108,103520.54110995092,35926.15179908322
"145.95.31.210",4790,"244.3.160.239",80,10,1579,5,1174,5,405,212.951512,0.08982799999998292,104555.37248966676,36068.93173621383
"145.95.31.210",5728,"244.3.160.239",80,10,1578,5,1173,5,405,212.95545,0.08733099999997762,107453.25256784423,37100.22786869302
"145.95.43.224",1863,"41.177.98.176",80,63,48189,26,8426,37,39763,73.598648,21.617759000000007,3118.177050636931,14714.93876862999
"145.95.43.224",1864,"41.177.98.176",80,124,111613,47,9737,77,101876,75.585148,19.631250999999992,3967.959046522304,41515.84634112214
"145.95.43.224",1865,"41.177.98.176",80,47,33145,20,7037,27,26108,75.585687,19.630724,2867.7495542191923,10639.648339001658
"145.95.48.20",49174,"244.3.31.46",993,61,8529,39,3705,22,4824,164.69457,46.915277,631.7771501167946,822.5891962654297
"145.95.48.20",49175,"244.3.31.46",993,1551,189068,1034,109781,517,79287,203.648916,2.386946999999992,367937.7883128544,265735.26768713427
"145.95.48.20",49183,"244.3.31.46",993,1524,185824,1016,107916,508,77908,203.655277,2.376152999999988,363330.1390945804,262299.6078114512
"145.95.48.20",49184,"244.3.31.46",993,9,884,6,531,3,353,206.008961,0.005963000000008378,712393.0907251437,473587.1205762254
"145.95.48.20",49191,"244.3.31.46",993,9,884,6,531,3,353,206.018104,0.005330000000014934,796998.123825159,529831.1444638063
"145.95.48.71",2025,"244.3.41.84",923,4,325,2,151,2,174,83.434791,0.1843059999999923,6554.317276703148,7552.656994346674
"145.95.67.128",4144,"244.3.41.197",923,2,174,0,0,2,174,27.537659,0.07212399999999874,0,19300.094282070106
"145.95.75.108",1244,"244.3.41.84",23,4,838,2,201,2,637,64.496046,0.15937499999999716,10089.411764706063,31974.901960784882
"145.95.108.55",58171,"41.177.98.176",80,55,47310,22,5876,33,41434,2.669512,20.977906,2240.8337610055073,15801.005114619162
"145.95.108.55",58172,"41.177.98.176",80,21,12823,10,3992,11,8831,2.964158,15.668723000000002,2038.2005604413325,4508.854997308969
"145.95.122.244",1128,"244.3.41.84",23,4,256,2,128,2,128,139.533688,0.20100800000000163,5094.324603995819,5094.324603995819
"145.95.149.185",20332,"41.177.98.176",80,4,256,2,128,2,128,6.123857,1.304303,785.0936477183599,785.0936477183599
"145.95.149.185",20336,"41.177.98.176",80,39,25295,16,3565,23,21730,7.42914,32.59088,875.0914366227607,5334.007550578567
"145.95.209.239",61422,"41.177.98.176",80,65,50908,25,4720,40,46188,97.28151,49.634883,760.7552938122167,7444.441845465819
"145.95.209.239",61423,"41.177.98.176",80,11,1934,6,1404,5,530,99.971371,46.945291999999995,239.25721880694664,90.31789598837729
"145.95.209.239",61424,"41.177.98.176",80,11,1918,6,1388,5,530,99.980437,46.93659099999999,236.57448833469823,90.334638917428
"145.95.209.239",5941,"244.3.160.239",80,9,2251,5,1421,4,830,112.684328,0.05839900000000853,194660.86748057912,113700.57706465916
"145.95.209.239",12042,"244.3.160.239",80,11,2624,6,1525,5,1099,113.185637,0.030719000000004826,397148.34467261576,286207.23330833093
"145.95.209.239",8775,"244.3.160.239",80,11,2570,6,1552,5,1018,113.218988,0.3051110000000108,40693.386996862,26691.92523376644
"145.95.209.239",13844,"244.3.160.239",80,9,2310,5,1438,4,872,113.635161,0.17242099999999994,66720.4110868166,40459.10880925179
"145.95.209.239",16176,"244.3.160.239",80,11,2510,6,1530,5,980,113.83484,1.0148949999999957,12060.360924036528,7724.93706245477
"145.95.209.239",7625,"244.3.160.239",80,93,69073,31,3298,62,65775,114.852839,0.526139999999998,50146.34888052628,1000114.0380887253
"145.95.209.239",6653,"244.3.160.239",80,13,2010,7,1493,6,517,115.041483,0.22735400000000539,52534.81355067303,18191.894578498297
"145.95.209.239",11293,"244.3.160.239",80,13,2009,7,1492,6,517,115.041765,0.2275860000000023,52446.108284340335,18173.349854560292
"145.95.209.239",2380,"244.3.160.239",80,13,2132,7,1498,6,634,115.041994,0.22869599999999934,52401.44121453823,22177.913037394683
"145.95.209.239",7307,"244.3.160.239",80,13,2016,7,1499,6,517,115.042429,0.23056300000000363,52011.8145582761,17938.697883007833
"145.95.209.239",10536,"244.3.160.239",80,13,2132,7,1498,6,634,115.06989,0.3105499999999921,38589.599098374834,16332.313637095891
"145.95.209.239",6290,"244.3.160.239",80,11,1867,6,1420,5,447,115.261488,0.20172499999999616,56314.289255175194,17727.103730326275
"145.95.209.239",4925,"244.3.160.239",80,11,1866,6,1419,5,447,115.33944,0.12914899999999818,87898.47385578022,27688.948423913855
"145.95.209.239",7345,"244.3.160.239",80,11,1862,6,1415,5,447,115.376022,0.10644599999999116,106345.00122128535,33594.49861902089
"145.95.209.239",15560,"244.3.160.239",80,13,2006,7,1489,6,517,115.474973,0.14009999999998968,85024.98215560941,29521.770164170626
"145.95.209.239",8113,"244.3.160.239",80,11,1876,6,1429,5,447,115.608693,0.36994299999999214,30902.057884593687,9666.354005887599
"145.95.209.239",15248,"244.3.160.239",80,11,1869,6,1422,5,447,115.993512,0.4339780000000104,26213.310352137036,8240.049034743499
"145.95.209.239",11313,"244.3.160.239",80,13,2002,7,1485,6,517,116.502012,0.10083300000000861,117818.57130105208,41018.31741592184
"145.95.209.239",4831,"244.3.160.239",80,11,1859,6,1412,5,447,116.502284,0.1754669999999976,64376.77739973986,20379.900494110283
"145.95.209.239",8098,"244.3.160.239",80,13,2000,7,1483,6,517,116.502639,0.1926339999999982,61588.296977688835,21470.76840017878
"145.95.209.239",9603,"244.3.160.239",80,13,2010,7,1493,6,517,116.503088,0.19564799999999138,61048.41347726798,21140.006542362724
"145.95.209.239",15725,"244.3.160.239",80,13,2005,7,1488,6,517,116.503403,0.19895400000000052,59832.92620404701,20788.72503191687
"145.95.209.239",11778,"244.3.160.239",80,13,1992,7,1475,6,517,116.503627,0.21902400000000455,53875.374388193784,18883.77529403131
"145.95.209.239",12272,"244.3.160.239",80,13,2052,7,1470,6,582,116.573298,0.015810000000001878,743833.0170777105,294497.15370015474
"145.95.209.239",12422,"244.3.160.239",80,13,1998,7,1481,6,517,116.601325,0.39992599999999356,29625.480713932553,10341.913253952147
"145.95.209.239",3277,"244.3.160.239",80,13,1998,7,1481,6,517,116.67784,0.33396600000000376,35476.66528928054,12384.494229951413
"145.95.209.239",16194,"244.3.160.239",80,11,1859,6,1412,5,447,116.681505,0.3034409999999923,37226.34713173331,11784.828022581294
"145.95.209.239",9726,"244.3.160.239",80,11,1858,6,1411,5,447,116.688395,0.3071740000000034,36747.90184065017,11641.61029253765
"145.95.209.239",4142,"244.3.160.239",80,13,2006,7,1489,6,517,116.688658,0.3422029999999978,34809.74743061889,12086.393164291449
"145.95.209.239",9137,"244.3.160.239",80,13,2001,7,1484,6,517,116.689984,0.3448190000000011,34429.65729846662,11994.698667996796
"145.95.209.239",5613,"244.3.160.239",80,11,1859,6,1412,5,447,116.915336,0.17658200000001045,63970.28009649529,20251.214733097306
"145.95.209.239",9196,"244.3.160.239",80,16,8610,9,7036,7,1574,161.094813,0.18744900000001508,300284.34400821273,67175.60509791457
"145.95.209.239",6264,"244.3.160.239",80,348,277458,104,8638,244,268820,161.281915,5.431678000000005,12722.403647638894,395929.2137715082
"145.95.209.239",12397,"244.3.160.239",80,12,2191,6,1674,6,517,164.314898,0.28610100000000216,46808.644499669346,14456.433217639815
"145.95.209.239",15681,"244.3.160.239",80,12,2192,6,1675,6,517,164.315195,0.2862230000000068,46816.642967195796,14450.271291964315
"145.95.209.239",8440,"244.3.160.239",80,13,2256,7,1739,6,517,164.315315,1.1584450000000004,12009.201990599464,3570.303294502543
"145.95.209.239",7860,"244.3.160.239",80,13,2255,7,1738,6,517,164.315755,1.1878220000000113,11705.457551720601,3482.003195764989
"145.95.209.239",14897,"244.3.160.239",80,13,2507,7,1761,6,746,164.42007,1.1878480000000025,11860.103312881758,5024.211852021461
"145.95.209.239",7811,"244.3.160.239",80,11,2121,6,1674,5,447,165.503321,0.665694000000002,20117.35121542324,5371.837510928429
"145.95.209.239",9523,"244.3.160.239",80,11,2104,6,1657,5,447,165.604266,0.8610820000000103,15394.584952420142,4152.914588854438
"145.95.209.239",2779,"244.3.160.239",80,13,2238,7,1721,6,517,165.625187,1.1311019999999985,12172.200208292461,3656.610986453923
"145.95.209.239",6138,"244.3.160.239",80,13,2236,7,1719,6,517,165.627759,1.1376109999999926,12088.490705522441,3635.6891767045386
"145.95.209.239",5229,"244.3.160.239",80,13,2253,7,1736,6,517,165.746115,1.0399260000000083,13354.796398974435,3977.206070431903
"145.95.209.239",2868,"244.3.160.239",80,13,2417,7,1783,6,634,165.775557,1.0421750000000145,13686.760860699787,4866.74502842606
"145.95.209.239",4020,"244.3.160.239",80,13,2265,7,1748,6,517,166.189209,0.6483929999999987,21567.166826292123,6378.847396563517
"145.95.209.239",4629,"244.3.160.239",80,11,2466,6,1721,5,745,166.469629,0.3785170000000164,36373.531439801656,15745.660036404552
"145.95.209.239",5241,"244.3.160.239",80,11,2466,6,1721,5,745,166.496784,0.3552190000000053,38759.18799388489,16778.381787010017
"145.95.209.239",7421,"244.3.160.239",80,11,2466,6,1721,5,745,166.517847,0.3576750000000004,38493.04536240997,16663.171873907857
"145.95.209.239",11478,"244.3.160.239",80,11,2466,6,1721,5,745,166.666952,0.24931300000000078,55223.754878405685,23905.69284393506
"145.95.209.239",9006,"244.3.160.239",80,13,2606,7,1791,6,815,166.698424,0.3684379999999976,38888.49684343117,17696.328826016976
"145.95.209.239",6472,"244.3.160.239",80,11,2119,6,1672,5,447,166.827833,0.2038310000000081,65622.99159597642,17543.945719737716
"145.95.209.239",5211,"244.3.160.239",80,11,2466,6,1721,5,745,166.848224,0.19238500000000158,71564.83093796235,30979.546222418332
"145.95.209.239",4245,"244.3.160.239",80,11,2466,6,1721,5,745,166.861319,0.19018599999998287,72392.28965329331,31337.743051541842
"145.95.209.239",15620,"244.3.160.239",80,13,2606,7,1791,6,815,166.875752,0.21050800000000436,68063.92156117441,30972.694624431686
"145.95.209.239",12252,"244.3.160.239",80,13,2606,7,1791,6,815,167.027317,0.2708669999999813,52896.809135114236,24070.85396153998
"145.95.209.239",7118,"244.3.160.239",80,13,2252,7,1735,6,517,167.034096,0.21655300000000466,64095.16377053055,19099.250529892965
"145.95.209.239",6818,"244.3.160.239",80,13,2606,7,1791,6,815,167.037193,0.2606879999999876,54962.253728597716,25010.740808937542
"145.95.209.239",9814,"244.3.160.239",80,11,2466,6,1721,5,745,167.050947,0.20841400000000476,66060.82125001049,28596.927269760494
"145.95.209.239",6752,"244.3.160.239",80,13,2606,7,1791,6,815,167.051802,0.25041500000000383,57217.01974721874,26036.778946947667
"145.95.209.239",13384,"244.3.160.239",80,15,4150,8,1785,7,2365,167.063268,0.24224300000000198,58949.071799803845,78103.39204847961
"145.95.209.239",13261,"244.3.160.239",80,13,2262,7,1745,6,517,167.163701,0.348858000000007,40016.28169627677,11855.826726060222
"145.95.209.239",5539,"244.3.160.239",80,15,4124,8,1785,7,2339,167.255701,0.48600600000000327,29382.353304279997,38501.58228499211
"145.95.209.239",14802,"244.3.160.239",80,15,4088,8,1785,7,2303,167.256303,0.48994500000000585,29146.128647092693,37604.22088193528
"145.95.209.239",13820,"244.3.160.239",80,15,3946,8,1785,7,2161,167.259606,0.4868210000000204,29333.163524168845,35512.02598080049
"145.95.209.239",15468,"244.3.160.239",80,13,2248,7,1731,6,517,167.260489,0.25558699999999135,54181.159448643586,16182.356692633584
"145.95.209.239",7755,"244.3.160.239",80,13,2298,7,1716,6,582,167.262433,0.22802100000001246,60204.98112015669,20419.171918374825
"145.95.209.239",16163,"244.3.160.239",80,13,2255,7,1738,6,517,167.262715,0.2646750000000111,52532.350996502944,15626.712005288851
"145.95.209.239",12971,"244.3.160.239",80,13,2262,7,1745,6,517,167.49022,0.27348700000001713,51044.47377754382,15123.205124922724
"145.95.209.239",12409,"244.3.160.239",80,13,2274,7,1757,6,517,167.491491,0.28011699999998996,50179.03233291983,14765.258802572313
"145.95.209.239",9673,"244.3.160.239",80,13,2275,7,1758,6,517,167.492719,1.1646929999999998,12075.285075122803,3551.1503889866262
"145.95.209.239",10628,"244.3.160.239",80,13,2258,7,1741,6,517,167.690578,0.23764400000001729,58608.675161161176,17404.184410293125
"145.95.209.239",5065,"244.3.160.239",80,13,2245,7,1728,6,517,168.874407,0.22545400000001337,61316.277378086794,18345.205673883607
"145.95.209.239",15353,"244.3.160.239",80,13,2280,7,1763,6,517,168.874696,0.22828000000001225,61783.7743122448,18118.10057823628
"145.95.209.239",9835,"244.3.160.239",80,13,2251,7,1734,6,517,168.874975,0.23605000000000587,58767.21033679159,17521.71150180003
"145.95.209.239",13364,"244.3.160.239",80,13,2256,7,1739,6,517,168.87531,0.2401129999999796,57939.38687201935,17225.22312411386
"145.95.209.239",10266,"244.3.160.239",80,13,2248,7,1731,6,517,168.875674,0.24211199999999167,57196.66931007334,17083.002907745762
"145.95.209.239",7580,"244.3.160.239",80,13,2238,7,1721,6,517,168.876117,0.2479940000000056,55517.47219690674,16677.82285055246
"145.95.209.239",12327,"244.3.160.239",80,13,2246,7,1729,6,517,169.072452,0.12925599999999804,107012.44042829896,31998.514575726178
"145.95.209.239",3954,"244.3.160.239",80,13,2243,7,1726,6,517,169.117155,0.11073899999999526,124689.5854215822,37349.082075873695
"145.95.209.239",13894,"244.3.160.239",80,11,2106,6,1659,5,447,169.117457,0.11033100000000218,120292.57416319745,32411.56157380908
"145.95.209.239",13057,"244.3.160.239",80,11,2104,6,1657,5,447,169.118097,0.15288699999999267,86704.55957668497,23389.823856836563
"145.95.209.239",15338,"244.3.160.239",80,13,2250,7,1733,6,517,169.143061,0.14840399999999931,93420.66251583559,27869.868736691864
"145.95.209.239",12929,"244.3.160.239",80,13,2245,7,1728,6,517,169.148813,0.15573700000001622,88765.03335751015,26557.593892264325
"145.95.209.239",2978,"244.3.160.239",80,11,2107,6,1660,5,447,169.202164,0.10133600000000342,131049.18291623463,35288.54503828727
"145.95.209.239",10429,"244.3.160.239",80,11,2097,6,1650,5,447,169.22392,0.1877460000000042,70307.75622383277,19047.01032245651
"145.95.209.239",15600,"244.3.160.239",80,13,2246,7,1729,6,517,169.271135,0.17544900000001462,78837.7249229055,23573.802073535076
"145.95.209.239",9897,"244.3.160.239",80,13,2246,7,1729,6,517,169.271261,0.1848619999999812,74823.38176586539,22373.44613820266
"145.95.209.239",6757,"244.3.160.239",80,11,2097,6,1650,5,447,169.281393,0.15156399999997916,87091.92156449959,23593.993296564433
"145.95.209.239",10005,"244.3.160.239",80,13,2246,7,1729,6,517,169.295779,0.16733099999999013,82662.50724612185,24717.476140107
"145.95.209.239",15226,"244.3.160.239",80,13,2246,7,1729,6,517,169.308381,0.16056600000001708,86145.26113871261,25758.87796918127
"145.95.209.239",15762,"244.3.160.239",80,13,2250,7,1733,6,517,169.417905,0.12130700000000161,114288.54064480876,34095.31189461404
"145.95.209.239",13115,"244.3.160.239",80,13,2246,7,1729,6,517,169.431543,0.11280600000000618,122617.59126286938,36664.71641579148
"145.95.209.239",7456,"244.3.160.239",80,13,2239,7,1722,6,517,169.431668,0.14653500000000008,94011.66956699759,28225.3386562937
"145.95.209.239",9171,"244.3.160.239",80,11,2105,6,1658,5,447,169.434743,0.20716899999999328,64025.0230488173,17261.269784572578
"145.95.209.239",12568,"244.3.160.239",80,11,2105,6,1658,5,447,169.439364,0.11206299999997782,118361.99280764058,31910.62170386932
"145.95.209.239",12966,"244.3.160.239",80,13,2246,7,1729,6,517,169.443215,0.26348600000000033,52496.14780291925,15697.228695262727
"145.95.209.239",14039,"244.3.160.239",80,13,2247,7,1730,6,517,169.541011,0.16709000000000174,82829.61278352897,24753.127057274265
"145.95.209.239",10108,"244.3.160.239",80,13,2244,7,1727,6,517,169.548551,0.16702100000000542,82720.13698875922,24763.353111284603
"145.95.209.239",11175,"244.3.160.239",80,13,2250,7,1733,6,517,169.580379,0.16673000000000116,83152.40208720628,24806.57350206904
"145.95.209.239",6070,"244.3.160.239",80,11,2109,6,1662,5,447,169.580596,0.16368199999999433,81230.67899952628,21847.24038073902
"145.95.209.239",9040,"244.3.160.239",80,13,2238,7,1721,6,517,169.642006,0.27089300000000094,50824.4952804242,15268.02095292232
"145.95.209.239",9978,"244.3.160.239",80,13,2244,7,1727,6,517,169.660225,0.25535999999999603,54104.01002506349,16196.741854636843
"145.95.209.239",5549,"244.3.160.239",80,13,2246,7,1729,6,517,169.6708,0.24478999999999473,56505.57620817966,16896.115037379343
"145.95.209.239",9079,"244.3.160.239",80,13,2242,7,1725,6,517,169.707099,0.21529599999999505,64097.8002378136,19210.76099881138
"145.95.209.239",5975,"244.3.160.239",80,13,2248,7,1731,6,517,169.751228,0.17404200000001424,79567.00106870104,23764.37871318223
"145.95.209.239",13319,"244.3.160.239",80,11,2110,6,1663,5,447,169.755399,0.18780399999999986,70839.8117186003,19041.127984494487
"145.95.209.239",8959,"244.3.160.239",80,11,2105,6,1658,5,447,169.911739,0.11469499999998334,115645.84332361417,31178.342560709007
"145.95.209.239",3481,"244.3.160.239",80,13,2250,7,1733,6,517,169.912837,0.12216200000000299,113488.64622386389,33856.68211063914
"145.95.209.239",15765,"244.3.160.239",80,33,24205,20,22551,13,1654,184.656624,0.41385300000001735,435922.90016018355,31972.7052842421
"145.95.209.239",15509,"244.3.160.239",80,101,73716,35,3863,66,69853,185.070606,1.8731789999999933,16498.156342773495,298329.2039895824
"145.95.209.239",15919,"244.3.160.239",80,13,2130,7,1613,6,517,185.755983,1.147672,11243.63058434814,3603.8171184798443
"145.95.209.239",5022,"244.3.160.239",80,13,2126,7,1609,6,517,185.760604,1.195685999999995,10765.368165220681,3459.1021388558684
"145.95.209.239",5726,"244.3.160.239",80,13,2090,7,1573,6,517,185.761096,1.1963099999999827,10519.012630505624,3457.2978575787715
"145.95.209.239",11467,"244.3.160.239",80,13,2096,7,1579,6,517,185.761101,1.1963090000000136,10559.144836325611,3457.3007475492977
"145.95.209.239",5455,"244.3.160.239",80,11,1957,6,1510,5,447,185.761105,0.49867000000000417,24224.437002426253,7171.075059658632
"145.95.209.239",4906,"244.3.160.239",80,13,2091,7,1574,6,517,185.76129,1.2044730000000072,10454.36468895519,3433.866927693668
"145.95.209.239",2098,"244.3.160.239",80,13,2342,7,1596,6,746,185.796433,1.1731759999999838,10883.277530396272,5087.045762954648
"145.95.209.239",5426,"244.3.160.239",80,13,2114,7,1597,6,517,186.117877,1.1014389999999992,11599.371367819742,3755.0876625941182
"145.95.209.239",15431,"244.3.160.239",80,11,2087,6,1523,5,564,186.138192,1.072023999999999,11365.417192152425,4208.860995649356
"145.95.209.239",7679,"244.3.160.239",80,13,2096,7,1579,6,517,187.225557,0.11866999999998029,106446.44813349708,34852.95356872577
"145.95.209.239",6741,"244.3.160.239",80,11,1954,6,1507,5,447,187.374717,0.3890039999999999,30991.969234249525,9192.707529999694
"145.95.209.239",4214,"244.3.160.239",80,13,2062,7,1545,6,517,188.211576,0.3088520000000017,40019.16775672469,13391.52733348004
"145.95.209.239",7509,"244.3.160.239",80,13,2090,7,1573,6,517,188.58878,0.5447639999999865,23099.91115418844,7592.278491236761
"145.95.209.239",11549,"244.3.160.239",80,13,2099,7,1582,6,517,188.589449,0.544226000000009,23255.044779190615,7599.783913300599
"145.95.209.239",5161,"244.3.160.239",80,13,2110,7,1593,6,517,188.595541,0.5716230000000166,22294.41432552509,7235.538108158488
"145.95.209.239",7831,"244.3.160.239",80,11,1947,6,1500,5,447,188.595816,0.47590099999999325,25215.328398133584,7514.167862643808
"145.95.209.239",11292,"244.3.160.239",80,13,2087,7,1570,6,517,188.596237,0.587775999999991,21368.684668989874,7036.694250871188
"145.95.209.239",3338,"244.3.160.239",80,11,1958,6,1511,5,447,188.596372,0.4780010000000061,25288.650023744398,7481.155897163299
"145.95.209.239",16340,"244.3.160.239",80,13,2133,7,1551,6,582,188.600204,0.5859560000000101,21175.651414098986,7945.989118636757
"145.95.209.239",9784,"244.3.160.239",80,13,2091,7,1574,6,517,189.045623,0.31890699999999583,39484.86549370244,12969.29825936732
"145.95.209.239",12337,"244.3.160.239",80,13,2088,7,1571,6,517,189.046213,0.3289570000000026,38205.60133999246,12573.071860455826
"145.95.209.239",9397,"244.3.160.239",80,13,2088,7,1571,6,517,189.071928,0.3120969999999943,40269.53158793654,13252.290153382044
"145.95.209.239",9652,"244.3.160.239",80,13,2243,7,1609,6,634,189.072049,0.3257810000000063,39511.20538030072,15568.740964021541
"145.95.209.239",2539,"244.3.160.239",80,13,2083,7,1566,6,517,189.100186,0.3117210000000057,40189.78509628729,13268.275156309406
"145.95.209.239",12474,"244.3.160.239",80,13,2073,7,1556,6,517,189.463213,0.34135499999999297,36466.43523604534,12116.41839141095
"145.95.209.239",9248,"244.3.160.239",80,11,1951,6,1504,5,447,189.463764,0.329150999999996,36554.651208716205,10864.31455471818
"145.95.209.239",11193,"244.3.160.239",80,13,2083,7,1566,6,517,189.464648,0.35353399999999624,35436.47852823246,11699.016219090792
"145.95.209.239",5064,"244.3.160.239",80,13,2086,7,1569,6,517,189.477303,0.35115999999999303,35744.39002164327,11778.106845882452
"145.95.209.239",15472,"244.3.160.239",80,13,2081,7,1564,6,517,189.478942,0.5197020000000236,24075.3354807167,7958.406933203666
"145.95.209.239",12619,"244.3.160.239",80,13,2080,7,1563,6,517,189.479049,0.5034499999999866,24836.62727182507,8215.314331115522
"145.95.209.239",4945,"244.3.160.239",80,13,2079,7,1562,6,517,189.78922,0.2125859999999875,58780.91689951706,19455.655593502128
"145.95.209.239",16086,"244.3.160.239",80,11,1940,6,1493,5,447,189.794054,0.18686600000000908,63917.45956995612,19136.70758725411
"145.95.209.239",6594,"244.3.160.239",80,11,1941,6,1494,5,447,189.794383,0.18785099999999488,63624.89419806296,19036.363926729682
"145.95.209.239",14544,"244.3.160.239",80,13,2082,7,1565,6,517,189.798957,0.28504200000000424,43923.35164642338,14510.142364984593
"145.95.209.239",3833,"244.3.160.239",80,13,2081,7,1564,6,517,189.911449,0.31954999999999245,39155.061805665144,12943.201376936622
"145.95.209.239",9083,"244.3.160.239",80,13,2072,7,1555,6,517,189.965733,0.3129979999999932,39744.662905195146,13214.141943399285
"145.95.209.239",11650,"244.3.160.239",80,13,2072,7,1555,6,517,189.965908,0.3147679999999866,39521.171148275964,13139.836323896254
"145.95.209.239",2574,"244.3.160.239",80,13,2080,7,1563,6,517,189.98135,0.3001340000000141,41661.39124524183,13780.51137158671
"145.95.209.239",6849,"244.3.160.239",80,13,2079,7,1562,6,517,189.986221,0.32375200000001314,38597.44495786742,12775.210655068793
"145.95.209.239",5365,"244.3.160.239",80,13,2078,7,1561,6,517,189.995492,0.32109599999998295,38891.795600071826,12880.882975808541
"145.95.209.239",8561,"244.3.160.239",80,13,2084,7,1567,6,517,190.171701,0.22919799999999668,54695.067147183574,18045.53268353153
"145.95.209.239",4282,"244.3.160.239",80,13,2079,7,1562,6,517,190.230059,0.20838399999999524,59966.21621621759,19847.972972973428
"145.95.209.239",8443,"244.3.160.239",80,13,2081,7,1564,6,517,190.230306,0.21253199999998174,58871.13469972087,19460.598874524097
"145.95.209.239",2525,"244.3.160.239",80,13,2073,7,1556,6,517,190.230537,0.2133320000000083,58350.364689777045,19387.621172631574
"145.95.209.239",2757,"244.3.160.239",80,13,2081,7,1564,6,517,190.265852,0.2503900000000101,49970.0467271037,16518.231558767653
"145.95.209.239",8352,"244.3.160.239",80,13,2080,7,1563,6,517,190.266039,0.25614699999999857,48815.71909879901,16146.978102417843
"145.95.209.239",16274,"244.3.160.239",80,13,2080,7,1563,6,517,190.372603,0.27072100000000887,46187.7726515475,15277.72134411392
"145.95.209.239",3265,"244.3.160.239",80,11,1942,6,1495,5,447,190.387765,0.2464610000000107,48526.94746836003,14509.394995556477
"145.95.209.239",2099,"244.3.160.239",80,13,2084,7,1567,6,517,190.43877,0.2619669999999985,47853.35557532083,15788.248138124358
"145.95.209.239",5990,"244.3.160.239",80,11,1942,6,1495,5,447,190.439135,0.20387600000000816,58663.108948574234,17540.073377934907
"145.95.209.239",9336,"244.3.160.239",80,13,2083,7,1566,6,517,190.52222,0.26902200000000676,46568.68211521617,15374.207313899593
"145.95.209.239",7601,"244.3.160.239",80,13,2083,7,1566,6,517,190.522465,0.2689619999999877,46579.07064938754,15377.636989612618
"145.95.209.239",3303,"244.3.160.239",80,13,2083,7,1566,6,517,190.61725,0.18131299999998873,69095.98318929574,22811.381423286013
"145.95.209.239",15114,"244.3.160.239",80,13,2089,7,1572,6,517,190.635853,0.1655979999999886,75942.94617085271,24976.147054917845
"145.95.209.239",10844,"244.3.160.239",80,13,2080,7,1563,6,517,190.643881,0.1595360000000028,78377.29415304246,25925.183030788838
"145.164.84.224",2598,"244.3.210.197",80,1,64,1,64,0,0,40.405173,0,0,0
"145.202.83.94",1958,"41.177.98.176",80,40,28129,16,4591,24,23538,7.371396,17.063216,2152.4664518107256,11035.668774280299
"145.202.83.94",1957,"41.177.98.176",80,4,256,2,128,2,128,7.753717,0.6593029999999995,1553.1553777246588,1553.1553777246588
"145.202.83.94",1959,"41.177.98.176",80,10,2172,6,1366,4,806,8.423275,15.994229999999998,683.2463957314608,403.14538430421476
"145.202.83.94",1960,"41.177.98.176",80,11,3210,6,1366,5,1844,8.428707,15.992857,683.3050529995985,922.4117992176132
"145.202.83.94",1961,"41.177.98.176",80,11,3877,6,1365,5,2512,8.432326,15.994153,682.7495022712362,1256.4591572932934
"145.202.83.94",1962,"41.177.98.176",80,25,14310,11,1685,14,12625,8.435777,15.99883,842.5616123179008,6312.9616353195825
"145.202.83.94",1963,"41.177.98.176",80,17,7465,8,1493,9,5972,8.439817,15.989777000000002,746.9772717905946,2987.9090871623785
"145.202.252.117",4603,"244.3.210.197",80,38,30278,16,2165,22,28113,137.100659,28.39585599999998,609.9481558154124,7920.310625606784
"145.202.252.117",4604,"244.3.210.197",80,56,44161,24,3745,32,40416,137.101842,28.393460000000005,1055.1725643863058,11387.411044656057
"145.202.252.117",4610,"244.3.210.197",80,17,9950,8,1333,9,8617,148.696603,0.7745850000000019,13767.372205761762,88997.3340563009
"145.202.252.117",4611,"244.3.210.197",80,29,23696,12,1485,17,22211,148.697593,0.473764999999986,25075.723196100073,375055.1433727803
"145.223.153.12",1064,"244.3.210.197",80,12,768,6,384,6,384,95.73146,9.279513000000009,331.051855846314,331.051855846314
"145.223.153.12",1066,"244.3.210.197",80,12,768,6,384,6,384,95.731465,18.60651,165.103504096147,165.103504096147
"145.223.153.12",1063,"244.3.210.197",80,12,768,6,384,6,384,95.731469,37.264568,82.43755837985296,82.43755837985296
"145.223.153.12",1061,"244.3.210.197",80,12,768,6,384,6,384,95.731473,15.493311000000006,198.27911541955098,198.27911541955098
"145.223.153.12",1062,"244.3.210.197",80,12,768,6,384,6,384,95.731477,9.279461999999995,331.05367531005584,331.05367531005584
"145.223.153.12",1065,"244.3.210.197",80,12,768,6,384,6,384,95.734589,9.276387999999997,331.1633795395364,331.1633795395364
"145.251.89.40",35779,"41.177.26.91",8000,7,490,0,0,7,490,9.962705,187.182526,0,20.942125762316085
"149.214.94.116",57447,"41.177.26.176",80,26,13696,13,1484,13,12212,31.02779,1.7685720000000025,6712.760351289053,55240.04677219806
"149.214.94.192",57288,"41.177.26.176",80,28,12950,14,1552,14,11398,99.123471,2.495153000000002,4976.047561011284,36544.45238428262
"151.43.204.39",34336,"41.177.26.46",80,7,953,4,377,3,576,200.294841,0.060423000000014326,49914.767555389255,76262.35042945413
"151.43.219.4",56633,"41.177.26.91",80,46,27957,23,2480,23,25477,11.038284,9.467129,2095.6722993845337,21528.807730411194
"151.43.219.4",45667,"41.177.26.91",80,31,16675,16,1686,15,14989,34.786208,9.740749000000001,1384.6984456739413,12310.34697639781
"151.43.219.4",37919,"41.177.26.91",80,23,9351,12,1456,11,7895,100.117401,9.467555000000004,1230.30708562031,6671.204973195294
"151.43.219.67",16208,"244.3.160.239",80,10,1558,5,643,5,915,25.790119,0.08800399999999797,58451.88855052178,83178.03736194
"151.43.219.121",3056,"244.3.160.239",80,10,1797,5,695,5,1102,27.734311,0.09400899999999979,59143.27351636559,93778.25527343148
"151.43.219.121",12852,"244.3.160.239",80,10,1692,5,660,5,1032,28.251391,0.09306099999999873,56736.97897078338,88716.00348158856
"151.43.219.121",3233,"244.3.160.239",80,10,1643,5,643,5,1000,28.788199,0.08936800000000034,57559.75293169793,89517.50067138091
"151.43.219.139",7884,"244.3.160.239",80,10,1656,5,675,5,981,170.707371,0.08758900000000835,61651.577252845505,89600.29227413547
"151.48.254.143",3011,"244.3.61.244",445,3,210,3,210,0,0,175.37588,8.950806,187.69259438758922,0
"151.77.15.13",49197,"41.177.241.46",443,43,3442,21,1845,22,1597,19.511434,193.44554,76.30054432891035,66.04442780123026
"151.77.15.40",2382,"41.177.241.46",443,42,3255,21,1722,21,1533,6.893984,192.67912900000002,71.49710542858017,63.64986214983357
"151.77.15.90",1211,"41.177.241.46",443,42,3255,21,1722,21,1533,19.96476,191.172167,72.0606990870172,64.15159796771043
"151.77.15.118",1678,"41.177.241.46",443,44,3488,22,1891,22,1597,16.42046,190.682027,79.33626591875908,67.00159527882509
"151.77.15.128",3055,"41.177.241.46",443,42,3255,21,1722,21,1533,2.850901,201.844578,68.25053284314627,60.75962070182534
"151.77.15.128",1820,"41.177.241.46",443,24,4485,10,2788,14,1697,7.873831,179.999247,123.91162947476109,75.42253773983843
"151.77.15.128",1123,"41.177.241.46",443,44,3506,22,1909,22,1597,8.877385,201.710698,75.7123947883022,63.33823702300609
"151.77.15.128",1864,"41.177.241.46",443,24,7275,9,3368,15,3907,187.879971,0.1600210000000004,168377.900400572,195324.36367726687
"151.77.15.152",49420,"41.177.241.46",443,42,3255,21,1722,21,1533,2.487329,195.06380900000002,70.6230441752524,62.871734448700316
"151.77.15.154",4155,"41.177.241.46",443,26,2050,12,1031,14,1019,0.489066,88.999458,92.67472168201293,91.59606342771211
"151.77.15.155",3876,"41.177.241.46",443,44,3488,22,1891,22,1597,14.320573,194.159256,77.91542011265227,65.80165305124572
"151.77.15.210",1127,"41.177.241.46",443,42,3255,21,1722,21,1533,2.525599,203.34974,67.7453533995175,60.30988778249729
"151.77.15.248",49363,"41.177.241.46",443,42,3255,21,1722,21,1533,18.488696,193.626547,71.14726887114297,63.33842228772484
"151.77.39.25",3868,"244.3.160.239",80,31,18196,12,768,19,17428,0.003816,0.209368,29345.458713843567,665927.9355011272
"151.77.39.25",6885,"244.3.160.239",80,6,757,3,192,3,565,0.033813,0.008100999999999997,189606.22145414155,557955.8079249477
"151.77.39.25",3398,"244.3.160.239",80,6,460,3,192,3,268,0.033818,0.009898999999999998,155167.1886049096,216587.534094353
"151.77.39.25",12481,"244.3.160.239",80,10,4327,4,256,6,4071,0.034144,0.17092,11982.213901240348,190545.28434355254
"151.77.39.25",3492,"244.3.160.239",80,6,991,3,192,3,799,0.034432,0.118615,12949.45833157695,53888.63128609367
"151.77.39.25",3630,"244.3.160.239",80,12,1971,6,1251,6,720,0.040326,0.509588,19639.39496220476,11303.248899110653
"151.77.39.25",12172,"244.3.160.239",80,12,1991,6,1252,6,739,0.040567,0.5101129999999999,19634.865216138387,11589.588973423537
"151.77.39.25",9941,"244.3.160.239",80,12,1991,6,1252,6,739,0.043713,0.508039,19715.02187824163,11636.901891390227
"151.77.39.25",11904,"244.3.160.239",80,10,2406,4,256,6,2150,0.053579,0.263172,7781.982885717325,65356.4968917666
"151.77.39.25",3428,"244.3.160.239",80,7,1012,3,192,4,820,0.054973,0.09850300000000001,15593.433702526825,66596.95643787498
"151.77.39.25",3835,"244.3.160.239",80,12,1989,6,1251,6,738,0.153925,0.39881500000000003,25094.341988139862,14803.856424658048
"151.77.39.25",10686,"244.3.160.239",80,12,1988,6,1250,6,738,0.155165,0.39808200000000005,25120.4525700735,14831.115197371395
"151.77.39.25",7239,"244.3.160.239",80,12,2170,6,1254,6,916,0.155677,0.503795,19912.861382109786,14545.59890431624
"151.77.39.25",14314,"244.3.160.239",80,12,1989,6,1252,6,737,0.441697,0.437898,22872.906475937318,13464.322741825721
"151.77.39.25",13083,"244.3.160.239",80,12,2007,6,1259,6,748,0.442201,0.438127,22988.76809692167,13658.140219616687
"151.77.39.25",11620,"244.3.160.239",80,12,1980,6,1260,6,720,0.44262,0.438103,23008.288005332077,13147.593145904044
"151.77.39.25",5516,"244.3.160.239",80,12,2006,6,1259,6,747,0.55351,0.4415760000000001,22809.210645506093,13533.344203489318
"151.77.39.25",2053,"244.3.160.239",80,12,2616,6,1260,6,1356,0.55401,0.4461719999999999,22592.184180091986,24313.49345095614
"151.77.39.25",12984,"244.3.160.239",80,12,2008,6,1259,6,749,0.554528,0.44578299999999993,22593.95266306701,13441.517509640344
"151.77.39.25",14677,"244.3.160.239",80,15,3737,7,1338,8,2399,0.630894,0.462114,23163.115594853218,41530.87766222187
"151.77.39.25",13673,"244.3.160.239",80,172,114990,59,4681,113,110309,0.631434,1.5444109999999998,24247.431545100368,571397.1216211229
"151.77.39.25",14531,"244.3.160.239",80,72,43737,26,2549,46,41188,0.641821,0.9716039999999999,20987.97452460056,339134.0504979395
"151.77.39.25",5052,"244.3.160.239",80,12,2006,6,1259,6,747,0.772279,0.3217979999999999,31299.13796853928,18570.656125892645
"151.77.39.25",5736,"244.3.160.239",80,15,3650,7,1319,8,2331,0.77287,0.46540899999999996,22672.531042588347,40067.98321476379
"151.77.39.25",4823,"244.3.160.239",80,12,2219,6,1292,6,927,0.773528,0.32164400000000004,32134.906915720483,23056.546989839695
"151.77.39.25",11306,"244.3.160.239",80,12,1903,6,1153,6,750,2.132888,0.47675899999999993,19347.301257029234,12584.974798587968
"151.77.39.25",12812,"244.3.160.239",80,10,1955,5,1248,5,707,4.610774,0.7861820000000002,12699.34951448901,7194.262906044655
"151.77.39.25",15748,"244.3.160.239",80,2550,1729405,853,55568,1697,1673837,5.398257,10.792102999999997,41191.60093264493,1240786.5269632807
"151.77.75.15",10255,"244.3.160.239",80,11,2045,6,1090,5,955,19.437386,0.007918000000000092,1101288.2040919296,964890.1237686173
"151.77.75.15",6009,"244.3.160.239",80,11,2147,6,1066,5,1081,19.484855,0.0155789999999989,547403.556069106,555106.2327492529
"151.77.75.15",5656,"244.3.160.239",80,11,2273,6,1093,5,1180,19.532155,0.01304800000000128,670141.017780437,723482.5260575623
"151.77.75.15",3900,"244.3.160.239",80,1055,998797,380,27424,675,971373,19.572791,1.716546000000001,127810.14898522956,4527105.01204162
"151.77.75.108",5536,"244.3.160.239",80,11,2534,6,1402,5,1132,73.141934,0.011676999999991722,960520.6816826198,775541.6630989484
"151.77.75.108",8240,"244.3.160.239",80,11,2831,6,1385,5,1446,73.256118,0.9114500000000021,12156.454001865131,12691.86461133356
"151.77.75.108",3756,"244.3.160.239",80,16,5088,8,2250,8,2838,74.198953,0.09862300000000346,182513.20685843434,230209.99158410516
"151.77.75.108",7971,"244.3.160.239",80,15,3368,8,2250,7,1118,74.30121,3.9971780000000052,4503.176991367403,2237.578611710559
"151.77.75.108",9618,"244.3.160.239",80,18,8451,8,1807,10,6644,78.192856,0.25602099999998984,56464.11817780797,207607.96965874717
"151.77.75.108",7815,"244.3.160.239",80,11,2208,6,1569,5,639,78.4151,0.0915379999999999,137123.38045401924,55845.65972601549
"151.77.75.108",12839,"244.3.160.239",80,11,2963,6,1579,5,1384,78.416721,0.09234299999999962,136794.34283053456,119900.80460890426
"151.77.75.108",3012,"244.3.160.239",80,14,4888,7,1645,7,3243,78.416862,0.09670100000001014,136089.59576424878,268290.9173638047
"151.77.75.108",8202,"244.3.160.239",80,14,5219,7,1641,7,3578,78.417261,0.09799200000000496,133970.12000978994,292105.47799818916
"151.77.75.108",7462,"244.3.160.239",80,17,6574,8,1708,9,4866,78.50846,0.1009379999999993,135370.227268225,385662.4858824255
"151.77.75.108",2309,"244.3.160.239",80,186,150289,45,4294,141,145995,78.510585,0.4332779999999872,79283.97010695447,2695636.519740293
"151.77.75.108",4785,"244.3.160.239",80,35,21568,12,1991,23,19577,78.514795,0.20728299999998967,76841.80564735552,755566.0618574983
"151.77.75.108",16098,"244.3.160.239",80,86,64666,23,2751,63,61915,78.51724,0.2948590000000024,74639.06477333173,1679853.76061099
"151.77.75.108",14009,"244.3.160.239",80,36,23727,12,1984,24,21743,78.611072,0.21643400000000668,73334.1341933315,803681.4918173421
"151.77.75.108",2546,"244.3.160.239",80,14,4891,7,1636,7,3255,78.727287,0.09481300000000203,138040.14217459335,274645.88189382723
"151.77.75.108",12706,"244.3.160.239",80,257,211256,60,5351,197,205905,78.813278,0.5215090000000089,82084.87293603613,3158603.207231269
"151.77.75.108",11145,"244.3.160.239",80,20,11111,8,1700,12,9411,78.823675,0.13652700000000095,99613.99576640448,551451.3612691957
"151.77.75.108",6295,"244.3.160.239",80,18,8088,8,1704,10,6384,78.827779,0.13205099999998993,103232.8418565633,386759.6610400822
"151.77.75.108",7116,"244.3.160.239",80,19,9410,8,1701,11,7709,79.004429,0.13904899999999998,97864.78147990997,443527.1019568642
"151.77.75.108",15093,"244.3.160.239",80,18,8671,8,1704,10,6967,79.005009,0.14004799999999307,97338.05552382523,397977.8361704755
"151.77.75.108",2376,"244.3.160.239",80,19,7675,9,1764,10,5911,79.005748,0.13712400000000002,102914.15069572064,344855.7509990957
"151.77.75.108",10058,"244.3.160.239",80,324,267205,74,6311,250,260894,79.143336,0.6078279999999978,83062.97176174869,3433787.189797126
"151.77.75.108",9893,"244.3.160.239",80,16,6255,8,1698,8,4557,79.779363,0.2989740000000012,45435.389030484075,121937.02462421433
"151.77.75.108",9130,"244.3.160.239",80,957,852788,257,19271,700,833517,79.782695,2.076100999999994,74258.42962360715,3211855.299910755
"151.77.75.108",6931,"244.3.160.239",80,13,2428,7,1740,6,688,80.134457,0.2844879999999961,48930.00759258806,19347.037484885393
"151.77.75.108",3845,"244.3.160.239",80,13,2413,7,1623,6,790,80.152878,0.12562400000000196,103356.04661529484,50308.85817996483
"151.77.75.108",2964,"244.3.160.239",80,14,4887,7,1620,7,3267,80.153384,0.1253189999999904,103416.08215833985,208555.76568598536
"151.77.75.108",9520,"244.3.160.239",80,13,2620,7,1608,6,1012,81.868201,0.23003699999999583,55921.43872507568,35194.338302099866
"151.77.90.127",12063,"244.3.160.239",80,11,1904,6,1037,5,867,106.220249,0.0055669999999992115,1490210.167056076,1245913.4183583586
"151.77.90.127",4887,"244.3.160.239",80,11,2047,6,1054,5,993,106.252675,0.011648000000008096,723901.0989005957,682005.4945050204
"151.77.90.127",10477,"244.3.160.239",80,11,2018,6,1106,5,912,106.265914,0.010355000000004111,854466.4413323503,704587.1559630231
"151.77.90.127",12275,"244.3.160.239",80,22,10455,10,1342,12,9113,106.276623,0.1295599999999979,82865.08181537646,562704.5384377986
"151.77.90.127",2532,"244.3.160.239",80,22,10104,10,1422,12,8682,106.381404,0.12011400000000094,94710.02547579724,578250.6618712178
"151.77.90.127",7618,"244.3.160.239",80,11,2866,6,1123,5,1743,106.382554,0.08166099999999687,110015.79701449093,170754.70542854647
"151.77.90.127",14011,"244.3.160.239",80,26,12822,11,1479,15,11343,106.507536,0.15317799999999693,77243.46838318974,592408.8315554572
"151.77.90.127",14152,"244.3.160.239",80,15,2833,8,1504,7,1329,106.874309,0.18473800000001006,65130.07610778153,57551.776028751105
"151.77.90.127",10197,"244.3.160.239",80,18,5819,9,1561,9,4258,106.876338,0.18316000000000088,68180.82550775245,185979.4715003267
"151.77.90.127",5418,"244.3.160.239",80,15,2878,8,1499,7,1379,106.877417,0.1825370000000106,65696.26979735233,60437.062075082635
"151.77.90.127",11554,"244.3.160.239",80,27,17174,12,1777,15,15397,106.87917,0.2790870000000041,50937.52127472721,441353.4130934017
"151.77.90.127",12610,"244.3.160.239",80,15,3608,8,1498,7,2110,106.880628,0.18444399999999916,64973.65053891725,91518.29281516382
"151.77.90.127",12713,"244.3.160.239",80,19,7061,9,1563,10,5498,106.882655,0.1834740000000039,68151.34569475638,239728.7899102819
"151.77.90.127",14271,"244.3.160.239",80,23,10011,11,1706,12,8305,107.051129,0.24712999999999852,55225.9944158948,268846.35616881965
"151.77.90.127",10038,"244.3.160.239",80,23,10961,11,1703,12,9258,107.051486,0.14392000000000849,94663.70205669258,514619.23290714034
"151.77.90.127",8609,"244.3.160.239",80,24,10061,11,1709,13,8352,107.053152,0.14549000000000945,93972.09430200778,459248.058285763
"151.77.90.127",7321,"244.3.160.239",80,15,2954,8,1501,7,1453,107.056136,0.10904400000001147,110120.68522796979,106599.17097684217
"151.77.90.127",7274,"244.3.160.239",80,15,2819,8,1499,7,1320,107.057091,0.10855300000000057,110471.38264257954,97279.6698386958
"151.77.90.127",10888,"244.3.160.239",80,15,2780,8,1496,7,1284,107.065217,0.10160899999999629,117784.84189393102,101093.40708008519
"151.77.90.127",15463,"244.3.160.239",80,14,3193,8,1501,6,1692,107.162035,0.2467269999999928,48669.17686349832,54862.25666424994
"151.77.90.127",3878,"244.3.160.239",80,14,2354,8,1501,6,853,107.163433,0.2459699999999998,48818.961661991336,27743.22071797376
"151.77.90.127",13448,"244.3.160.239",80,14,2234,8,1516,6,718,107.163928,0.24602900000000716,49295.00180872843,23346.84122603365
"151.77.90.127",11180,"244.3.160.239",80,14,3242,8,1517,6,1725,107.185595,0.224575999999999,54039.6124251926,61449.13080649785
"151.77.90.127",14260,"244.3.160.239",80,14,3247,8,1518,6,1729,107.197273,0.21124400000000776,57488.02332847112,65478.78282933239
"151.77.90.127",4850,"244.3.160.239",80,14,3173,8,1414,6,1759,107.333223,0.29531399999999053,38304.99062015469,47650.97489452058
"151.77.90.127",13875,"244.3.160.239",80,31,16795,13,1863,18,14932,109.66148,0.44918099999999583,33180.38830671854,265941.7918389271
"151.77.90.127",2992,"244.3.160.239",80,19,9975,9,1580,10,8395,110.123152,0.16573499999999797,76266.32877786922,405225.20891785575
"151.77.90.127",14972,"244.3.160.239",80,15,3348,8,1529,7,1819,110.135045,0.15377399999999852,79545.30674886599,94632.38258743442
"151.77.90.127",2188,"244.3.160.239",80,15,3353,8,1530,7,1823,110.135887,0.15317699999999945,79907.55792318718,95210.11640128774
"151.77.90.127",13615,"244.3.160.239",80,13,3133,7,1374,6,1759,110.345794,0.10057299999999714,109293.74683066343,139918.268322516
"151.77.90.127",12271,"244.3.160.239",80,14,3203,8,1444,6,1759,110.453761,0.20496099999999728,56361.942027996316,68656.96400778776
"151.77.90.127",11938,"244.3.160.239",80,34,18739,14,1951,20,16788,113.16771,0.5407210000000049,28865.163365210265,248379.47851109682
"151.77.90.127",6270,"244.3.160.239",80,14,3290,8,1541,6,1749,113.738352,0.2016659999999888,61130.780597625206,69382.04754396268
"151.77.90.127",14488,"244.3.160.239",80,14,3295,8,1542,6,1753,113.738931,0.20172100000000626,61153.77179371318,69521.76521036266
"151.77.90.127",14642,"244.3.160.239",80,28,14865,12,1832,16,13033,120.614011,0.4434609999999992,33049.129461215365,235114.24905459597
"151.77.90.127",9248,"244.3.160.239",80,14,3299,8,1550,6,1749,121.073635,0.21416600000000585,57899.012915213716,65332.499089489545
"151.77.90.127",15061,"244.3.160.239",80,14,3304,8,1551,6,1753,121.074295,0.2137649999999951,58045.04947021395,65604.75288284014
"151.77.136.204",8694,"244.3.160.239",80,11,2108,6,1111,5,997,206.616924,0.011230999999980895,791380.9990219143,710177.1881411778
"151.77.136.204",16240,"244.3.160.239",80,11,2079,6,1163,5,916,206.628557,0.008969000000007554,1037350.8752360535,817036.4589133491
"151.77.136.204",10831,"244.3.160.239",80,11,1897,6,1119,5,778,206.641176,0.16810499999999706,53252.43151601771,37024.47874840195
"151.77.136.204",11773,"244.3.160.239",80,11,1981,6,1120,5,861,206.809477,0.22673000000000343,39518.36986724238,30379.74683544258
"151.77.136.204",9481,"244.3.160.239",80,11,1956,6,1133,5,823,207.036784,0.21228599999997755,42697.116154626114,31014.76310261014
"151.77.136.204",2642,"244.3.160.239",80,11,2026,6,1143,5,883,207.249716,0.16592299999999227,55109.90037547794,42573.96503197464
"151.77.136.204",6512,"244.3.160.239",443,38,16776,17,2331,21,14445,207.419371,1.3780829999999753,13531.84097039172,83855.61682424213
"151.77.136.204",13645,"244.3.160.239",443,21,6567,10,1734,11,4833,208.759862,0.47758300000000986,29046.260021817598,80957.65552793797
"151.77.136.204",2658,"244.3.160.239",443,29,12592,14,2061,15,10531,209.241515,0.7563260000000014,21800.12322728555,111391.11970235036
"151.77.136.204",15713,"244.3.160.239",443,23,6076,12,1921,11,4155,209.243793,0.7537820000000011,20387.85749726045,44097.63034935824
"151.77.136.204",12525,"244.3.160.239",443,20,3088,11,1835,9,1253,209.243907,0.6435989999999947,22809.233699866098,15574.915436475325
"151.77.136.204",15850,"244.3.160.239",443,20,3184,11,1851,9,1333,209.245126,0.6420669999999973,23063.013673027992,16608.858577064457
"151.77.136.204",6788,"244.3.160.239",443,20,3840,11,1739,9,2101,209.889537,0.6575330000000008,21157.873445135046,25562.215128366148
"151.77.142.180",2105,"244.3.31.168",443,18,8588,9,1534,9,7054,97.665102,0.02612099999998918,469813.55997109925,2160407.3350952636
"151.77.142.180",2106,"244.3.31.168",443,14,3537,8,1454,6,2083,97.714464,0.012305999999995265,945229.9691211178,1354136.1937271585
"151.77.142.180",2107,"244.3.31.168",443,14,4977,8,1454,6,3523,97.740731,0.01286300000001006,904299.152607549,2191090.725334522
"151.77.176.164",63041,"41.177.98.176",80,97,81385,32,4340,65,77045,1.6681780000000002,24.80679,1399.6167984652589,24846.423096257113
"151.77.176.164",63051,"41.177.98.176",80,11,2379,6,1505,5,874,5.371983,21.104513,570.4940928985189,331.3035463078442
"151.77.176.164",63054,"41.177.98.176",80,38,24641,14,2113,24,22528,140.68224,15.514578999999998,1089.5558300357363,11616.428650754882
"151.77.176.164",63064,"41.177.98.176",80,66,46892,25,3913,41,42979,156.200721,20.638544000000024,1516.773663878613,16659.702351096064
"151.77.176.164",63074,"41.177.98.176",80,11,2348,6,1495,5,853,158.769622,18.071000999999995,661.8338408591756,377.621582777844
"151.77.185.176",50299,"244.3.210.197",80,1,64,0,0,1,64,93.509244,0,0,0
"151.77.185.176",50297,"244.3.210.197",80,1,64,0,0,1,64,93.509266,0,0,0
"151.77.192.83",7406,"244.3.160.239",80,8,512,4,256,4,256,3.5980280000000002,180.066588,11.373570314999249,11.373570314999249
"151.77.210.188",4903,"244.3.160.239",80,50,29958,19,2918,31,27040,165.229652,0.525447000000014,44426.935542498824,411687.57267620566
"151.77.210.188",13997,"244.3.160.239",80,12,3278,6,1688,6,1590,165.686582,0.2886240000000271,46787.51593768617,44071.17911192003
"151.77.210.188",16025,"244.3.160.239",80,423,427642,143,10496,280,417146,165.691943,1.695180999999991,49533.35366547905,1968620.4599980875
"151.77.210.188",10710,"244.3.160.239",80,12,2709,6,2201,6,508,167.2896,0.2681560000000047,65663.27063351068,15155.357329315504
"151.77.217.75",7263,"244.3.160.239",80,49,29335,19,2590,30,26745,46.5791,0.936041000000003,22135.782513800074,228579.7310160552
"151.77.217.75",8607,"244.3.160.239",80,11,2201,6,1715,5,486,47.539034,0.33622299999999683,40806.250613432545,11563.753818150562
"151.77.217.75",5229,"244.3.160.239",80,52,30151,21,2730,31,27421,60.382322,0.8010749999999973,27263.36485347823,273842.0247792039
"151.77.217.75",13721,"244.3.160.239",80,11,2201,6,1715,5,486,61.22766,0.17247400000000113,79548.22176096056,22542.52814917016
"151.77.217.75",13708,"244.3.160.239",80,53,29726,22,2800,31,26926,67.920525,0.5055610000000001,44307.21515306757,426077.1697183919
"151.77.217.75",14615,"244.3.160.239",80,102,59581,42,3966,60,55615,68.373782,0.624966999999998,50767.48052297177,711909.5888262922
"151.77.217.75",15409,"244.3.160.239",80,11,2201,6,1715,5,486,68.935714,0.27457099999999457,49968.86051331084,14160.271842256017
"151.77.217.75",16361,"244.3.160.239",80,51,30246,20,2660,31,27586,73.18645,0.6278850000000062,33891.556574850154,351478.3758172242
"151.77.217.75",11388,"244.3.160.239",80,112,68954,46,4246,66,64708,73.760321,0.6481780000000015,52405.35778752121,798644.8167015832
"151.77.217.75",11796,"244.3.160.239",80,11,2201,6,1715,5,486,74.352065,0.6893090000000086,19903.99080818592,5640.431214448022
"151.77.217.75",13963,"244.3.160.239",80,49,29446,19,2590,30,26856,97.898166,0.47624700000000075,43506.83573859776,451127.2511952824
"151.77.217.75",4319,"244.3.160.239",80,11,2201,6,1715,5,486,98.409098,0.149162000000004,91980.53123449425,26065.61993000828
"151.77.241.157",16359,"244.3.160.239",80,12,3333,6,1277,6,2056,112.024678,0.07453999999999894,137053.93077542455,220660.04829621993
"151.77.241.157",4294,"244.3.160.239",80,14,3208,8,1330,6,1878,112.159972,0.23829400000001044,44650.72557428863,63048.16738986018
"151.81.72.15",63539,"41.177.98.176",80,22,12673,10,2159,12,10514,182.27617,2.2391350000000045,7713.693010917146,37564.50593644413
"151.81.72.15",63540,"41.177.98.176",80,5,330,1,66,4,264,184.528089,23.648184000000015,22.32729582956559,89.30918331826236
"151.81.72.15",63541,"41.177.98.176",80,5,330,1,66,4,264,185.297482,23.648438,22.327056019513847,89.30822407805539
"151.81.72.15",63542,"41.177.98.176",80,5,330,1,66,4,264,185.393338,23.632927999999993,22.34170899179315,89.3668359671726
"151.81.72.15",63543,"41.177.98.176",80,5,330,1,66,4,264,185.443809,23.64241100000001,22.332747704961214,89.33099081984486
"151.81.72.15",63544,"41.177.98.176",80,18,5656,10,4331,8,1325,185.447035,23.829970000000003,1453.9674200177337,444.8180169761019
"151.81.72.15",63545,"41.177.98.176",80,15,4318,8,3221,7,1097,185.476322,13.78610599999999,1869.1282367914494,636.5829480783049
"151.81.72.15",63546,"41.177.98.176",80,15,3496,8,2562,7,934,185.511534,18.618131999999974,1100.862320666758,401.32919886914596
"151.81.72.15",63547,"41.177.98.176",80,16,3569,9,2636,7,933,185.512501,18.61900300000002,1132.6062947623982,400.8807560748549
"151.81.72.15",63548,"41.177.98.176",80,43,26675,19,4522,24,22153,185.514619,23.36160799999999,1548.5235434136218,7586.121640256958
"151.81.72.15",63549,"41.177.98.176",80,16,4432,9,3334,7,1098,185.529086,23.64776999999998,1127.8864772450013,371.4515153014431
"151.83.41.143",62503,"41.177.26.176",80,18,8509,8,1386,10,7123,132.840644,0.49417700000000764,22437.304852309655,115310.91086796658
"151.83.41.143",62995,"41.177.26.176",80,38,25668,15,3292,23,22376,133.334632,19.677932,1338.3520178848064,9096.890872475828
"151.83.41.143",63083,"41.177.26.176",80,35,22811,14,2982,21,19829,133.334666,19.677954999999997,1212.3210973904556,8061.406787443107
"151.83.41.143",63061,"41.177.26.176",80,21,9310,10,2101,11,7209,133.334671,19.677959000000016,854.1536243672418,2930.7917553847915
"151.83.41.143",62673,"41.177.26.176",80,28,19498,12,1631,16,17867,134.570956,18.441611999999992,707.530339538648,7750.732419703877
"151.83.41.143",62589,"41.177.26.176",80,10,1833,6,1247,4,586,134.57105,18.441575999999998,540.9515976291832,254.20820866936756
"151.83.41.143",62651,"41.177.26.176",80,28,19397,12,1632,16,17765,134.761866,18.250706000000008,715.3695862505261,7787.096016997914
"151.117.159.151",50411,"244.3.210.197",80,532,387849,282,28404,250,359445,199.050433,9.59073699999999,23692.861142996648,299826.8016316163
"151.117.159.151",50412,"244.3.210.197",80,417,305015,220,24140,197,280875,199.829704,8.585898000000014,22492.696745290905,261708.21037007382
"151.121.225.30",47172,"41.177.26.91",80,25,13452,13,1041,12,12411,180.837376,0.6643119999999954,12536.278134370685,149459.892339745
"151.164.77.13",51762,"244.3.210.197",80,29,17103,14,1460,15,15643,192.066054,0.47254499999999666,24717.222698367525,264829.8045688789
"151.239.66.180",57459,"41.177.26.176",80,126,50293,57,8349,69,41944,81.413808,43.41126899999999,1538.5866743494648,7729.6058772205
"151.239.66.180",57460,"41.177.26.176",80,142,77230,57,6539,85,70691,82.088148,42.73564999999999,1224.083405774804,13233.167156694706
"151.239.66.180",57461,"41.177.26.176",80,46,20695,22,3516,24,17179,82.08908,42.734093,658.2098279235738,3215.9802713023532
"151.239.66.180",57462,"41.177.26.176",80,30,10246,16,2689,14,7557,82.090459,42.731921,503.41757394899236,1414.7737472415527
"151.239.66.180",57549,"41.177.26.176",80,37,16631,18,3025,19,13606,165.644345,24.627490000000023,982.6417552093201,4419.7764368191765
"151.239.66.180",57550,"41.177.26.176",80,32,16399,15,2261,17,14138,190.367951,18.736767999999984,965.3746046276506,6036.473312793332
"151.239.142.67",60635,"41.177.26.176",80,21,9151,9,1620,12,7531,55.137612,18.580008999999997,697.5238817160962,3242.624909385136
"151.239.142.67",60636,"41.177.26.176",80,62,56225,13,1443,49,54782,56.182033,15.776226999999999,731.7338930277816,27779.519146117764
"151.239.142.67",60637,"41.177.26.176",80,37,14261,12,1788,25,12473,56.184853,3.1388450000000034,4557.090267279838,31790.037418222273
"151.239.142.67",60638,"41.177.26.176",80,29,12962,9,1610,20,11352,56.186903,20.958670999999995,614.5427827938138,4333.099174084083
"151.239.142.67",60639,"41.177.26.176",80,18,5628,8,1607,10,4021,56.188775,17.538422000000004,733.0191963678373,1834.1444857467789
"151.239.142.67",60640,"41.177.26.176",80,15,2884,8,1602,7,1282,56.366055,17.373431999999994,737.6780822580135,590.3266550903704
"151.241.55.224",3799,"41.177.26.176",80,21,15894,8,884,13,15010,186.490876,11.285647000000012,626.6366474159605,10640.063436327566
"154.48.222.132",59178,"41.177.26.91",80,236,225049,87,7671,149,217378,89.108528,74.642784,822.1558295574827,23297.952016366376
"154.48.222.132",59178,"41.177.26.91",8000,5,350,0,0,5,350,119.574129,48.800544,0,57.37640957445064
"154.197.244.38",35353,"41.177.26.91",8000,4,256,0,0,4,256,6.642525,180.032419,0,11.375728945796146
"156.149.106.197",41850,"41.177.98.176",80,18,10168,9,1560,9,8608,7.592068,19.750508,631.8824811999773,3486.6951270316695
"156.225.203.83",57062,"244.3.210.197",80,22,7568,11,2291,11,5277,56.335263,62.011594,295.5576339482581,680.7759207092789
"156.225.203.83",57063,"244.3.210.197",80,31,23437,13,1167,18,22270,56.335386,62.011427,150.55289729101057,2873.0188711832097
"164.15.26.84",1483,"41.177.26.176",80,69,45461,31,3669,38,41792,85.865833,18.366989000000004,1598.0844764484802,18203.092515599586
"164.15.26.84",1485,"41.177.26.176",80,32,22255,14,2216,18,20039,88.557754,30.048942999999994,589.9708352470169,5335.029588228778
"164.223.95.211",3411,"41.177.26.15",80,2,2836,0,0,2,2836,56.825499,59.999957,0,378.1336043290831
"165.0.138.176",49961,"41.177.26.91",80,281,264678,87,14740,194,249938,189.853563,5.231374999999986,22540.918974457065,382213.85391030187
"165.0.138.176",49962,"41.177.26.91",80,224,214514,63,13007,161,201507,190.157363,4.706789999999984,22107.63598970856,342495.8411146462
"165.117.222.142",1498,"41.177.26.91",80,7,452,4,258,3,194,180.152465,0.18580599999998526,11108.360332821134,8352.798079718217
"165.138.142.31",4046,"244.3.210.197",80,73,66166,27,4199,46,61967,28.822043999999998,134.68723599999998,249.4074494185923,3680.645729488428
"165.151.186.57",49259,"41.177.26.13",80,30,18208,13,2127,17,16081,121.312338,61.62389,276.12667749471836,2087.631923268719
"165.188.210.111",34324,"41.177.98.127",210,24,7379,11,912,13,6467,156.831835,2.3834019999999896,3061.170545296191,21706.787189068495
"165.210.204.46",52205,"41.177.98.176",80,135,113452,50,6837,85,106615,174.900323,21.410369000000003,2554.650038960094,39836.772546984124
"165.210.204.46",52208,"41.177.98.176",80,57,40351,24,4891,33,35460,178.802943,33.513023000000004,1167.5461208020533,8464.769054107712
"165.210.204.46",52209,"41.177.98.176",80,103,87665,40,6423,63,81242,178.804729,17.638307999999995,2913.204599896998,36847.978842415054
"165.210.204.46",52211,"41.177.98.176",80,45,29080,21,4711,24,24369,178.806383,33.510913999999985,1124.6485249551838,5817.56737521394
"168.3.177.90",53158,"244.3.210.197",80,20,3764,11,1937,9,1827,95.754088,37.26371499999999,415.8468901986827,392.231424054204
"168.22.64.48",10218,"244.3.160.239",80,10,2048,5,1061,5,987,160.069256,0.0341980000000035,248201.64921922717,230890.69536227823
"168.22.64.48",11797,"244.3.160.239",80,10,2182,5,1078,5,1104,160.157485,0.042011999999999716,205274.68342378506,210225.64981434017
"168.22.64.48",2313,"244.3.160.239",80,10,2253,5,1140,5,1113,165.367217,0.03824999999997658,238431.3725491656,232784.31372563273
"168.22.64.48",15774,"244.3.160.239",80,10,2123,5,1091,5,1032,165.423249,0.044162000000000035,197635.976631493,186948.0548888183
"168.22.64.48",5529,"244.3.160.239",80,13,4073,6,1111,7,2962,165.467351,0.3703689999999824,23997.68879144967,63979.436723918916
"168.22.64.48",4417,"244.3.160.239",80,52,40774,13,1606,39,39168,165.871639,0.13016000000001782,98709.28088505102,2407375.5377993016
"168.22.64.48",6756,"244.3.160.239",80,11,3377,5,1406,6,1971,166.321212,0.3304019999999923,34043.3774613963,47723.68206003706
"168.22.64.48",3734,"244.3.160.239",80,11,2506,5,944,6,1562,166.3712,0.082523000000009,91513.88097862627,151424.45136505747
"168.22.64.48",9333,"244.3.160.239",443,23,8475,10,2014,13,6461,166.933474,0.7818579999999997,20607.32255729302,66109.19118305373
"168.22.64.48",15490,"244.3.160.239",80,10,2844,5,1538,5,1306,167.759439,0.0402790000000266,305469.35127465613,259390.74952191216
"168.22.64.48",11000,"244.3.160.239",80,174,148664,39,3655,135,145009,167.803674,0.9734960000000115,30036.076162613565,1191655.6411120193
"168.22.64.48",13003,"244.3.160.239",80,12,4327,5,1153,7,3174,168.801342,0.0600069999999846,153715.39987005462,423150.6324263255
"168.22.64.48",12602,"244.3.160.239",80,29,18188,11,1537,18,16651,168.805351,0.10601299999999014,115985.77532945151,1256525.1431429388
"168.22.64.48",8065,"244.3.160.239",80,11,3190,5,1152,6,2038,168.823305,0.042048999999991565,219172.86974724365,387738.11505632167
"168.22.64.48",2978,"244.3.160.239",80,157,136510,31,2803,126,133707,168.827462,0.20796400000000403,107826.3545613643,5143467.138543109
"168.22.64.48",2335,"244.3.160.239",80,51,37824,15,1777,36,36047,169.079669,0.10395900000000324,136746.21725872273,2773939.726238142
"168.22.64.48",12022,"244.3.160.239",80,13,5698,5,1145,8,4553,169.24726,0.030166999999977406,303643.0536681427,1207412.07279568
"168.22.64.48",9017,"244.3.160.239",80,10,2190,5,1142,5,1048,169.281203,0.05020299999998201,181981.15650465657,167001.9719937654
"168.22.64.48",15042,"244.3.160.239",80,10,1512,5,1024,5,488,169.761228,0.04825000000002433,169782.38341960352,80911.9170984048
"168.22.64.48",10358,"244.3.160.239",80,10,1717,5,1135,5,582,170.912578,0.026776000000012345,339109.6504330674,173887.06304144955
"168.22.64.48",12598,"244.3.160.239",80,55,42709,14,1743,41,40966,172.393388,0.1480020000000195,94214.94304129784,2214348.4547503195
"168.22.64.48",3260,"244.3.160.239",80,10,1906,5,1155,5,751,172.397715,0.06066799999999262,152304.34495946998,99030.79053208827
"168.22.64.48",7407,"244.3.160.239",80,12,4627,5,1151,7,3476,172.611257,0.040521000000012464,227240.1964412815,686261.4446827928
"168.22.64.48",11814,"244.3.160.239",80,15,8384,6,1208,9,7176,172.655494,0.056229999999999336,171865.5521963385,1020949.6709941434
"168.22.64.48",9558,"244.3.160.239",80,10,2297,5,1146,5,1151,172.717243,0.04218500000001768,217328.43427749575,218276.6386155302
"168.22.64.48",9289,"244.3.160.239",80,86,82995,25,2459,61,80536,172.785247,0.3720690000000104,52871.913542916634,1731635.7987362074
"168.22.64.48",14463,"244.3.160.239",80,11,1997,5,1184,6,813,172.789391,0.20845400000001746,45439.28156811194,31201.12830648227
"168.22.64.48",10860,"244.3.160.239",80,11,2772,5,1188,6,1584,172.823502,0.17441000000002305,54492.28828621492,72656.3843816199
"168.22.64.48",13423,"244.3.160.239",80,11,2197,5,1201,6,996,172.891525,0.1063919999999996,90307.54192044548,74892.84908639775
"168.22.64.48",6222,"244.3.160.239",80,11,2447,5,1024,6,1423,172.896218,0.10170399999998381,80547.47109259522,111932.66734840136
"168.22.64.48",5147,"244.3.160.239",80,11,1702,5,1031,6,671,172.89624,0.10168600000000083,81112.44419094008,52789.96125326944
"168.22.64.48",13035,"244.3.160.239",80,11,2018,5,1045,6,973,172.92529,0.07263900000000945,115089.69011135772,107160.06552952254
"168.22.64.48",8815,"244.3.160.239",80,11,2082,5,1040,6,1042,172.92981,0.06813499999998385,122110.51588760508,122345.34380277355
"168.22.64.48",10890,"244.3.160.239",80,12,2837,6,1244,6,1593,173.079736,0.18554499999999052,53636.58411706329,68684.14670295967
"168.22.64.48",12794,"244.3.160.239",80,12,2220,6,1252,6,968,173.083279,0.1820069999999987,55030.85046179582,42547.81409506258
"168.22.64.48",15526,"244.3.160.239",80,12,1997,6,1248,6,749,173.087256,0.18204600000001392,54843.281368441145,32914.75780846347
"168.22.64.48",10361,"244.3.160.239",80,12,2046,6,1255,6,791,173.235273,0.09045100000000161,110999.32560170502,69960.53111629376
"168.22.64.48",8411,"244.3.160.239",80,12,2852,6,1252,6,1600,173.28722,0.1480150000000151,67668.81734958604,86477.72185250612
"168.22.64.48",5243,"244.3.160.239",80,12,2847,6,1256,6,1591,173.291573,0.14792499999998654,67926.31401048446,86043.60317729361
"168.22.64.48",5956,"244.3.160.239",80,12,2840,6,1251,6,1589,173.291596,0.15216100000000665,65772.43840405598,83543.08922785368
"168.22.64.48",4157,"244.3.160.239",80,11,2264,5,1180,6,1084,173.295784,0.1480799999999931,63749.32468936007,58562.93895192061
"168.22.64.48",9729,"244.3.160.239",80,12,3031,6,1252,6,1779,173.295788,0.1518400000000213,65964.17281347864,93730.2423603662
"168.22.64.48",9241,"244.3.160.239",80,12,3051,6,1251,6,1800,173.399538,0.1436999999999955,69645.09394572243,100208.76826722652
"168.22.64.48",2848,"244.3.160.239",80,16,6819,7,1311,9,5508,173.559825,0.20570299999999975,50986.130489103285,214211.75189472226
"168.22.64.48",6238,"244.3.160.239",80,12,2964,6,1249,6,1715,173.563687,0.20188699999999926,49493.03323146135,67958.80864047735
"168.22.64.48",14626,"244.3.160.239",80,12,2293,6,1256,6,1037,173.727241,0.07722800000001939,130108.25089342566,107422.17848446051
"168.22.64.48",9919,"244.3.160.239",80,12,3253,6,1342,6,1911,182.379706,0.14801800000000753,72531.71911523904,103284.73564025472
"168.22.64.48",7622,"244.3.160.239",80,10,1860,5,1002,5,858,183.995574,0.0660829999999919,121301.99900127087,103869.37639030979
"168.22.64.48",12330,"244.3.160.239",80,10,1874,5,990,5,884,184.477123,0.06632299999998281,119415.58735283466,106629.67597970286
"168.22.64.48",11952,"244.3.160.239",80,10,1744,5,989,5,755,184.577194,0.10837100000000532,73008.46167332231,55734.46770814797
"168.22.64.48",8406,"244.3.160.239",80,10,1921,5,990,5,931,184.689534,0.49593699999999785,15969.770353895827,15018.036565128297
"168.22.64.48",8563,"244.3.160.239",80,13,3717,6,1175,7,2542,185.189202,0.10216400000001613,92008.9268235241,199052.5038173602
"168.22.64.48",15997,"244.3.160.239",80,51,36204,16,2025,35,34179,185.481306,0.9100260000000162,17801.689182506558,300466.1405278477
"168.22.64.48",5007,"244.3.160.239",80,24,17804,8,1205,16,16599,185.541215,0.2540429999999958,37946.33192018737,522714.65854206646
"168.22.64.48",2731,"244.3.160.239",80,70,55265,18,2056,52,53209,186.857465,0.24436099999999783,67310.24999897752,1741980.1032079742
"168.22.64.48",3360,"244.3.160.239",80,36,26491,10,1553,26,24938,186.861384,0.18401900000000637,67514.76749683222,1084148.9194050238
"168.22.64.48",16362,"244.3.160.239",80,41,28851,13,1722,28,27129,186.861389,0.18798499999999763,73282.44274809252,1154517.6476846703
"168.22.64.48",7652,"244.3.160.239",80,11,3272,5,1235,6,2037,187.957717,0.09573199999999815,103204.78001086565,170225.2120503104
"168.22.64.48",4334,"244.3.160.239",80,46,33475,14,1824,32,31651,188.057217,0.18401799999998047,79296.59055093279,1375995.8264953801
"168.22.64.48",8419,"244.3.160.239",80,105,85246,26,2569,79,82677,188.255472,0.21189300000000344,96992.34991245424,3121462.247455033
"168.22.64.48",15015,"244.3.160.239",80,107,85810,27,2634,80,83176,188.505229,0.22454199999998536,93844.35873912842,2963401.0563727203
"168.22.64.48",15946,"244.3.160.239",80,14,6277,6,1283,8,4994,188.761622,0.13780700000000934,74480.97701857891,289912.70399905153
"168.22.64.48",11377,"244.3.160.239",80,78,63501,19,2131,59,61370,188.903393,0.2401540000000182,70987.78283933937,2044354.8722901256
"168.22.64.48",8506,"244.3.160.239",80,10,2982,5,1229,5,1753,189.161631,0.1002589999999941,98066.00903660098,139877.7167137197
"168.22.64.48",5543,"244.3.160.239",80,12,3773,5,1226,7,2547,189.161635,0.10374900000002185,94535.85094794103,196397.07370669316
"168.22.64.48",5365,"244.3.160.239",80,21,11475,9,1476,12,9999,189.269244,0.12433200000000966,94971.52784479524,643374.1916802898
"168.22.64.48",10503,"244.3.160.239",80,12,3557,6,1331,6,2226,189.399439,0.26201000000000363,40639.67024159327,67966.87149345351
"168.22.64.48",11688,"244.3.160.239",80,12,2119,6,1296,6,823,189.403234,0.19677500000000236,52689.620124507055,33459.53500190533
"168.22.64.48",6742,"244.3.160.239",80,12,2113,6,1241,6,872,189.473234,0.12678400000001488,78306.41090357486,55022.7158000945
"168.22.64.48",13307,"244.3.160.239",80,12,2661,6,1245,6,1416,189.473404,0.12678900000000226,78555.7106689052,89345.29020656207
"168.22.64.48",5600,"244.3.160.239",80,13,4340,6,1246,7,3094,189.477383,0.18407199999998625,54152.72284758543,134469.12077883573
"168.22.64.48",16029,"244.3.160.239",80,11,2061,5,1180,6,881,189.477388,0.12283999999999651,76847.9322696212,57375.44773689515
"168.22.64.48",7965,"244.3.160.239",80,12,2157,6,1311,6,846,189.513569,0.24984400000002438,41978.19439329732,27088.903475766238
"168.22.64.48",12356,"244.3.160.239",80,14,5769,6,1183,8,4586,189.519504,0.14195499999999583,66669.01482864484,258448.09974992834
"168.22.64.48",6359,"244.3.160.239",80,12,2126,6,1249,6,877,189.600013,0.27661000000000513,36123.06134991437,25364.23122808239
"168.22.64.48",7576,"244.3.160.239",80,12,2113,6,1246,6,867,189.600038,0.2765899999999988,36038.90234643351,25076.828518746268
"168.22.64.48",10217,"244.3.160.239",80,20,12586,7,1348,13,11238,190.651187,0.146096,73814.47815135254,615376.1909977001
"168.22.64.48",3277,"244.3.160.239",80,42,30638,13,1724,29,28914,190.825229,0.18659999999999854,73912.11146838214,1239614.1479099775
"168.22.64.48",12402,"244.3.160.239",80,40,30932,11,1631,29,29301,191.0573,0.17019899999999666,76663.20013631253,1377258.3857719763
"168.22.64.48",11833,"244.3.160.239",80,12,2446,6,1318,6,1128,191.325351,0.280132999999978,37639.26420664766,32213.270125264462
"168.22.64.48",15826,"244.3.160.239",80,12,2435,6,1321,6,1114,191.329263,0.2762260000000083,38258.5274376767,32263.436461447265
"168.22.64.48",2203,"244.3.160.239",80,12,3029,6,1303,6,1726,192.483812,0.2693439999999896,38701.43756683053,51265.29642390599
"168.22.64.48",5308,"244.3.160.239",80,13,4131,6,1326,7,2805,192.623328,0.29619500000001153,35814.243994664284,75760.90075794367
"168.22.64.48",10025,"244.3.160.239",80,390,324878,85,6424,305,318454,201.465279,1.8226279999999804,28196.64791718362,1397779.470083872
"168.22.64.48",15595,"244.3.160.239",80,44,32226,13,1716,31,30510,203.641511,0.17592600000000402,78032.80924934169,1387401.5210940647
"168.22.64.48",4522,"244.3.160.239",80,12,2165,6,1295,6,870,204.153233,0.21458599999999706,48279.01167830214,32434.548386195256
"168.22.64.48",16283,"244.3.160.239",80,12,3023,6,1293,6,1730,204.243285,0.15995000000000914,64670.209440446444,86527.03969990127
"168.22.64.48",15373,"244.3.160.239",80,12,2147,6,1301,6,846,204.24329,0.3798590000000104,27399.640392881873,17817.137411512733
"168.22.205.0",49174,"41.177.98.176",80,23,12960,10,2242,13,10718,111.819114,2.8877789999999948,6211.001603654585,29692.022831387083
"168.22.205.0",49175,"41.177.98.176",80,15,3860,8,1963,7,1897,114.65448,19.32398699999999,812.6687313544564,785.3451774729516
"168.22.205.0",49177,"41.177.98.176",80,11,1748,6,1218,5,530,114.692754,0.035631000000009294,273469.7314135853,118997.50217504123
"168.22.205.0",49178,"41.177.98.176",80,53,46294,17,3846,36,42448,133.982873,28.08633899999998,1095.4791936392999,12090.71783972985
"168.22.205.0",49179,"41.177.98.176",80,20,13862,8,1255,12,12607,135.004978,15.023374000000018,668.2919562543,6713.272264938613
"168.22.205.0",49180,"41.177.98.176",80,21,14561,8,1260,13,13301,135.009472,15.02896100000001,670.7050474081337,7080.196694901259
"168.41.246.108",53354,"244.3.210.197",80,302,287470,111,14220,191,273250,133.938233,64.67307,1759.00108035694,33800.77673751996
"168.41.246.108",53355,"244.3.210.197",80,328,314480,119,14197,209,300283,134.616097,63.999572,1774.636867884054,37535.626019499
"168.41.246.108",53358,"244.3.210.197",80,6,1109,4,767,2,342,138.829568,0.380424000000005,16129.371438184551,7191.975269698978
"168.67.39.121",1393,"244.3.210.197",80,73,56248,32,8745,41,47503,0.672248,164.667029,424.8573647369322,2307.8329785132637
"168.67.39.121",1395,"244.3.210.197",80,8,3107,4,793,4,2314,34.681309,130.65803,48.55422969411065,141.68283418937207
"168.67.39.121",1396,"244.3.210.197",80,7,2317,4,790,3,1527,34.749503,130.589795,48.39581837156571,93.54482867516562
"168.67.39.121",1397,"244.3.210.197",80,10,4698,5,1313,5,3385,34.754422,130.584912,80.43808307655021,207.37464677389374
"168.91.64.164",39710,"244.3.210.255",1723,12,864,4,312,8,552,27.875985,180.32669199999998,13.841544877893064,24.48888709165696
"168.91.64.164",63610,"244.3.210.255",80,11,8027,5,371,6,7656,73.500526,0.19303800000000138,15375.21109833286,317284.6797003676
"168.91.64.164",4045,"244.3.210.230",80,11,8027,5,371,6,7656,73.840995,0.1325779999999952,22386.82134290838,461977.1002730635
"168.91.64.164",2434,"244.3.210.197",80,12,8090,5,370,7,7720,85.918179,0.42292799999999886,6998.827223546344,146029.5842318318
"168.91.64.164",1260,"244.3.210.255",80,12,8091,5,371,7,7720,86.499969,0.6125340000000108,4845.445314055951,100827.05613075994
"168.91.64.164",4020,"244.3.210.255",80,6,807,4,329,2,478,87.190116,0.09229100000000301,28518.490427017958,41434.15934381332
"168.91.64.164",2351,"244.3.210.230",80,12,8091,5,371,7,7720,87.37591,0.628383999999997,4723.226562102177,98283.85191220703
"168.91.64.164",1239,"244.3.210.98",80,12,8091,5,371,7,7720,88.121638,0.43280999999998926,6857.5125343685995,142695.40907095847
"168.91.64.164",38486,"244.3.210.255",80,16,14163,6,435,10,13728,165.92154,0.09821900000000028,35431.02658345117,1118154.3285922245
"168.91.64.164",1117,"244.3.210.230",80,15,12645,6,435,9,12210,166.101774,0.10866199999998116,32025.9152233587,898934.3100625512
"168.91.64.164",4010,"244.3.210.197",80,12,8090,5,370,7,7720,173.061825,0.39274299999999585,7536.735218705442,157252.9618605568
"168.91.64.164",1241,"244.3.210.255",80,16,12709,6,435,10,12274,173.612497,0.5874650000000088,5923.757160000932,167145.2767398884
"168.91.64.164",38455,"244.3.210.230",80,17,14227,6,435,11,13792,174.333497,0.5685530000000085,6120.801402859448,194064.58149020118
"168.91.64.164",1294,"244.3.210.98",80,16,12709,6,435,10,12274,175.025169,0.44374399999998104,7842.35955866479,221280.73844379687
"168.91.90.164",3298,"244.3.160.239",80,10,2147,5,1079,5,1068,104.182837,0.048193999999995185,179109.4327094838,177283.4792712963
"168.91.90.164",8991,"244.3.160.239",80,10,2204,5,1127,5,1077,124.848752,0.04740199999999106,190202.9450234526,181764.4825113207
"168.91.90.164",10197,"244.3.160.239",80,10,2086,5,1090,5,996,124.898093,0.044076000000004,197840.09438241238,180778.65505035114
"168.91.90.164",13718,"244.3.160.239",80,10,1862,5,1046,5,816,124.957418,0.19751199999998903,42367.046052900405,33051.15638543665
"168.91.90.164",6831,"244.3.160.239",80,10,1889,5,1033,5,856,125.155618,0.2181539999999984,37881.49655747802,31390.66897696146
"168.91.90.164",5814,"244.3.160.239",80,111,72306,39,3246,72,69060,125.374658,1.2066039999999987,21521.55968321009,457880.13300138287
"168.91.90.164",11511,"244.3.160.239",80,48,27484,18,1757,30,25727,126.102791,0.2906420000000054,48361.90227152214,708142.6634828971
"168.91.90.164",2771,"244.3.160.239",80,10,1841,5,907,5,934,126.393579,0.1288770000000028,56301.74507475999,57977.76174181458
"168.91.90.164",7838,"244.3.160.239",80,16,5595,7,1012,9,4583,126.53082,0.17979400000000112,45029.311322958216,203922.26659398963
"168.91.90.164",13944,"244.3.160.239",80,33,17329,13,1391,20,15938,126.732818,0.27694700000000694,40180.97325480948,460391.33841491985
"168.91.90.164",13980,"244.3.160.239",80,15,5132,7,1005,8,4127,127.029054,0.18895799999999952,42549.13790366124,174726.65883423874
"168.91.90.164",4122,"244.3.160.239",80,18,7568,8,1076,10,6492,127.231642,0.17876700000000767,48152.06385965883,290523.4187517706
"168.91.90.164",3347,"244.3.160.239",80,10,2069,5,918,5,1151,127.41938,0.14108000000000231,52055.57130705897,65267.9330876088
"168.91.90.164",4335,"244.3.160.239",80,11,2732,5,957,6,1775,127.574937,0.14753599999998812,51892.4194772843,96247.69547772166
"168.91.90.164",8102,"244.3.160.239",80,12,2973,6,1035,6,1938,127.730974,0.1408479999999912,58786.77723503718,110076.1104169102
"168.91.90.164",10167,"244.3.160.239",80,12,2923,6,956,6,1967,127.887952,0.12886100000001477,59350.773313874044,122116.07856526176
"168.91.90.164",12950,"244.3.160.239",80,57,35805,21,1949,36,33856,128.028274,0.3472769999999912,44897.876910939674,779919.1999470362
"168.91.90.164",7085,"244.3.160.239",80,15,4369,7,997,8,3372,128.390727,0.2569599999999923,31039.850560399434,104981.32004981635
"168.91.90.164",7651,"244.3.160.239",80,12,2639,6,921,6,1718,128.391694,0.25631100000001084,28746.327703452793,53622.35721447546
"168.91.90.164",5702,"244.3.160.239",80,15,5184,7,1000,8,4184,128.64789,0.3272919999999999,24443.00502303754,102269.53301638906
"168.91.90.164",12301,"244.3.160.239",80,12,1639,6,929,6,710,128.649106,0.22067000000001258,33679.24955816186,25739.792450263634
"168.91.90.164",7835,"244.3.160.239",80,12,1680,6,923,6,757,128.868791,0.2233550000000264,33059.4793042427,27113.78746837673
"168.91.90.164",2698,"244.3.160.239",80,46,22233,17,1643,29,20590,128.887751,0.34622199999998315,37964.08084986119,475764.10511177225
"168.91.90.164",13145,"244.3.160.239",80,12,1757,6,943,6,814,129.279304,0.38581300000001306,19553.5142672739,16878.643280552442
"168.91.90.164",7736,"244.3.160.239",80,30,17489,9,1123,21,16366,129.384276,0.22083599999999137,40681.772899347714,592874.3501965491
"168.91.90.164",10086,"244.3.160.239",80,18,7567,8,1051,10,6516,129.558447,0.32607699999999795,25785.32064512386,159864.0811832798
"168.91.90.164",4107,"244.3.160.239",80,540,396265,159,11196,381,385069,154.737211,3.4860060000000033,25693.587446493184,883690.9632398789
"168.91.90.164",5464,"244.3.160.239",80,36,14511,14,1693,22,12818,158.22399,0.40982200000001967,33048.494224320195,250215.94741130315
"168.91.90.164",6885,"244.3.160.239",80,174,109782,60,4757,114,105025,158.638815,0.6867129999999975,55417.619879047204,1223509.6758034334
"168.91.90.164",14379,"244.3.160.239",80,690,460704,227,15520,463,445184,159.638952,2.0556860000000086,60398.32931683121,1732498.0566098057
"168.91.90.164",15660,"244.3.160.239",80,16,6407,7,1140,9,5267,162.044579,1.1238840000000039,8114.716465400315,37491.41370461707
"168.117.3.145",7053,"244.3.160.239",80,29,19849,10,640,19,19209,0.997402,0.3479789999999999,14713.531563686318,441612.8559482039
"168.117.3.145",8089,"244.3.160.239",80,66,48444,24,2431,42,46013,1.096224,0.74976,25938.967136150237,490962.441314554
"168.117.3.145",10748,"244.3.160.239",80,12,2245,6,1283,6,962,1.107006,0.38503600000000016,26657.24763398746,19987.741405998393
"168.117.3.145",12921,"244.3.160.239",80,21,12182,9,1474,12,10708,1.115441,0.6371630000000001,18507.038230405717,134445.97379320516
"168.117.3.145",11492,"244.3.160.239",80,12,2356,6,1281,6,1075,1.123692,0.47888200000000025,21399.84380285748,17958.49499459156
"168.117.3.145",3657,"244.3.160.239",80,15,6233,7,1347,8,4886,1.132228,0.5752139999999999,18733.897297353684,67953.83978832228
"168.117.3.145",14336,"244.3.160.239",80,12,2031,6,1280,6,751,1.142821,0.515482,19864.90313919788,11655.111138701255
"168.117.3.145",7148,"244.3.160.239",80,21,9549,9,1454,12,8095,1.486489,0.5236820000000002,22211.953055480226,123662.83355165916
"168.117.3.145",16044,"244.3.160.239",80,13,4223,6,1271,7,2952,1.584535,0.40442699999999987,25141.743751035425,58393.72742175969
"168.117.3.145",5459,"244.3.160.239",80,13,4492,6,1303,7,3189,2.111165,0.4636689999999999,22481.55472977491,55022.00923503622
"168.117.3.145",9602,"244.3.160.239",80,12,2239,6,1302,6,937,2.120202,0.4577460000000002,22754.977651361223,16375.894054781465
"168.117.3.145",3931,"244.3.160.239",80,12,2598,6,1346,6,1252,2.130378,0.5574210000000002,19317.53557903272,17968.465486589124
"168.117.3.145",7338,"244.3.160.239",80,12,2617,6,1327,6,1290,2.13924,0.5516209999999999,19245.097630438293,18708.497319717706
"168.117.3.145",6324,"244.3.160.239",80,12,2701,6,1326,6,1375,2.147551,0.55104,19250.871080139375,19962.25319396051
"168.117.3.145",10351,"244.3.160.239",80,12,2638,6,1327,6,1311,2.156458,0.6177549999999998,17184.806274332062,16977.604390089928
"168.117.3.145",16317,"244.3.160.239",80,36,22066,14,1852,22,20214,2.466895,0.5939049999999999,24946.750742963945,272285.9716621346
"168.117.3.145",6944,"244.3.160.239",80,21,11824,9,1531,12,10293,2.494209,0.5291060000000001,23148.48064471013,155628.5508007847
"168.117.3.145",15551,"244.3.160.239",80,12,2044,6,1341,6,703,2.603609,0.34762499999999985,30860.841423948234,16178.353110391952
"168.117.3.145",4329,"244.3.160.239",80,12,2916,6,1346,6,1570,2.6229050000000003,0.5482939999999998,19639.09873170234,22907.41828289203
"168.117.3.145",4389,"244.3.160.239",80,12,3031,6,1348,6,1683,2.642181,0.5317150000000002,20281.541803409717,25321.83594594848
"168.117.3.145",10084,"244.3.160.239",80,12,2850,6,1341,6,1509,2.724344,0.544,19720.588235294115,22191.176470588234
"168.117.3.145",15943,"244.3.160.239",80,12,2802,6,1341,6,1461,2.9448410000000003,0.4405439999999996,24351.710612333864,26530.83460448902
"168.117.3.145",7956,"244.3.160.239",80,12,2531,6,1335,6,1196,3.001045,0.4134709999999999,25830.10658546791,23140.67975746788
"168.117.3.145",4179,"244.3.160.239",80,12,2533,6,1334,6,1199,3.034201,0.571116,18686.22136308561,16795.1869672711
"168.117.3.145",8382,"244.3.160.239",80,12,2034,6,1329,6,705,3.081534,0.5290279999999998,20097.23492896407,10661.061418299223
"168.117.3.145",9353,"244.3.160.239",80,12,2178,6,1343,6,835,3.101659,0.5025659999999998,21378.286632999454,13291.786551418127
"168.117.3.145",8366,"244.3.160.239",80,14,2805,7,1421,7,1384,3.193061,0.4913719999999997,23135.221380135634,22532.826453277776
"168.117.3.145",3465,"244.3.160.239",80,12,2645,6,1357,6,1288,3.379785,0.3389059999999997,32032.480982927445,30403.71076345656
"168.117.3.145",6930,"244.3.160.239",80,12,2481,6,1354,6,1127,3.409307,0.527698,20526.892275506067,17085.52998116347
"168.117.3.145",10573,"244.3.160.239",80,12,2472,6,1353,6,1119,3.4891199999999998,0.4530920000000003,23889.188067765474,19757.57682766413
"168.117.3.145",8871,"244.3.160.239",80,12,2048,6,1342,6,706,3.507946,0.5396920000000001,19892.827761019245,10465.22831540953
"168.117.3.145",15795,"244.3.160.239",80,12,2407,6,1349,6,1058,3.52709,0.5262550000000004,20507.16857797074,16083.457639357335
"168.117.3.145",5107,"244.3.160.239",80,12,2386,6,1346,6,1040,3.629889,0.5217129999999996,20639.700371660296,15947.46536889057
"168.117.3.145",3463,"244.3.160.239",80,12,2497,6,1355,6,1142,3.713341,0.4465180000000002,24276.736884067373,20460.54134435789
"168.117.3.145",11937,"244.3.160.239",80,12,2572,6,1357,6,1215,3.834571,0.4190450000000001,25906.52555214833,23195.599517951527
"168.117.3.145",15103,"244.3.160.239",80,16,6997,7,1395,9,5602,3.854032,0.5098849999999997,21887.288310109154,87894.3291134276
"168.117.3.145",5274,"244.3.160.239",80,12,2811,6,1342,6,1469,3.96145,0.5131269999999999,20922.695551003948,22902.712194057225
"168.117.3.145",4227,"244.3.160.239",80,12,2608,6,1343,6,1265,3.981086,0.4857039999999997,22120.468433449194,20835.73534498379
"168.117.3.145",4604,"244.3.160.239",80,12,2055,6,1343,6,712,4.0723,0.5014459999999996,21426.03590416517,11359.149340108415
"168.117.3.145",14138,"244.3.160.239",80,10,1750,5,1151,5,599,5.748006,0.29732000000000003,30969.99865464819,16117.31467778824
"168.117.3.145",3902,"244.3.160.239",80,10,2103,5,1246,5,857,6.367115,0.30990300000000026,32164.90321165007,22123.051406407794
"168.117.3.145",10940,"244.3.160.239",80,21,12589,7,1375,14,11214,6.686542,1.052733,10448.993239501375,85218.18922746794
"168.117.3.145",2822,"244.3.160.239",80,63,40807,23,2399,40,38408,7.712635,1.3023949999999997,14735.9288080805,235922.28164266606
"168.117.3.145",10405,"244.3.160.239",80,31,19985,12,1669,19,18316,8.730675,0.5344619999999995,24982.131564077543,274159.8093035616
"168.117.3.145",14463,"244.3.160.239",80,12,2364,6,1289,6,1075,8.738786,0.3848660000000006,26793.741198235188,22345.439711483963
"168.117.3.145",8302,"244.3.160.239",80,22,10955,9,1476,13,9479,9.279511,0.42387000000000086,27857.597848396857,178903.90921744838
"168.117.3.145",15133,"244.3.160.239",80,28,17875,11,1597,17,16278,9.289496,0.5006420000000009,25519.233304437057,260114.01360652875
"168.117.3.145",13921,"244.3.160.239",80,13,3804,6,1280,7,2524,9.298049,0.36293099999999967,28214.72952158953,55635.919775384355
"168.117.3.145",7055,"244.3.160.239",80,12,1997,6,1297,6,700,9.857596000000001,0.31135299999999866,33325.51798119833,17986.015872659085
"168.117.3.145",6196,"244.3.160.239",80,13,4495,6,1311,7,3184,9.883925,0.33366900000000044,31432.347625940638,76339.1264996148
"168.117.3.145",3405,"244.3.160.239",80,13,4475,6,1311,7,3164,9.89432,0.41831200000000024,25072.19491671287,60509.85867008354
"168.117.3.145",8583,"244.3.160.239",80,13,4421,6,1311,7,3110,9.902781,0.4150570000000009,25268.81849962771,59943.57401513514
"168.117.3.145",13179,"244.3.160.239",80,30,17788,10,1583,20,16205,15.382192,1.1089920000000006,11419.379039704518,116898.94967682357
"168.117.3.145",13672,"244.3.160.239",80,33,17980,13,1775,20,16205,16.474343,1.1011309999999987,12895.831649458616,117733.4940166067
"168.117.3.145",12018,"244.3.160.239",80,12,2372,6,1297,6,1075,17.42945,0.35892800000000236,28908.30472963918,23960.23715062615
"168.117.3.145",6950,"244.3.160.239",80,12,2131,6,1310,6,821,17.894854,0.38792700000000124,27015.392071188566,16931.02052705787
"168.117.3.145",14858,"244.3.160.239",80,12,2128,6,1310,6,818,17.905183,0.382871999999999,27372.072128544336,17091.87404667883
"168.117.3.145",15168,"244.3.160.239",80,23,12728,8,1477,15,11251,20.885593,1.238499000000001,9540.580977457383,72675.0687727644
"168.117.3.145",5668,"244.3.160.239",80,64,42355,23,2437,41,39918,22.094094,1.3982740000000007,13942.903894372626,228384.42250946513
"168.117.3.145",4286,"244.3.160.239",80,14,3439,7,2300,7,1139,23.126005,0.33900799999999975,54276.005286010986,26878.421748159355
"168.117.3.145",6706,"244.3.160.239",80,12,2033,6,1317,6,716,23.598347,0.32051600000000136,32871.993909820274,17871.182717867363
"168.117.3.145",15975,"244.3.160.239",80,12,2033,6,1317,6,716,23.608528,0.3341169999999991,31533.86388600409,17143.695172649146
"168.117.3.145",5310,"244.3.160.239",80,13,4519,6,1353,7,3166,47.684075,1.1215150000000023,9651.230701328095,22583.737176943643
"168.117.3.145",15797,"244.3.160.239",80,39,22646,15,1926,24,20720,48.815778,1.243701999999999,12388.819829830629,133279.51551095047
"168.117.3.145",3091,"244.3.160.239",80,42,25409,16,2074,26,23335,48.824164,1.3265999999999991,12507.16116387759,140720.639228102
"168.117.3.145",9378,"244.3.160.239",80,14,3433,7,2294,7,1139,49.838451,0.5393880000000024,34023.74543000571,16893.219723093505
"168.117.3.145",12907,"244.3.160.239",80,12,2467,6,1392,6,1075,49.984454,0.4988390000000038,22323.835947068925,17240.031352801074
"168.117.3.145",8285,"244.3.160.239",80,12,3423,6,1406,6,2017,50.530367,0.4951870000000014,22714.651232766548,32585.66965610962
"168.117.3.145",12088,"244.3.160.239",80,12,2157,6,1416,6,741,50.547442,0.48589300000000435,23313.7748434324,12200.216920186022
"168.117.3.145",2394,"244.3.160.239",80,12,2124,6,1416,6,708,50.556246,0.4912169999999989,23061.09112673223,11530.545563366115
"168.117.3.145",13140,"244.3.160.239",80,12,2142,6,1409,6,733,50.570106,0.48478000000000065,23251.784314534398,12096.208589463246
"168.117.3.145",9532,"244.3.160.239",80,12,2163,6,1422,6,741,50.580528,0.4815010000000015,23626.11915655412,12311.500910693812
"168.117.3.145",5479,"244.3.160.239",80,12,3038,6,1421,6,1617,50.588754,0.5441590000000005,20890.952828125584,23772.46356303946
"168.117.3.145",6518,"244.3.160.239",80,12,2946,6,1422,6,1524,50.941572,0.33400100000000066,34059.77826413687,36502.88472190196
"168.117.3.145",2250,"244.3.160.239",80,4802,3539177,1609,104087,3193,3435090,51.979621,20.438387,40741.766950591555,1344564.0304198174
"168.117.3.145",2949,"244.3.160.239",80,13,4511,6,1380,7,3131,125.612446,1.2288870000000003,8983.738944264198,20382.671474268987
"168.117.3.145",3922,"244.3.160.239",80,37,22512,15,1953,22,20559,127.016493,1.1577359999999999,13495.3046290346,142063.47561102014
"168.117.3.145",9435,"244.3.160.239",80,42,25036,16,2101,26,22935,127.025985,1.2812839999999852,13118.09091505099,143200.10239728438
"168.117.3.145",2925,"244.3.160.239",80,14,3487,7,2348,7,1139,127.999724,0.4686980000000034,40076.97920622632,19441.089998250332
"168.117.3.145",3586,"244.3.160.239",80,12,2494,6,1419,6,1075,128.135021,0.4371590000000083,25967.668514201436,19672.4761471223
"168.117.3.145",6544,"244.3.160.239",80,491,350509,168,11749,323,338760,130.096533,2.536155000000008,37060.826329620904,1068578.2217569477
"168.117.123.48",8065,"244.3.160.239",80,12,2412,6,1731,6,681,108.486624,0.6033049999999918,22953.564117652248,9030.25832704863
"168.117.123.48",7485,"244.3.160.239",80,12,2405,6,1724,6,681,109.584645,0.3347100000000012,41205.81996355039,16276.776911356043
"168.117.123.48",13531,"244.3.160.239",80,10,3137,5,1424,5,1713,111.047274,0.19886800000000449,57284.22873463676,68910.03077418031
"168.117.123.48",8754,"244.3.160.239",80,12,2453,6,1772,6,681,111.230434,0.21720999999999435,65264.03020118949,25081.718152940204
"168.117.123.48",3465,"244.3.160.239",80,12,2427,6,1746,6,681,114.318859,0.25621300000000247,54517.14003582904,21263.55805521167
"168.117.123.48",10724,"244.3.160.239",80,12,2438,6,1757,6,681,115.022729,0.3798979999999972,36999.405103475416,14340.691448757405
"168.117.123.48",4088,"244.3.160.239",80,12,2419,6,1738,6,681,117.941619,0.4079749999999933,34080.51963968436,13353.759421533401
"168.117.123.48",2673,"244.3.160.239",80,12,2463,6,1782,6,681,118.26289,0.40606900000000223,35107.33397526017,13416.43907808764
"168.117.123.48",16211,"244.3.160.239",80,16,2985,8,2164,8,821,118.584429,0.41565300000000605,41650.126427572395,15801.642235229638
"168.117.123.48",8737,"244.3.160.239",80,12,2508,6,1827,6,681,119.078927,0.38052200000001335,38410.394142781464,14317.174828261726
"168.117.123.48",16327,"244.3.160.239",80,6,396,1,66,5,330,120.736754,50.61924499999999,10.430815394421629,52.15407697210814
"168.117.123.48",9439,"244.3.160.239",80,6,396,1,66,5,330,120.87269,50.61331099999998,10.43203832288309,52.160191614415446
"168.117.123.48",11769,"244.3.160.239",80,79,58724,28,2956,51,55768,124.690533,0.44313900000000217,53364.745599010435,1006781.167985661
"168.117.123.48",5605,"244.3.160.239",80,10,1881,5,1415,5,466,124.865808,0.16415600000000552,68958.79529228063,22710.10502205143
"168.117.123.48",6393,"244.3.160.239",80,10,1891,5,1425,5,466,124.883582,0.14962400000000287,76190.98540340975,24915.788910869436
"168.117.123.48",6609,"244.3.160.239",80,10,1883,5,1417,5,466,124.885715,0.1496580000000023,75746.03429151683,24910.12842614456
"168.117.123.48",7801,"244.3.160.239",80,10,1883,5,1417,5,466,124.887286,0.1746699999999919,64899.52481823167,21343.104139234976
"168.117.123.48",4428,"244.3.160.239",80,10,1873,5,1407,5,466,124.894714,0.16635400000001255,67662.93566730677,22410.0412373596
"168.117.123.48",4381,"244.3.160.239",80,10,1872,5,1406,5,466,124.8956,0.19005900000000508,59181.6225487859,19614.96166979675
"168.117.123.48",11995,"244.3.160.239",80,10,1555,5,1138,5,417,124.909061,0.19925400000001048,45690.42528631556,16742.449336022488
"168.117.123.48",8430,"244.3.160.239",80,10,1906,5,1440,5,466,125.165109,0.16662200000000382,69138.52912580413,22373.996230989393
"168.117.123.48",8541,"244.3.160.239",80,10,1899,5,1433,5,466,125.167402,0.16740000000000066,68482.67622461144,22270.011947431216
"168.117.123.48",7429,"244.3.160.239",80,10,1909,5,1443,5,466,125.168309,0.17404300000001172,66328.43607613764,21419.993909549645
"168.117.123.48",8604,"244.3.160.239",80,10,1910,5,1444,5,466,125.169581,0.1820950000000039,63439.41349295562,20472.83011614773
"168.117.123.48",14948,"244.3.160.239",80,10,1905,5,1439,5,466,125.170574,0.19348599999999294,59497.844805311084,19267.543904986076
"168.117.123.48",15902,"244.3.160.239",80,10,1898,5,1432,5,466,125.178965,0.2070719999999966,55323.75212486569,18003.399783650428
"168.117.123.48",10828,"244.3.160.239",80,10,1896,5,1430,5,466,125.332615,0.24381199999999126,46921.39845454863,15290.469706167594
"168.117.123.48",13245,"244.3.160.239",80,10,1902,5,1436,5,466,125.335676,0.2419659999999908,47477.74480712347,15407.123314846473
"168.117.123.48",14228,"244.3.160.239",80,10,1907,5,1441,5,466,125.34113,0.23760399999999038,48517.7017221952,15689.971549301152
"168.117.123.48",4383,"244.3.160.239",80,10,1908,5,1442,5,466,125.350862,0.2287899999999894,50421.78416889084,16294.418462346137
"168.117.123.48",12775,"244.3.160.239",80,10,1909,5,1443,5,466,125.365082,0.2682850000000059,43028.868553962195,13895.670648750092
"168.117.123.48",9137,"244.3.160.239",80,10,1925,5,1459,5,466,125.382227,0.2590950000000021,45049.11325961484,14388.544742275884
"168.117.123.48",14890,"244.3.160.239",80,10,1926,5,1460,5,466,125.580793,0.1400430000000057,83402.95480673455,26620.3951643413
"168.117.123.48",12730,"244.3.160.239",80,10,1925,5,1459,5,466,125.581762,0.15036800000000028,77622.89848904008,24792.5090444775
"168.117.123.48",12133,"244.3.160.239",80,10,1934,5,1468,5,466,125.583208,0.16266199999999742,72198.79258831311,22918.690290295577
"168.117.123.48",8595,"244.3.160.239",80,10,1933,5,1467,5,466,125.584124,0.19241999999999848,60991.5809167451,19374.28541731644
"168.117.123.48",14721,"244.3.160.239",80,10,1925,5,1459,5,466,125.634358,0.1464239999999961,79713.70813528048,25460.307053489174
"168.117.123.48",14121,"244.3.160.239",80,10,1934,5,1468,5,466,125.701791,0.13087600000000066,89733.79382010408,28484.978147253747
"168.117.123.48",6271,"244.3.160.239",80,10,1924,5,1458,5,466,125.721773,0.14068000000000325,82911.5723628073,26499.85783338011
"168.117.123.48",13754,"244.3.160.239",80,10,1934,5,1468,5,466,125.733176,0.14307599999999354,82082.24999301441,26056.08208225117
"168.117.123.48",6734,"244.3.160.239",80,10,1891,5,1425,5,466,128.531859,0.12765300000000934,89304.59918685158,29204.170681454623
"168.117.123.48",11757,"244.3.160.239",80,10,2426,5,1506,5,920,134.452989,0.15173099999998385,79403.68151532173,48506.897074432934
"168.117.123.48",4676,"41.177.98.176",80,54,40970,23,5710,31,35260,134.630171,42.683374000000015,1070.2059307682655,6608.6621924499195
"168.117.123.48",4677,"41.177.98.176",80,39,26826,17,4469,22,22357,138.475874,38.838651,920.5263076722207,4605.10330289278
"168.117.123.48",4678,"41.177.98.176",80,49,34089,22,6284,27,27805,138.476867,38.838629999999995,1294.3813929585056,5727.287497010066
"168.117.123.48",4679,"41.177.98.176",80,90,78583,33,3784,57,74799,138.499514,38.81743599999999,779.8557328722075,15415.546766149115
"168.117.123.48",4680,"41.177.98.176",80,44,28612,19,5400,25,23212,138.500494,38.817453,1112.9014569812193,4783.827522120011
"168.117.123.48",4681,"41.177.98.176",80,30,15751,14,4274,16,11477,138.503242,38.81595200000001,880.8749557398461,2365.4192482513367
"168.117.123.48",4689,"41.177.98.176",80,56,48660,21,2315,35,46345,190.037616,15.642226999999991,1183.9746348138287,23702.507322007295
"168.117.123.48",4690,"41.177.98.176",80,13,4109,7,2191,6,1918,190.700016,18.409415999999993,952.1214578452682,833.4865158134297
"168.117.123.48",4691,"41.177.98.176",80,11,2109,6,1239,5,870,190.717773,14.973642000000012,661.9632017380936,464.8167760388551
"168.117.123.48",4692,"41.177.98.176",80,11,2223,6,1240,5,983,190.723651,14.969966999999997,662.6601114083953,525.3184592858489
"168.159.143.225",5697,"244.3.160.239",80,10,2000,5,1034,5,966,127.10923,0.20178099999999688,40994.940058777225,38298.94786922515
"168.159.143.225",16138,"244.3.160.239",80,10,2044,5,1069,5,975,141.234766,0.21048700000000053,40629.587575479614,37056.92037988085
"168.159.143.225",6275,"244.3.160.239",80,10,1930,5,1036,5,894,141.445095,0.2079650000000015,39852.85985622552,34390.40223114441
"168.159.143.225",2579,"244.3.160.239",80,10,1766,5,992,5,774,141.753341,0.29406099999999924,26987.59781133853,21056.855550379056
"168.159.143.225",14824,"244.3.160.239",80,10,1906,5,1004,5,902,142.134394,0.9267110000000116,8667.21124492954,7786.6778316000455
"168.159.143.225",13605,"244.3.160.239",80,57,38421,21,2069,36,36352,143.06121,2.3481840000000034,7048.851367695196,123847.19425734933
"168.159.143.225",10504,"244.3.160.239",80,28,19538,11,1332,17,18206,145.098976,0.5965480000000127,17862.770472786386,244151.35077143312
"168.159.143.225",13821,"244.3.160.239",80,12,1766,6,1015,6,751,145.117184,0.44177199999998606,18380.522079263184,13599.775449779952
"168.159.143.225",9891,"244.3.160.239",80,20,9241,8,1140,12,8101,145.191492,0.46660599999998453,19545.39804460359,138892.34171871375
"168.159.143.225",7524,"244.3.160.239",80,12,2073,6,1013,6,1060,145.409142,0.5647480000000087,14349.76308017005,15015.546757137467
"168.159.143.225",6894,"244.3.160.239",80,19,10512,8,1154,11,9358,145.875136,0.556051999999994,16602.763770295045,134634.89026206327
"168.159.143.225",14732,"244.3.160.239",80,25,17437,10,1275,15,16162,146.361402,0.6482090000000085,15735.665502947146,199466.5300852014
"168.159.143.225",15668,"244.3.160.239",80,13,3546,6,1022,7,2524,147.013888,0.48378199999999083,16900.17404533479,41737.807524877695
"168.159.143.225",2075,"244.3.160.239",80,12,1756,6,1020,6,736,147.488899,0.5582019999999943,14618.363961433464,10548.152819230421
"168.159.143.225",15882,"244.3.160.239",80,12,1759,6,1020,6,739,147.493613,0.5535689999999818,14740.709830211354,10679.788788751166
"168.159.143.225",15456,"244.3.160.239",80,12,1709,6,1009,6,700,147.497051,0.5424969999999973,14879.34495490305,10322.637728872283
"168.159.143.225",8801,"244.3.160.239",80,12,2294,6,1042,6,1252,147.49709,0.5499760000000151,15157.025033819242,18211.703783437322
"168.159.143.225",7994,"244.3.160.239",80,12,1733,6,1028,6,705,147.505908,0.5495609999999829,14964.671801674895,10262.736984611673
"168.159.143.225",6337,"244.3.160.239",80,12,1743,6,1040,6,703,147.506047,0.5494170000000054,15143.324651403067,10236.305028784958
"168.159.143.225",14784,"244.3.160.239",80,12,1733,6,1025,6,708,147.926999,0.5620670000000132,14589.008071991075,10077.090453628956
"168.159.143.225",15839,"244.3.160.239",80,12,2647,6,1030,6,1617,147.931549,0.5581190000000049,14763.87652095687,23177.85275183229
"168.159.143.225",3949,"244.3.160.239",80,12,1772,6,1031,6,741,147.931861,0.5616709999999898,14684.753174011386,10554.221243397127
"168.159.143.225",6919,"244.3.160.239",80,12,2316,6,1026,6,1290,147.935798,0.5580989999999986,14707.06810082086,18491.342933780612
"168.159.143.225",6565,"244.3.160.239",80,12,2555,6,1031,6,1524,147.935802,0.558086000000003,14779.084227162044,21846.09540465078
"168.159.143.225",8749,"244.3.160.239",80,12,2400,6,1025,6,1375,147.936306,0.5575880000000097,14706.1988421556,19727.82771508678
"168.159.143.225",10279,"244.3.160.239",80,12,2337,6,1026,6,1311,148.375817,0.45787899999999127,17926.13332343295,22905.614802164328
"168.159.143.225",6725,"244.3.160.239",80,39,31396,15,1610,24,29786,148.379226,0.7461540000000184,17261.8521109579,319354.9856999951
"168.159.143.225",4474,"244.3.160.239",80,22,13950,9,1225,13,12725,148.379773,0.6478130000000135,15127.82238084107,157144.11411934908
"168.159.143.225",7856,"244.3.160.239",80,12,2727,6,1044,6,1683,148.383185,0.45024900000001367,18549.73581284966,29903.453422438677
"168.159.143.225",14755,"244.3.160.239",80,12,2612,6,1042,6,1570,148.383225,0.45024399999999787,18514.405522339086,27895.985287977317
"168.159.143.225",3315,"244.3.160.239",80,13,2610,6,1037,7,1573,148.390302,0.44297800000001075,18727.792350861215,28407.73130945486
"168.159.143.225",8335,"244.3.160.239",80,12,2498,6,1037,6,1461,148.815631,0.4853119999999933,17094.15798496661,24083.476196756234
"168.159.143.225",4628,"244.3.160.239",80,12,2227,6,1031,6,1196,148.825849,0.5502099999999928,14990.639937478614,17389.72392359304
"168.159.143.225",11868,"244.3.160.239",80,12,2229,6,1030,6,1199,148.829161,0.5501130000000103,14978.74073144944,17436.417608745513
"168.159.143.225",6642,"244.3.160.239",80,12,1749,6,1004,6,745,148.833527,0.5455719999999928,14722.16316086622,10924.314297654715
"168.159.143.225",6732,"244.3.160.239",80,12,1959,6,1022,6,937,149.02754,0.5615420000000029,14559.908252632855,13348.956979175131
"168.159.143.225",10772,"244.3.160.239",80,9,4411,4,902,5,3509,149.129583,0.4357559999999978,16559.726085240447,64421.373429167106
"168.159.143.225",15582,"244.3.160.239",80,8,1498,4,914,4,584,149.195266,0.36990699999998355,19767.130657166057,12630.201645278968
"168.159.143.225",10338,"244.3.160.239",80,6,1043,4,913,2,130,149.305394,0.25512299999999755,28629.32781442704,4076.465077629261
"168.159.143.225",6071,"244.3.160.239",80,6,1044,4,914,2,130,149.313476,0.2520470000000046,29010.462334405358,4126.214555221769
"168.159.143.225",2583,"244.3.160.239",80,6,1043,4,913,2,130,149.313818,0.25207900000000905,28975.043537937465,4125.690755675652
"168.159.143.225",11492,"244.3.160.239",80,13,5030,6,1173,7,3857,149.565713,0.8281730000000209,11330.965873072128,37257.91591853299
"168.159.143.225",12641,"244.3.160.239",80,42,29014,14,1767,28,27247,150.397278,1.2784389999999917,11057.23464318602,170501.68212953565
"168.159.143.225",4285,"244.3.160.239",80,38,23180,14,1683,24,21497,150.397548,1.1380350000000021,11830.91908421092,151116.61767871786
"168.159.143.225",13740,"244.3.160.239",80,12,1833,6,1100,6,733,151.589135,0.4677499999999952,18813.468733297894,12536.61143773396
"168.159.143.225",4824,"244.3.160.239",80,12,1848,6,1107,6,741,151.589297,0.472311000000019,18750.357285770697,12551.052166898
"168.159.143.225",4171,"244.3.160.239",80,14,3712,6,1097,8,2615,151.597592,0.46748200000001816,18772.915320803066,44750.38611112125
"168.159.143.225",7088,"244.3.160.239",80,16,6694,7,1092,9,5602,151.600935,0.5582740000000115,15648.230080569434,80275.99350856224
"168.159.143.225",15165,"244.3.160.239",80,12,1752,6,1040,6,712,151.604971,0.4565729999999917,18222.71575410756,12475.551554735177
"168.159.143.225",12513,"244.3.160.239",80,12,1745,6,1039,6,706,151.679042,0.48006999999998357,17314.14168767114,11764.950944654307
"168.159.143.225",6446,"244.3.160.239",80,12,2508,6,1039,6,1469,152.04956,0.5220949999999789,15920.474243193932,22509.313439125974
"168.159.143.225",8885,"244.3.160.239",80,12,2305,6,1040,6,1265,152.053839,0.5215729999999894,15951.745968445777,19402.84485584991
"168.159.143.225",6383,"244.3.160.239",80,11,1481,5,818,6,663,152.479828,0.3693759999999884,17716.36489647461,14359.35198821842
"168.159.143.225",2722,"244.3.160.239",80,6,1208,4,1078,2,130,153.112835,0.188477000000006,45756.246120214804,5517.914652716071
"168.159.143.225",13796,"244.3.160.239",80,130,123677,43,3574,87,120103,153.305428,1.453158000000002,19675.76822341408,661197.1994786519
"168.198.48.241",3661,"41.177.98.176",80,51,41253,19,2404,32,38849,186.493693,4.579088999999982,4199.962044852169,67872.01559087435
"168.198.48.241",3664,"41.177.98.176",80,72,58959,29,3906,43,55053,190.455973,18.566866000000005,1682.9980891767082,23720.966155515955
"168.198.48.241",3668,"41.177.98.176",80,61,63709,17,1474,44,62235,190.54983,0.5180310000000077,22763.116493028072,961100.7835438277
"168.198.48.241",3669,"41.177.98.176",80,46,30924,19,3545,27,27379,190.5499,18.47424699999999,1535.1099289730191,11856.07186046609
"168.198.48.241",3670,"41.177.98.176",80,35,18586,17,3534,18,15052,190.549972,18.47362799999999,1530.3978189882364,6518.264847597887
"168.198.48.241",3672,"41.177.98.176",80,20,12446,8,1313,12,11133,190.554563,0.5133030000000076,20463.546871925246,173511.5516566213
"168.198.48.241",3673,"41.177.98.176",80,21,8440,11,1772,10,6668,191.154778,17.869389000000012,793.3119593512677,2985.2167860915647
"168.198.48.241",3674,"41.177.98.176",80,11,3286,6,774,5,2512,192.172372,16.850841000000003,367.4594045484139,1192.5814266480822
"168.198.48.241",3675,"41.177.98.176",80,21,13475,9,966,12,12509,192.176961,16.846407999999997,458.7328052365823,5940.257412737482
"176.83.186.135",59453,"41.177.98.142",80,18,9010,9,852,9,8158,164.954108,17.927075000000002,380.2070332165174,3640.5269682867947
"177.4.241.90",10482,"41.177.26.91",80,50,37979,22,4531,28,33448,53.843288,60.363296000000005,600.4973618405462,4432.892464984019
"177.4.241.90",28815,"41.177.26.91",80,17,6662,9,1181,8,5481,54.567332,62.952874,150.08051896089765,696.5210198346147
"177.4.241.90",41536,"41.177.26.91",80,23,15010,11,1319,12,13691,54.569013,59.637235000000004,176.93643912230337,1836.5707263255915
"177.4.241.90",59909,"41.177.26.91",80,22,10907,11,2295,11,8612,54.570684,66.664247,275.409996005805,1033.4775100662278
"177.4.241.90",41536,"41.177.26.91",8000,6,420,0,0,6,420,84.653677,119.151527,0,28.199386819440424
"177.4.241.90",28815,"41.177.26.91",8000,3,210,0,0,3,210,84.653739,14.060050000000004,0,119.48748404166412
"177.4.241.90",10482,"41.177.26.91",8000,7,490,0,0,7,490,84.653844,96.761016,0,40.51218312961906
"177.4.241.90",59909,"41.177.26.91",8000,6,420,0,0,6,420,84.883641,127.43162099999999,0,26.36708199764641
"177.93.197.22",3765,"244.3.31.168",445,2,132,2,132,0,0,184.934026,2.94380000000001,358.7200217406061,0
"177.106.41.4",15754,"244.3.31.168",445,2,132,2,132,0,0,131.183206,3.025980999999973,348.977736476207,0
"177.117.203.142",4630,"244.3.160.239",80,15,6188,7,1345,8,4843,115.295077,0.05629199999999912,191146.16641796645,688268.3152135402
"177.117.203.142",12847,"244.3.160.239",80,10,1898,5,1340,5,558,115.354441,0.014962000000011244,716481.7537756946,298355.8347812221
"177.117.203.142",12879,"244.3.160.239",80,13,4151,6,1423,7,2728,115.37828,0.27642099999999914,41183.55696564312,78952.03331150697
"177.117.203.142",13940,"244.3.160.239",80,12,3365,6,1532,6,1833,115.672273,0.2562649999999991,47825.49314186504,57222.01627221842
"177.117.203.142",9678,"244.3.160.239",80,10,2690,5,1538,5,1152,115.938753,0.01357299999999384,906505.5625142256,678995.0637297711
"177.117.203.142",5783,"244.3.160.239",80,56,38822,19,2375,37,36447,115.953354,0.24156099999999014,78655.08091124301,1207049.1511461365
"177.117.203.142",6463,"244.3.160.239",80,10,1698,5,1210,5,488,118.379826,0.009353000000004386,1034962.0442633872,417406.17983515124
"177.210.26.90",20189,"244.3.61.215",445,2,140,2,140,0,0,175.864238,2.922206999999986,383.2719584889111,0
"177.220.79.75",1471,"244.3.31.41",445,2,132,2,132,0,0,159.058873,3.0435410000000047,346.96427615070684,0
"184.4.145.41",2906,"244.3.41.84",23,7,2390,4,319,3,2071,33.124007,7.354013000000002,347.02141538232246,2252.919596416269
"184.4.145.117",2180,"244.3.41.84",23,5,320,2,128,3,192,18.482842,0.28992299999999815,3531.9722822956664,5297.9584234435
"184.4.145.224",2726,"244.3.41.84",23,5,320,2,128,3,192,139.528871,0.29207999999999856,3505.8887975897187,5258.833196384578
"184.4.145.252",3294,"244.3.41.84",23,5,320,2,128,3,192,139.533379,0.28732800000000225,3563.8712551508797,5345.80688272632
"184.75.94.64",1551,"244.3.41.84",23,3,192,1,64,2,128,139.536812,0.2845760000000155,1799.1678848531574,3598.3357697063147
"184.75.94.223",4319,"244.3.41.84",23,3,192,1,64,2,128,139.52531,0.29626400000000785,1728.1883725325602,3456.3767450651203
"184.75.224.75",1326,"244.3.41.84",23,16,9150,8,638,8,8512,65.661808,145.69845200000003,35.03125757300427,467.3762765852858
"184.75.224.111",1590,"244.3.41.84",23,3,192,1,64,2,128,18.471162,0.3026459999999993,1691.745471607096,3383.490943214192
"186.116.68.136",1665,"41.177.26.176",80,33,13310,15,1634,18,11676,62.080848,137.577014,95.01587234623366,678.9506276099291
"186.116.68.136",60752,"41.177.26.176",80,2,140,1,70,1,70,62.080852,0.00032099999999957163,0,0
"186.116.68.136",60572,"41.177.26.176",80,2,140,1,70,1,70,62.080951,0.00043099999999896,0,0
"186.116.68.136",60847,"41.177.26.15",80,2,134,1,70,1,64,65.002483,0.00028100000000108594,0,0
"186.116.68.136",1939,"41.177.26.15",80,188,148659,69,5380,119,143279,65.002487,135.660229,317.2632120501581,8449.28545712539
"186.181.116.61",4550,"41.177.98.142",80,4,256,2,128,2,128,14.983357999999999,7.419965000000001,138.00604180747482,138.00604180747482
"186.181.192.43",1249,"244.3.41.84",23,5,320,2,128,3,192,18.492734,0.2796990000000008,3661.0785165481357,5491.6177748222035
"186.205.77.68",5380,"41.177.26.176",80,17,9067,7,1220,10,7847,2.12825,20.159326,484.14317026273596,3113.9929975833516
"186.205.77.68",4686,"41.177.26.176",80,42,22498,17,3398,25,19100,22.288397,36.759389,739.5117475973282,4156.761147471739
"186.205.77.68",5133,"41.177.26.176",80,19,8922,9,1348,10,7574,59.048429,33.83342400000001,318.73806210095665,1790.8917524871258
"186.205.77.68",4591,"41.177.26.176",80,26,13709,11,2247,15,11462,92.882997,30.478697999999994,589.7889732691339,3008.5274640012517
"186.248.123.139",49953,"41.177.26.176",80,137,90527,63,11101,74,79426,55.943821,28.845892000000006,3078.7052797673923,22027.677285902613
"186.248.123.139",49954,"41.177.26.176",80,167,126066,71,11661,96,114405,57.637792,30.985395000000004,3010.7087548827435,29537.78707678246
"188.41.244.103",2544,"244.3.61.225",445,2,132,2,132,0,0,99.108853,2.9720860000000044,355.3060039312451,0
"193.77.145.67",1388,"41.177.98.176",80,1,64,1,64,0,0,2.867721,0,0,0
"193.77.145.67",1399,"41.177.98.176",80,73,56629,29,4650,44,51979,109.410793,47.842821,777.5461233776327,8691.627945601285
"193.77.145.67",1418,"41.177.98.176",80,55,33053,28,8911,27,24142,152.245161,37.55395300000001,1898.2821861655946,5142.894011716955
"193.77.145.67",1420,"41.177.98.176",80,65,41607,31,9767,34,31840,152.904352,36.901355000000024,2117.429021237837,6902.727555668344
"193.77.145.67",1436,"41.177.98.176",80,7,1446,5,1316,2,130,174.494745,28.848877000000016,364.9362157147398,36.04993012379648
"193.77.145.67",1437,"41.177.98.176",80,32,25000,13,1828,19,23172,186.807597,18.679467000000017,782.8917174135636,9924.051901480905
"194.4.95.90",62917,"244.3.210.197",80,36,26861,17,5215,19,21646,8.764085,131.575065,317.0813558024843,1316.1156333078764
"194.31.224.39",52665,"41.177.26.46",80,35,11435,12,2381,23,9054,179.385784,27.741552000000013,686.623444859898,2610.9570221593935
"194.31.224.39",52666,"41.177.26.46",80,24,6124,9,1163,15,4961,179.457546,27.669838999999996,336.25060124130107,1434.341558691397
"194.31.224.39",52667,"41.177.26.46",80,15,2413,7,1034,8,1379,179.458049,27.669891000000007,298.9531111633218,398.70052252825997
"194.31.224.39",52668,"41.177.26.46",80,151,68607,34,2776,117,65831,179.458291,27.669004,802.6309873676696,19033.861862176174
"194.66.13.218",4131,"244.3.41.84",23,5,320,2,128,3,192,18.495363,0.27688699999999855,3698.2595788173708,5547.389368226056
"194.66.108.56",3073,"244.3.41.84",23,5,320,2,128,3,192,18.494545,0.27807200000000165,3682.4994965332503,5523.749244799875
"194.66.121.72",1861,"244.3.41.84",23,35,20373,14,3833,21,16540,7.72851,44.130014,694.8558865175071,2998.4128262456475
"194.66.143.67",2289,"244.3.41.84",23,5,320,2,128,3,192,139.529307,0.2919520000000091,3507.4258782264487,5261.138817339673
"194.66.143.176",3903,"244.3.41.84",23,3,701,1,66,2,635,64.489122,0.004680000000007567,0,0
"194.66.167.93",1594,"244.3.41.84",23,33,6525,18,2231,15,4294,163.521516,8.794871999999998,2029.364384154767,3905.912445343151
"194.66.181.220",1530,"244.3.41.84",23,6,384,3,192,3,192,139.526489,0.22728100000000495,6758.154003194137,6758.154003194137
"194.66.204.45",1109,"244.3.41.84",23,13,3576,6,460,7,3116,18.476904,133.21631100000002,27.624244901962488,187.12423285764154
"194.66.204.66",1539,"244.3.41.84",23,5,320,2,128,3,192,18.470846,0.30308199999999985,3378.6236068126796,5067.935410219019
"194.66.204.103",1656,"244.3.41.84",23,5,320,2,128,3,192,18.486245,0.28662100000000024,3572.662156645881,5358.993234968822
"194.66.204.111",1101,"244.3.41.84",23,5,362,2,146,3,216,18.4791,0.2943390000000008,3968.2135225029538,5870.7816497303975
"194.66.204.209",4513,"244.3.41.84",23,55,20480,28,2878,27,17602,53.608281,157.122753,146.5351106723544,896.2164760440521
"194.66.204.244",3105,"244.3.41.84",23,5,320,2,128,3,192,139.531256,0.2898219999999867,3533.2031384782626,5299.804707717393
"194.168.142.150",50737,"41.177.98.127",210,12,977,5,440,7,537,188.05109,3.200222000000025,1099.9236927938039,1342.406870523347
"197.33.149.72",61065,"41.177.26.176",80,33,10546,17,1398,16,9148,189.132646,2.2991859999999917,4864.330245573886,31830.395626974183
"197.33.149.108",46404,"41.177.26.15",80,177,159640,64,4821,113,154819,186.938869,2.4033279999999877,16047.747123988152,515348.71644653013
"197.33.149.108",37300,"41.177.26.15",80,11,1550,6,686,5,864,206.451182,2.1526599999999974,2549.403993199115,3210.911151784308
"197.33.149.117",43790,"41.177.26.176",80,36,14436,18,1794,18,12642,184.534853,4.011957999999993,3577.305644774952,25208.638774384024
"197.193.211.106",3038,"41.177.98.127",210,16,2644,8,720,8,1924,5.010259,1.5906990000000008,3621.049614037601,9676.249246400477
"198.130.142.77",2865,"41.177.98.127",210,14,1162,7,631,7,531,67.935891,1.592993000000007,3168.877703794039,2666.6783846507683
"198.130.142.77",2895,"41.177.98.127",210,14,1162,7,631,7,531,164.412705,1.589396000000022,3176.0492665137763,2672.713408112227
"198.177.110.202",22358,"41.177.26.22",80,11,1667,6,578,5,1089,27.564927,101.207351,45.68838087660253,86.0807037623186
"198.177.110.202",23553,"41.177.26.22",80,9,1539,5,514,4,1025,158.394924,15.147469999999998,271.4644755856919,541.3445281621288
"198.222.241.108",1526,"41.177.98.127",210,14,1158,7,627,7,531,166.138009,1.4624809999999968,3429.7881476750886,2904.6531202798596
"203.22.116.24",1195,"244.3.41.84",23,3,701,1,66,2,635,64.492885,0.011796000000003914,44760.935910463275,430654.4591385482
"203.22.116.186",1229,"244.3.41.84",23,10,2900,6,555,4,2345,63.853484,13.460366,329.857301057044,1393.7213891509339
"203.22.116.204",1711,"244.3.41.84",23,63,24243,38,2696,25,21547,18.938244,177.983859,121.17952785819753,968.4923170476936
"203.22.116.244",1158,"244.3.41.84",23,7,4255,4,344,3,3911,153.480139,5.393903999999992,510.2055950569391,5800.622332173514
"203.43.142.224",55806,"244.3.210.197",80,49,41485,19,4456,30,37029,40.975579,7.59836,4691.5387004564145,38986.30757163388
"203.43.142.224",55880,"244.3.210.197",80,55,30177,29,20846,26,9331,41.520287,2.472383999999998,67452.30514353763,30192.7208718387
"203.67.168.48",54249,"41.177.98.143",8001,3,298,2,158,1,140,182.453693,0.21793400000001384,5799.921077022951,5139.170574577298
"203.95.211.244",52878,"41.177.98.127",210,15,1230,8,693,7,537,156.188264,1.6365820000000042,3387.547950545702,2624.9830439293532
"203.188.177.164",26080,"41.177.98.127",210,16,2667,8,723,8,1944,4.734081,1.6700410000000003,3463.388024605383,9312.346223835222
"204.41.197.117",11632,"41.177.26.176",80,3,192,0,0,3,192,53.265556,119.99983,0,12.800018133359021
"208.51.205.98",1267,"41.177.26.176",80,30,14831,13,2010,17,12821,6.681607,17.427532,922.6779787292888,5885.400181735429
"208.51.205.98",1269,"41.177.26.15",80,187,172558,66,5199,121,167359,9.382005,17.542467000000002,2370.9322069695213,76321.76249782884
"208.51.205.98",1271,"41.177.26.176",80,29,14738,12,1924,17,12814,57.83516,17.776937000000004,865.8409488653753,5766.57272284871
"208.51.205.98",1273,"41.177.26.15",80,194,164331,79,6529,115,157802,61.2174,18.475246999999996,2827.1340567192424,68330.12841452134
"208.51.205.98",1277,"41.177.26.176",80,33,15056,15,2158,18,12898,140.8801,17.355841999999996,994.7082947632275,5945.202773798012
"208.51.205.98",1279,"41.177.26.15",80,204,175030,82,6499,122,168531,143.503586,19.641498999999982,2647.048476289923,68642.82608980105
"208.51.205.98",1281,"41.177.26.176",80,30,14810,13,1994,17,12816,172.393932,17.34929599999998,919.460939510169,5909.634604193744
"208.51.205.98",1283,"41.177.26.15",80,144,130169,51,4149,93,126020,174.955446,16.891460999999993,1965.0165252135391,59684.594482383756
"208.247.67.121",4929,"244.3.31.41",445,2,132,2,132,0,0,166.771816,2.960710000000006,356.67120386663936,0
"209.47.40.117",10586,"244.3.160.239",80,11,1494,6,609,5,885,87.17557,0.3150810000000064,15462.690546240177,22470.412370151982
"209.47.40.117",5997,"244.3.160.239",80,11,1628,6,626,5,1002,87.318775,1.1677760000000035,4288.493683720153,6864.330145507337
"209.47.40.117",9718,"244.3.160.239",80,10,1424,5,539,5,885,147.962319,0.09560399999998026,45102.71536756716,74055.4788502726
"209.47.40.117",15541,"244.3.160.239",80,10,1558,5,556,5,1002,148.057809,0.09864799999999718,45089.611548132016,81258.6164950149
"209.108.145.209",57359,"244.3.210.197",80,26,16995,14,1663,12,15332,3.4161,0.8895739999999996,14955.473069131973,137881.72765840733
"209.108.145.209",57361,"244.3.210.197",80,60,48588,26,5760,34,42828,17.688475,130.820807,352.2375458209794,2619.032918823074
"209.108.145.209",57363,"244.3.210.197",80,9,3464,5,1085,4,2379,19.486722,129.022599,67.27503605783045,147.50904219500336
"209.108.145.209",57364,"244.3.210.197",80,9,3459,5,1085,4,2374,19.496599,129.012757,67.28016827049127,147.21024836326845
"209.108.145.209",57365,"244.3.210.197",80,9,3577,5,1085,4,2492,19.502822,129.00655999999998,67.28340016197627,154.53477714621647
"209.108.145.209",57366,"244.3.210.197",80,9,3343,5,1085,4,2258,19.509185,129.000236,67.28669860728007,140.0307515716483
"209.108.145.209",57367,"244.3.210.197",80,9,3711,5,1085,4,2626,19.522398,128.987045,67.29357975446294,162.8690695255481
"209.116.176.202",1946,"244.3.210.197",80,94,85491,35,4786,59,80705,183.239854,29.82595999999998,1283.7139190155162,21646.914298818894
"209.116.176.202",1951,"244.3.210.197",80,48,39232,20,3198,28,36034,186.14979,26.866243999999995,952.2730456851358,10729.895849974417
"209.116.176.202",1952,"244.3.210.197",80,75,69306,28,3324,47,65982,186.153649,25.825974000000002,1029.6610691236658,20438.958081503526
"209.116.176.202",1953,"244.3.210.197",80,80,74424,30,3064,50,71360,186.157746,26.874010999999996,912.1079841784691,21242.828247707424
"209.116.176.202",1955,"244.3.210.197",80,90,85682,33,3275,57,82407,186.171599,20.484047000000004,1279.0441263877199,32183.874602513843
"209.116.176.202",1954,"244.3.210.197",80,139,143052,45,3266,94,139786,186.171724,23.130459000000002,1129.5928022872351,48346.98697505311
"210.90.111.210",49369,"41.177.26.176",80,29,16495,13,2346,16,14149,202.288158,3.1648209999999892,5930.193208399484,35765.68785406833
"210.90.111.210",49371,"41.177.26.176",80,65,55767,24,2027,41,53740,203.099958,1.9724190000000021,8221.376898113424,217965.8581670525
"210.90.111.210",49374,"41.177.26.176",80,13,4834,6,1398,7,3436,203.104007,2.16543200000001,5164.789289157983,12694.002859475557
"210.90.111.210",49375,"41.177.26.176",80,14,4610,7,1463,7,3147,203.105957,2.335484000000008,5011.380938597721,10779.778409956956
"210.90.111.210",49379,"41.177.26.176",80,24,11224,8,1371,16,9853,203.47967,2.044228000000004,5365.350636034717,38559.29964759305
"210.197.167.105",3237,"41.177.26.15",80,437,409742,158,10292,279,399450,0.110632,159.954949,514.7449360882232,19978.12521574434
"213.197.255.209",57944,"41.177.98.127",210,14,1229,7,628,7,601,12.8519,1.458767,3444.0044229133237,3295.9341690619544
"213.197.255.209",58002,"41.177.98.127",210,14,1229,7,628,7,601,191.931805,1.4276030000000048,3519.1856559561606,3367.8830879453067
"214.106.244.94",3269,"244.3.210.39",1080,3,198,3,198,0,0,114.300014,9.154612999999998,173.02752175324073,0
"215.108.215.222",3887,"244.3.210.197",80,1,64,0,0,1,64,18.509217,0,0,0
"215.108.215.222",3893,"244.3.210.197",80,1,64,0,0,1,64,23.509236,0,0,0
"215.108.215.222",3892,"244.3.210.197",80,1,64,0,0,1,64,23.50926,0,0,0
"215.108.215.222",3896,"244.3.210.197",80,1,64,0,0,1,64,23.509282,0,0,0
"215.108.215.222",3890,"244.3.210.197",80,1,64,0,0,1,64,23.509321,0,0,0
"215.108.215.222",3889,"244.3.210.197",80,1,64,0,0,1,64,23.509341,0,0,0
"215.108.215.222",3891,"244.3.210.197",80,1,64,0,0,1,64,23.509366,0,0,0
"215.108.215.222",3894,"244.3.210.197",80,1,64,0,0,1,64,23.509396,0,0,0
"215.151.186.136",62712,"244.3.210.197",80,32,22990,13,2191,19,20799,95.88145,1.2362719999999996,14178.109671658021,134591.74032898914
"215.151.186.136",62717,"244.3.210.197",80,9,1517,5,1048,4,469,96.749639,0.3139280000000042,26706.760785912335,11951.785122703135
"215.224.55.83",1932,"41.177.26.15",80,10,1205,5,534,5,671,173.856122,1.3548069999999939,3153.2166574279727,3962.1879721613664
"215.224.55.83",1934,"41.177.26.15",80,42,32496,17,1509,25,30987,174.868942,19.853413999999987,608.0566294542596,12486.315955532895
"215.224.91.90",12610,"244.3.160.239",80,10,2486,5,1034,5,1452,9.943294999999999,0.19954500000000053,41454.30855195559,58212.433285724874
"215.224.91.90",6111,"244.3.160.239",80,164,113939,57,4681,107,109258,15.711146,0.9742660000000001,38437.14139670275,897151.2913311148
"215.224.91.90",7483,"244.3.160.239",80,10,1813,5,1304,5,509,16.975116,0.32889000000000124,31718.81176077096,12381.039253245719
"215.224.91.90",12631,"244.3.160.239",80,10,2372,5,1698,5,674,16.985893,0.4261009999999992,31879.765595480945,12654.276802917642
"215.224.91.90",14286,"244.3.160.239",80,91,62156,32,3083,59,59073,18.510749,0.6643599999999985,37124.45059907287,711337.226804746
"215.224.91.90",7060,"244.3.160.239",80,10,1790,5,1281,5,509,19.401229999999998,0.4142720000000004,24737.370616406588,9829.290900664288
"215.224.91.90",4348,"244.3.160.239",80,10,2156,5,1482,5,674,19.409302,0.264247000000001,44867.11296627759,20405.151241073614
"215.224.91.90",2800,"244.3.160.239",80,121,84476,42,3741,79,80735,20.776948,1.1796979999999984,25369.204660853913,547496.0540748572
"215.224.91.90",9638,"244.3.160.239",80,12,2164,6,1332,6,832,21.822879,0.37105999999999995,28717.727591225143,17937.79981674123
"215.224.91.90",2940,"244.3.160.239",80,12,2158,6,1331,6,827,21.823862,0.37116000000000327,28688.436253906417,17825.19668067664
"215.224.91.90",7979,"244.3.160.239",80,10,1830,5,1321,5,509,22.318535,0.2931209999999993,36053.37045111072,13891.874004250838
"215.224.91.90",13800,"244.3.160.239",80,10,2184,5,1510,5,674,22.326083,0.25416799999999995,47527.61952724183,21214.31494129867
"215.224.91.90",8707,"244.3.160.239",80,90,62168,32,3101,58,59067,187.28641,0.7673130000000015,32331.004427137235,615832.1310860093
"215.224.91.90",6066,"244.3.160.239",80,10,1792,5,1283,5,509,188.404253,0.2799449999999979,36664.34478201103,14545.714336744828
"215.224.91.90",15085,"244.3.160.239",80,10,2154,5,1480,5,674,188.41086,0.2530879999999911,46782.146921230626,21304.84258439827
"215.224.91.90",3195,"244.3.160.239",80,10,2486,5,1034,5,1452,188.669993,0.19506799999999203,42405.72518301484,59548.465150616576
"215.224.161.57",12690,"244.3.210.197",80,10,1597,6,931,4,666,111.078158,60.628274000000005,122.84697400424098,87.87979021141192
"215.224.161.57",12691,"244.3.210.197",80,38,20050,20,3099,18,16951,111.204699,0.780629999999988,31758.96391376245,173716.10109783392
"215.224.161.57",12692,"244.3.210.197",80,10,1645,6,1117,4,528,111.597198,0.1100709999999907,81183.96307838355,38375.23053302284
"215.224.161.57",12693,"244.3.210.197",80,10,1637,6,1108,4,529,111.622911,0.10764600000000257,82343.97933968552,39314.047897737946
"215.224.161.57",12694,"244.3.210.197",80,10,1643,6,1114,4,529,111.623158,0.10853299999999422,82113.27430367238,38992.74874923042
"215.224.161.57",12695,"244.3.210.197",80,10,1646,6,1117,4,529,111.632474,0.10758900000000438,83056.818076194,39334.8762419934
"215.224.161.57",12696,"244.3.210.197",80,10,1631,6,1102,4,529,111.632861,0.10866299999999285,81131.57192421137,38946.0994082648
"215.224.161.57",12697,"244.3.210.197",80,10,1629,6,1100,4,529,111.97295,0.10755400000000748,81819.36515610194,39347.67651597993
"215.224.161.57",12698,"244.3.210.197",80,10,1629,6,1100,4,529,112.082933,0.10732600000000048,81993.17965823716,39431.2654901886
"215.224.161.57",12699,"244.3.210.197",80,10,1630,6,1101,4,529,112.242877,0.10753500000001281,81908.21592968755,39354.628725526534
"215.224.161.57",12700,"244.3.210.197",80,10,1630,6,1101,4,529,112.392867,0.10732300000000805,82070.0129515513,39432.36771241656
"215.224.161.57",12701,"244.3.210.197",80,10,1626,6,1098,4,528,112.542987,0.10737699999999961,81805.22830773845,39338.03328459554
"215.224.161.57",12702,"244.3.210.197",80,10,1643,6,1114,4,529,112.65292,0.10750699999999824,82896.92764192235,39364.878566047504
"215.224.161.57",12703,"244.3.210.197",80,10,1647,6,1119,4,528,112.753051,0.10736199999999485,83381.45712636155,39343.52936793467
"215.224.161.57",12704,"244.3.210.197",80,10,1637,6,1109,4,528,112.772982,0.10734300000000019,82650.94137484497,39350.49327855559
"215.224.161.57",12705,"244.3.210.197",80,10,1631,6,1103,4,528,112.773159,0.10821099999999717,81544.39012669904,39034.84858286228
"215.224.161.57",12706,"244.3.210.197",80,10,1631,6,1102,4,529,112.879583,0.10746699999999976,82034.48500469931,39379.530460513546
"215.224.161.57",12707,"244.3.210.197",80,10,1627,6,1098,4,529,112.992934,0.10739299999998764,81793.04051475432,39406.665238893474
"215.224.161.57",12708,"244.3.210.197",80,10,1628,6,1099,4,529,113.102941,0.10737199999999802,81883.54505830348,39414.372462095125
"215.224.161.57",12709,"244.3.210.197",80,10,1632,6,1103,4,529,113.192829,0.10737199999999802,82181.57433968039,39414.372462095125
"215.224.161.57",12710,"244.3.210.197",80,10,1626,6,1097,4,529,113.302938,0.10800100000000157,81258.50686567598,39184.82236275533
"215.224.161.57",12711,"244.3.210.197",80,10,1628,6,1099,4,529,113.432903,0.10737400000000719,81882.01985582554,39413.63831094787
"215.224.161.57",12712,"244.3.210.197",80,10,1636,6,1107,4,529,113.612882,0.10752300000000048,82363.77333221692,39359.0208606529
"215.224.161.57",12713,"244.3.210.197",80,10,1632,6,1103,4,529,113.722957,0.10737900000000877,82176.21695116624,39411.80305273521
"215.224.161.57",12714,"244.3.210.197",80,10,1625,6,1096,4,529,113.812902,0.10732000000000141,81699.59001118044,39433.46999627231
"215.224.161.57",12715,"244.3.210.197",80,10,1659,6,1130,4,529,113.972968,0.10938500000000317,82643.87256022067,38689.03414544844
"215.224.161.57",12716,"244.3.210.197",80,10,1659,6,1130,4,529,113.973147,0.1079859999999968,83714.55559054199,39190.265404775855
"215.224.161.57",12717,"244.3.210.197",80,10,1657,6,1128,4,529,113.973225,0.10776400000000308,83738.53977209219,39270.99959169926
"215.224.161.57",12718,"244.3.210.197",80,10,1669,6,1140,4,529,113.995137,0.10733000000000459,84971.58296841153,39429.795956394475
"215.224.161.57",12719,"244.3.210.197",80,10,1672,6,1143,4,529,113.996662,0.10734399999999766,85184.08108511141,39424.65345058962
"215.224.161.57",12720,"244.3.210.197",80,10,1658,6,1130,4,528,114.022874,0.1074650000000048,84120.4112966975,39305.820499695816
"215.224.161.57",12721,"244.3.210.197",80,10,1658,6,1129,4,529,114.051642,0.10826099999999883,83428.01193412307,39090.71595496112
"215.224.161.57",12722,"244.3.210.197",80,10,1658,6,1130,4,528,114.051853,0.10930000000000462,82708.1427264375,38645.92863677788
"215.224.161.57",12723,"244.3.210.197",80,10,1657,6,1129,4,528,114.052082,0.10771800000000553,83848.56755602162,39213.501921682386
"215.224.161.57",12724,"244.3.210.197",80,10,1670,6,1141,4,529,114.073539,0.10796600000000467,84545.13457940097,39197.52514680378
"215.224.161.57",12725,"244.3.210.197",80,10,1659,6,1130,4,529,114.073772,0.1077669999999955,83884.67712751006,39269.90637208214
"215.224.161.57",12726,"244.3.210.197",80,10,1669,6,1140,4,529,114.103029,0.10732600000000048,84974.7498276276,39431.2654901886
"215.224.161.57",12727,"244.3.210.197",80,10,1698,6,1170,4,528,114.131263,0.10781699999999717,86813.76777317349,39177.49520020137
"215.224.161.57",12728,"244.3.210.197",80,10,1663,6,1135,4,528,114.131456,0.10850399999999638,83683.5508368383,38929.440389295705
"215.224.161.57",12729,"244.3.210.197",80,10,1701,6,1173,4,528,114.131684,0.10930999999999358,85847.58942457737,38642.39319367165
"215.224.161.57",12730,"244.3.210.197",80,10,1704,6,1176,4,528,114.150877,0.1077940000000126,87277.58502327495,39185.8545002459
"215.224.161.57",12731,"244.3.210.197",80,10,1703,6,1174,4,529,114.15109,0.10831400000000713,86710.85916870748,39071.588160346044
"215.224.161.57",12732,"244.3.210.197",80,10,1650,6,1121,4,529,114.202843,0.10775200000000495,83228.15353774953,39275.373078920165
"215.224.161.57",12733,"244.3.210.197",80,10,1704,6,1176,4,528,114.208315,0.10725399999999752,87717.00822347155,39383.14654931376
"215.224.161.57",12734,"244.3.210.197",80,10,1707,6,1179,4,528,114.210263,0.107711000000009,87567.65789937158,39216.05035697048
"215.224.161.57",12735,"244.3.210.197",80,10,1706,6,1177,4,529,114.210701,0.10779300000000092,87352.61102297848,39260.43435102431
"215.224.161.57",12736,"244.3.210.197",80,10,1699,6,1171,4,528,114.238112,0.10745799999999406,87178.24638463881,39308.380948838
"215.224.161.57",12737,"244.3.210.197",80,10,1761,6,1232,4,529,114.362869,0.10731299999999067,91843.48587776744,39436.04223160631
"215.224.161.57",12739,"244.3.210.197",80,44,25311,23,4111,21,21200,116.196002,1.9297690000000074,17042.454304116127,87886.16668627143
"215.224.161.57",12741,"244.3.210.197",80,10,1854,6,1325,4,529,118.05299,0.10779500000001008,98334.80217077796,39259.70592327663
"215.224.161.57",12745,"244.3.210.197",80,20,9811,11,1600,9,8211,118.595094,60.14142700000001,212.8316642702874,1092.2254970770812
"219.24.164.79",3589,"41.177.98.127",210,14,1160,7,630,7,530,10.448099,1.3258230000000015,3801.412405728362,3198.0136111683046
"219.24.164.79",3593,"41.177.98.127",210,22,6286,10,869,12,5417,31.314131,2.485741000000001,2796.751552152858,17433.835624870004
"219.24.164.79",3698,"41.177.98.127",210,14,1160,7,630,7,530,96.177951,1.3493950000000012,3735.0071698798315,3142.148888946525
"219.24.164.79",3714,"41.177.98.127",210,14,1157,7,627,7,530,102.140106,1.4126239999999939,3550.8387228307192,3001.5064164278806
"219.24.164.79",3742,"41.177.98.127",210,14,1165,7,635,7,530,127.811687,1.3759799999999984,3691.9141266588217,3081.4401372113
"219.24.194.38",57969,"244.3.210.197",80,148,112595,71,9213,77,103382,89.264781,8.307402999999994,8872.08673998361,99556.50400010697
"219.39.197.43",51307,"41.177.26.176",80,72,37354,20,4503,52,32851,62.716432,3.8765439999999955,9292.8133925476,67794.40656419746
"219.39.197.43",51308,"41.177.26.176",80,75,55701,29,4362,46,51339,66.276585,18.825772999999998,1853.6290647932494,21816.474680747506
"219.241.81.77",5717,"244.3.210.197",80,7,1355,5,881,2,474,10.287573,62.076550000000005,113.53723749145207,61.085868979509975
"219.241.81.77",5922,"244.3.210.197",80,39,31014,16,2664,23,28350,12.152279,64.619144,329.80938280457565,3509.795796737883
"223.186.247.209",2883,"244.3.61.225",445,2,132,2,132,0,0,155.771112,2.899419000000023,364.2108988042058,0
"223.198.244.193",1609,"41.177.26.46",80,80,63919,31,3723,49,60196,9.352506,27.945453,1065.7905599168494,17232.427758462174
"223.198.244.193",1610,"41.177.26.46",80,35,22658,15,2614,20,20044,10.068356,27.235847999999997,767.8115988898162,5887.53469324693
"223.198.244.193",1611,"41.177.26.46",80,12,3099,6,1018,6,2081,11.526264,25.774700000000003,315.9687600631627,645.904705001416
"223.198.244.193",1612,"41.177.26.46",80,11,2257,6,1014,5,1243,11.527603,25.771974999999998,314.76051020536846,385.8454775002692
"223.198.244.193",1613,"41.177.26.46",80,11,2393,6,1021,5,1372,11.529497,25.776547,316.87719848589495,425.8134342043564
"223.198.244.193",1614,"41.177.26.46",80,11,2031,6,1015,5,1016,11.530899,25.772145000000002,315.06884661715196,315.3792592739176
"223.219.184.43",1170,"244.3.210.197",80,3,192,2,128,1,64,31.777474,4.611951999999999,222.03179911672981,111.01589955836491
"223.219.184.43",1171,"244.3.210.197",80,3,192,2,128,1,64,31.777515,4.610951,222.0800004164,111.0400002082
"224.47.38.154",4193,"41.177.26.176",80,42,22214,20,1992,22,20222,84.023447,0.14519899999999097,109752.82198913897,1114167.45294396
"224.47.38.154",4194,"41.177.26.176",80,10,2373,6,1030,4,1343,84.148115,0.20037299999999902,41123.30503610786,53619.99870242025
"224.47.38.154",4195,"41.177.26.176",80,18,8079,10,1292,8,6787,84.148455,0.0901269999999954,114682.61453283175,602438.780831524
"224.47.38.154",4196,"41.177.26.176",80,12,4056,7,1078,5,2978,84.149021,0.06248899999999935,138008.2894589462,381251.10019363806
"224.47.38.154",4197,"41.177.26.176",80,25,12758,14,1599,11,11159,84.368677,0.11386099999999999,112347.51143938662,784043.7024090778
"224.47.38.154",4198,"41.177.26.176",80,12,3536,7,1104,5,2432,84.369327,0.05982900000000768,147620.71904927152,325193.4680505692
"224.47.38.154",4199,"41.177.26.176",80,16,4614,9,1874,7,2740,84.486408,0.467101999999997,32095.773514136305,46927.651776271865
"224.47.38.154",4200,"41.177.26.176",80,47,17485,25,3659,22,13826,84.48822,2.0903940000000034,14003.101807601797,52912.513143455166
"224.47.38.154",4201,"41.177.26.176",80,10,1877,6,1012,4,865,84.488426,0.16147199999998918,50138.72374158085,42855.72730876228
"224.47.38.154",4202,"41.177.26.176",80,14,5634,8,1155,6,4479,84.490241,0.09071800000000962,101854.09731254018,394982.2526951233
"224.47.38.154",4203,"41.177.26.176",80,34,20357,16,2360,18,17997,84.49106,0.27103299999998853,69659.41416728147,531212.0664273578
"224.47.38.154",4204,"41.177.26.176",80,37,21229,20,2611,17,18618,84.517027,0.4362289999999973,47883.107267054984,341435.34703103395
"224.47.38.154",4205,"41.177.26.176",80,102,90194,38,7186,64,83008,84.52204,2.1329259999999977,26952.646270897378,311339.44637554267
"224.47.38.154",4206,"41.177.26.176",80,30,19581,15,1706,15,17875,84.672114,0.14480500000000518,94250.8891267533,987534.960809329
"224.47.38.154",4207,"41.177.26.176",80,19,10963,10,1349,9,9614,84.673229,0.15178299999999467,71101.5067563586,506723.4143481332
"224.47.38.154",4208,"41.177.26.176",80,28,12175,12,2101,16,10074,84.673665,1.929912999999999,8709.20088107599,41759.39537170849
"224.47.38.154",4209,"41.177.26.176",80,37,12594,17,2497,20,10097,86.702956,0.49828499999999565,40089.50700904136,162108.03054476998
"224.47.38.154",4210,"41.177.26.176",80,12,3921,7,1175,5,2746,86.703406,0.06089099999999803,154374.20965331994,360775.8125174609
"224.47.38.154",4211,"41.177.26.176",80,10,3012,6,1107,4,1905,86.703429,0.2617520000000013,33833.55237018229,58223.050826736464
"224.47.38.154",4212,"41.177.26.176",80,12,3462,7,1180,5,2282,86.709484,0.06311399999999878,149570.61824635076,289254.3651170953
"224.47.38.154",4213,"41.177.26.176",80,22,9878,12,2285,10,7593,86.709723,5.75719500000001,3175.1573465897836,10550.97143661104
"224.47.38.154",4214,"41.177.26.176",80,16,4406,9,2055,7,2351,86.710173,20.812343,789.915868674661,903.6945047465343
"224.47.38.154",4231,"41.177.26.176",80,20,9670,11,1615,9,8055,154.968558,0.5613030000000094,23017.870918202436,114804.30355796944
"224.47.199.136",51172,"41.177.98.143",8001,26,9070,13,1180,13,7890,60.659571,143.589989,65.74274478146245,439.58496298791414
"224.224.68.106",2182,"244.3.41.84",23,2,482,1,64,1,418,64.491066,0.13763399999999137,3720.0110437830194,24296.322129707845
"224.224.68.142",2086,"244.3.41.84",23,17,6035,10,781,7,5254,169.931594,39.46304900000001,158.32532351973103,1065.0976309509178
"224.224.68.225",1396,"244.3.41.84",23,4,256,2,128,2,128,18.487919,0.30279099999999914,3381.870663262788,3381.870663262788
"225.176.204.185",49878,"41.177.26.13",80,349,296518,135,21414,214,275104,193.589653,16.017978,10694.982849895287,137397.61660304441
"225.176.204.185",49879,"41.177.26.13",80,109,74623,49,10433,60,64190,193.638021,16.785746999999986,4972.313713533277,30592.621227997803
"225.176.204.185",49880,"41.177.26.13",80,77,43679,39,9812,38,33867,193.641605,16.797834999999992,4672.983155269714,16129.221414545395
"225.176.204.185",49881,"41.177.26.13",80,56,35587,25,5319,31,30268,193.765453,16.662008999999983,2553.8336943642294,14532.701308707747
"231.116.39.192",24506,"244.3.210.197",80,52,45627,19,5688,33,39939,186.333869,3.568835000000007,12750.379325466129,89528.37550629249
"231.116.39.192",24793,"244.3.210.197",80,27,13653,16,6930,11,6723,187.556093,2.738938999999988,20241.414649979517,19636.800965629478
"231.116.39.192",24794,"244.3.210.197",80,25,10826,16,6931,9,3895,187.556307,2.7334699999999827,20284.839416565886,11399.430028498648
"231.116.39.192",24797,"244.3.210.197",80,28,17507,15,6022,13,11485,187.56151499999999,2.3414160000000095,20575.58332222886,39241.211301195355
"231.116.39.192",24796,"244.3.210.197",80,26,10896,17,7003,9,3893,187.561775,2.755113999999992,20334.548770032805,11304.069450483752
"231.116.39.192",25190,"244.3.210.197",80,8,3570,5,1184,3,2386,190.210523,0.1633470000000159,57986.98476249382,116855.52841495798
"231.116.39.192",25189,"244.3.210.197",80,8,3335,5,1183,3,2152,190.210707,0.16877499999998236,56074.655606582666,102005.62879574463
"231.116.39.192",25201,"244.3.210.197",80,6,1441,4,1106,2,335,190.294987,0.34651999999999816,25533.879718342512,7734.041325176077
"231.116.39.192",25200,"244.3.210.197",80,7,3639,4,1120,3,2519,190.295175,0.21460400000000845,41751.318707944156,93903.18912974226
"231.116.39.192",25209,"244.3.210.197",80,8,3441,5,1183,3,2258,190.317037,0.22549300000000017,41970.26071762757,80108.91690651145
"231.116.39.192",25235,"244.3.210.197",80,6,1437,4,1102,2,335,190.374039,0.37434099999998693,23550.71979825963,7159.247851558054
"239.91.255.122",30447,"41.177.98.176",80,28,22316,9,1567,19,20749,29.119788,17.412370000000003,719.947945052856,9532.992923995986
"239.91.255.128",42887,"41.177.98.176",80,105,103528,24,4558,81,98970,2.209555,27.447671,1328.4915867725172,28846.163304711718
"239.91.255.128",47093,"41.177.98.176",80,7,448,4,256,3,192,29.66792,12.597550000000002,162.57129362455396,121.92847021841547
"239.91.255.128",49726,"41.177.98.176",80,48,44451,16,2272,32,42179,46.801288,25.087621,724.500740823532,13450.139413378416
"239.91.255.197",2627,"41.177.98.176",80,7,448,4,256,3,192,72.157332,11.463949999999997,178.64697595505916,133.98523196629438
"239.152.13.68",12427,"41.177.26.176",80,7,460,4,262,3,198,9.127684,0.503743,4160.851862953927,3144.460568186555
"239.152.156.176",15485,"41.177.26.176",80,7,460,4,262,3,198,209.544237,0.5041119999999921,4157.806201796491,3142.158885327119
"241.3.176.111",51785,"41.177.26.176",80,105,76361,41,7463,64,68898,104.968261,16.094995999999995,3709.4759141288396,34245.67486689653
"241.3.176.111",9450,"41.177.26.176",80,31,10619,15,4327,16,6292,105.145932,15.917320000000004,2174.737958400032,3162.341399180263
"241.3.176.111",3863,"41.177.26.176",80,48,27964,21,4719,27,23245,105.146648,15.91668,2371.8514162501224,11683.340998248379
"241.3.176.111",9576,"41.177.26.176",80,54,32079,24,4832,30,27247,105.147631,20.915640999999994,1848.1862449255086,10421.67438234382
"241.3.176.111",16333,"41.177.26.176",80,25,9769,10,698,15,9071,105.285241,83.376355,66.9734242999709,870.3666645057822
"241.3.176.111",39057,"41.177.26.176",80,29,19263,12,1444,17,17819,105.640281,15.423051000000001,749.0087402291543,9242.788602592314
"241.3.176.111",6918,"41.177.26.176",80,20,10875,9,1245,11,9630,105.643571,15.419765000000012,645.9242407390769,4996.18509101792
"241.16.181.164",2574,"41.177.98.127",210,14,1116,7,589,7,527,39.798689,23.586346999999996,199.77659109314388,178.74747624123398
"241.22.194.12",3569,"41.177.98.127",210,14,1162,7,632,7,530,77.199629,1.4816119999999984,3412.499358806493,2861.747880011774
"241.22.194.12",3599,"41.177.98.127",210,148,114548,60,4312,88,110236,134.312891,9.639571999999987,3578.5821196210836,91486.21951265068
"241.117.39.77",30043,"244.3.210.197",80,4,280,2,140,2,140,30.98909,0.013372000000000384,83757.10439724558,83757.10439724558
"241.117.39.77",30041,"244.3.210.197",80,4,280,2,140,2,140,30.996345,0.01463099999999784,76549.79153852542,76549.79153852542
"241.117.39.77",29921,"244.3.210.197",80,4,280,2,140,2,140,30.996706,0.01427500000000137,78458.8441330923,78458.8441330923
"241.117.39.77",30042,"244.3.210.197",80,4,280,2,140,2,140,31.084966,0.013351000000000113,83888.84727735679,83888.84727735679
"241.151.91.231",57540,"41.177.98.127",210,13,1297,8,933,5,364,55.743474,126.32648600000002,59.08499663324759,23.0513813231534
"241.203.83.100",61555,"244.3.210.197",80,3,192,2,128,1,64,0.069164,128.440087,7.972588807106616,3.986294403553308
"241.203.83.100",61561,"244.3.210.197",80,1,64,0,0,1,64,123.509301,0,0,0
"241.203.83.100",61557,"244.3.210.197",80,1,64,0,0,1,64,123.509321,0,0,0
"241.203.83.100",61559,"244.3.210.197",80,1,64,0,0,1,64,123.509329,0,0,0
"241.218.55.197",24338,"244.3.210.197",80,209,158064,91,25785,118,132279,49.963482,80.548588,2560.938746685417,13137.809442420023
"241.218.55.197",26238,"244.3.210.197",80,142,96744,68,24969,74,71775,50.750885,79.760882,2504.385545786718,7199.017683881681
"242.106.38.225",58374,"41.177.26.176",80,30,10779,16,1480,14,9299,120.256703,11.094169000000008,1067.227297510971,6705.504486185486
"242.161.77.18",50278,"244.3.210.197",80,31,22369,13,1640,18,20729,77.502417,67.40511500000001,194.6439821369639,2460.228722998247
"242.254.218.67",51074,"41.177.26.176",80,7,490,1,70,6,420,76.372873,104.612525,5.353087500755765,32.11852500453459
"242.254.218.67",51075,"41.177.26.176",80,94,29325,42,4261,52,25064,79.406346,3.2744,10410.456877595896,61236.25702418764
"242.254.218.67",51076,"41.177.26.176",80,29,10553,12,1197,17,9356,85.386487,24.269419999999997,394.5706160262586,3084.0456838276323
"242.254.218.67",51077,"41.177.26.176",80,18,8006,8,1104,10,6902,85.499013,24.15615799999999,365.6210561298698,2285.793957797429
"244.3.0.176",1094,"244.3.41.84",23,4,256,2,128,2,128,18.489803,0.1611280000000015,6355.195869122626,6355.195869122626
"244.3.0.204",3055,"244.3.41.84",23,24,9248,12,910,12,8338,0.071864,160.874037,45.25279613639584,414.63496064315217
"244.3.3.41",1139,"244.3.41.84",23,30,5616,15,1414,15,4202,18.493058,102.202243,110.68250233999268,328.9164602776869
"244.3.3.72",1493,"244.3.41.84",23,18,3239,12,792,6,2447,30.678612,149.535658,42.37116474252582,130.91191934969783
"244.3.3.72",1160,"244.3.41.84",23,5,2795,2,201,3,2594,81.265931,0.37079599999999857,4336.616360478555,55966.08377652423
"244.3.3.106",2292,"244.3.41.84",23,4,256,2,128,2,128,18.472916,0.1557959999999987,6572.697630234464,6572.697630234464
"244.3.3.106",2106,"244.3.41.84",23,4,256,2,128,2,128,18.483538,0.1645380000000003,6223.486367890689,6223.486367890689
"244.3.3.155",1158,"244.3.41.84",23,4,256,2,128,2,128,139.539878,0.15185999999999922,6743.052811800377,6743.052811800377
"244.3.4.230",1421,"244.3.41.84",23,4,256,2,128,2,128,139.542439,0.17603900000000294,5816.892847607535,5816.892847607535
"244.3.22.128",1554,"244.3.41.84",23,4,256,2,128,2,128,139.524678,0.19021299999999997,5383.438566238901,5383.438566238901
"244.3.25.61",1520,"244.3.41.84",23,4,256,2,128,2,128,139.528055,0.16811799999999266,6090.95992100813,6090.95992100813
"244.3.31.46",13637,"181.51.224.13",1723,2,132,0,0,2,132,69.230884,2.805450999999991,0,376.41006740092894
"244.3.31.46",34303,"41.177.230.224",25,46,31306,27,29377,19,1929,117.940164,5.0992219999999975,46088.599398104285,3026.344018754235
"244.3.31.68",22289,"46.242.152.255",80,1,64,0,0,1,64,16.911366,0,0,0
"244.3.31.84",31100,"244.3.41.84",2596,13,1202,5,398,8,804,1.2837830000000001,180.437575,17.645991972570013,35.64667725112133
"244.3.31.84",61344,"244.3.41.84",31100,12,1128,8,800,4,328,16.369914,180.279913,35.500349947473076,14.55514347846396
"244.3.31.84",31111,"41.177.180.176",3938,2,182,0,0,2,182,27.586959,0.21859099999999998,0,6660.8414802073285
"244.3.31.84",61562,"41.177.180.176",31111,1,82,0,0,1,82,27.75276,0,0,0
"244.3.31.98",57577,"41.177.98.220",7000,11,1193,6,609,5,584,3.69769,1.325752,3674.895455560316,3524.0376782384637
"244.3.31.98",57534,"41.177.98.220",7000,34,6205,18,2508,16,3697,5.07471,0.3800730000000003,52789.858790284976,77816.62996319121
"244.3.31.98",56651,"41.177.98.220",7000,4,256,2,128,2,128,188.466173,0.03957099999999514,25877.536579821735,25877.536579821735
"244.3.31.98",56721,"41.177.98.220",7000,4,256,2,128,2,128,188.485016,0.02078199999999697,49273.40968146229,49273.40968146229
"244.3.31.108",4925,"244.3.160.239",80,11,1468,6,571,5,897,44.781238,0.010951999999996076,417092.76844426926,655222.7903581603
"244.3.31.108",4013,"244.3.160.239",80,11,1611,6,588,5,1023,44.793889,0.009205000000001462,511026.61596950056,889082.0206408148
"244.3.31.108",2420,"244.3.160.239",80,11,1638,6,615,5,1023,44.803981,0.006169999999997344,797406.8071316236,1326418.152350652
"244.3.31.108",10152,"244.3.160.239",80,17,5562,8,743,9,4819,44.811021,0.028856000000004656,205988.3559744608,1336013.3074575055
"244.3.31.108",7183,"244.3.160.239",80,11,1468,6,571,5,897,69.259891,0.003117000000003145,0,0
"244.3.31.108",9335,"244.3.160.239",80,11,1611,6,588,5,1023,69.263966,0.008341999999998961,563893.5507073347,981059.6979142914
"244.3.31.108",11583,"244.3.160.239",80,11,1638,6,615,5,1023,69.273234,0.005991999999992004,821094.7930585056,1365821.0947948801
"244.3.31.108",14767,"244.3.160.239",80,17,5562,8,743,9,4819,69.2799,0.029342999999997232,202569.607742922,1313839.7573528145
"244.3.31.108",9375,"244.3.160.239",80,11,1468,6,571,5,897,94.381011,0.010983999999993443,415877.64020418125,653313.9111438714
"244.3.31.108",11377,"244.3.160.239",80,11,1611,6,588,5,1023,94.393741,0.008548999999987927,550239.7941287452,957304.9479484801
"244.3.31.108",13434,"244.3.160.239",80,11,1638,6,615,5,1023,94.403285,0.005509000000003539,893084.0442905863,1485569.0687955604
"244.3.31.108",9233,"244.3.160.239",80,17,5562,8,743,9,4819,94.409722,0.028690999999994915,207172.98107424116,1343696.6296053408
"244.3.31.108",10027,"244.3.160.239",80,11,1468,6,571,5,897,192.412586,0.0030679999999847496,0,0
"244.3.31.108",2758,"244.3.160.239",80,11,1611,6,588,5,1023,192.416932,0.008093000000002348,581243.0495488243,1011244.2851844341
"244.3.31.108",2356,"244.3.160.239",80,11,1638,6,615,5,1023,192.425821,0.005527999999998201,890014.4717803185,1480463.096961408
"244.3.31.108",14866,"244.3.160.239",80,17,5562,8,743,9,4819,192.432215,0.028525999999999385,208371.31038351427,1351468.835448392
"244.3.31.117",57685,"41.177.98.220",7000,131,108993,59,29451,72,79542,75.323779,133.334734,1767.0414372297018,4772.469865204066
"244.3.31.117",57915,"41.177.98.220",7000,40,28569,25,26365,15,2204,208.748421,2.169916999999998,97201.87454174523,8125.656419116499
"244.3.31.156",53324,"244.3.41.84",1521,208,60592,95,29141,113,31451,75.068582,15.232311999999993,15304.833566959507,16518.04401065315
"244.3.31.156",53355,"244.3.41.84",1521,199,59607,97,29116,102,30491,145.568599,6.154975000000007,37843.85801729491,39631.03018290077
"244.3.31.181",49395,"41.177.98.220",7030,20,2797,11,1559,9,1238,26.115118,1.4069649999999996,8864.470686904084,7039.26536907457
"244.3.31.181",49499,"41.177.98.220",7000,11,1154,6,603,5,551,120.325908,1.3147950000000037,3669.0130400556636,3352.613905589835
"244.3.31.210",60468,"244.3.31.168",25,28,3796,17,2969,11,827,69.562095,0.6504929999999973,36513.84411515589,10170.747417727827
"244.3.34.55",3888,"244.3.31.40",22,12,1104,8,744,4,360,19.6571,181.70292899999998,32.75676420163816,15.850047194341046
"244.3.34.55",2372,"244.3.31.26",443,31,15997,12,2037,19,13960,118.941941,0.14262100000000544,114260.87322343398,783054.3889048299
"244.3.34.55",2373,"244.3.31.26",443,13,2596,7,1712,6,884,119.131174,0.12446199999999408,110041.61912873528,56820.555671613314
"244.3.34.55",2374,"244.3.31.26",443,27,14295,11,1942,16,12353,121.028631,0.08402699999999186,184892.95107526754,1176098.1589252213
"244.3.34.55",2375,"244.3.31.26",443,13,2612,7,1728,6,884,122.342562,0.07360500000000059,187813.32789891842,96080.42931865965
"244.3.34.55",2376,"244.3.31.26",443,63,49535,27,3014,36,46521,122.357592,0.07153499999999724,337065.7719997334,5202600.12581274
"244.3.34.55",2377,"244.3.31.26",443,27,13873,11,1968,16,11905,124.188294,0.12055800000000261,130592.74374159872,789993.1982945797
"244.3.34.55",2378,"244.3.31.26",443,13,2612,7,1728,6,884,124.347729,0.06724499999999978,205576.62279723468,105167.67045877052
"244.3.34.55",2379,"244.3.31.26",443,796,750454,278,19196,518,731258,124.362791,0.6933209999999974,221496.24776979288,8437742.402148532
"244.3.34.55",2380,"244.3.31.26",443,628,624564,198,14064,430,610500,124.365983,0.8391929999999945,134071.6617035661,5819876.953215806
"244.3.34.61",1065,"244.3.41.84",23,11,925,7,464,4,461,40.283063,172.708997,21.492800401127916,21.353838329568898
"244.3.34.136",2386,"244.3.41.84",23,116,38373,68,4799,48,33574,10.159871,128.69888999999998,298.3087111318521,2086.9799265556994
"244.3.34.157",1448,"244.3.41.84",23,347,133984,231,15244,116,118740,75.565062,99.60122,1224.402672979307,9537.23257606684
"244.3.34.165",1093,"41.177.3.224",22,46,4512,24,2956,22,1556,7.822805,202.081692,117.02198138760635,61.59885082514056
"244.3.34.184",1061,"244.3.41.84",23,4,256,2,128,2,128,139.530494,0.16823199999998906,6086.83246944735,6086.83246944735
"244.3.34.194",34018,"244.3.160.254",22,2,153,1,82,1,71,106.486829,0.000529999999997699,0,0
"244.3.34.239",1119,"244.3.41.84",23,2,128,2,128,0,0,18.473285,0.25238900000000086,4057.2291185431873,0
"244.3.34.244",1493,"244.3.41.84",23,4,256,2,128,2,128,139.524053,0.19797399999998788,5172.396375281919,5172.396375281919
"244.3.34.248",60796,"244.3.31.124",443,24,4058,14,1685,10,2373,45.498327,0.02059699999999509,654464.242365549,921687.6244115417
"244.3.39.34",1092,"244.3.41.84",923,4,325,2,151,2,174,83.43436,0.12982200000000432,9305.048450955614,10722.373711697199
"244.3.39.224",52661,"41.177.241.46",443,42,3255,21,1722,21,1533,10.108194,192.741646,71.47391487981793,63.62921690520377
"244.3.41.47",1049,"244.3.41.185",1024,100,39980,40,2600,60,37380,0.182819,153.489872,135.51382725760564,1948.271870342038
"244.3.41.84",2626,"244.3.31.67",1592,444,181364,238,107436,206,73928,0.163559,188.293083,4564.628643315591,3140.9757096600306
"244.3.41.84",2632,"244.3.31.67",1592,88,35373,46,20625,42,14748,7.826606,138.814968,1188.6326264182117,849.9371623959169
"244.3.41.84",2643,"244.3.31.67",1592,79,28365,41,15965,38,12400,11.026177,155.02195500000002,823.8833009169571,639.9093599355007
"244.3.41.84",2652,"244.3.31.67",1592,13,3915,7,1895,6,2020,16.644229,0.4123650000000012,36763.5468577594,39188.582930170975
"244.3.41.84",2636,"244.3.31.67",1592,113,38355,57,18274,56,20081,37.639628,107.19658,1363.7748517723235,1498.629900319581
"244.3.41.84",2629,"244.3.31.67",1592,97,32660,49,15743,48,16917,68.198943,131.31235299999997,959.1176848380748,1030.6418010802079
"244.3.41.84",2715,"244.3.31.67",1593,35,10790,20,6369,15,4421,84.387494,10.900127999999995,4674.440520331506,3244.7325389206453
"244.3.41.120",1032,"244.3.41.185",1024,100,39980,40,2600,60,37380,0.184413,153.488252,135.51525754557426,1948.2924334821405
"244.3.41.164",15585,"244.3.160.239",80,12,2325,6,1674,6,651,140.865774,0.33202200000002335,40334.676617811645,15685.707573593418
"244.3.41.208",1064,"244.3.41.185",1024,4,256,2,128,2,128,4.695025,0.007416000000000089,138079.8274002141,138079.8274002141
"244.3.41.208",1062,"244.3.41.155",923,36,13969,0,0,36,13969,9.250746,49.42636,0,2260.9797686902293
"244.3.41.208",1051,"244.3.41.176",23,2,128,0,0,2,128,139.545578,0.0036849999999901684,0,0
"244.3.41.208",1050,"244.3.41.176",23,2,128,0,0,2,128,140.121615,0.0011820000000000164,0,0
"244.3.41.252",63617,"41.177.3.203",5666,15,3706,9,1904,6,1802,3.097543,0.04303900000000027,353911.5685773346,334952.0202606917
"244.3.41.252",64156,"41.177.3.224",5666,15,3706,9,1904,6,1802,45.215275,0.03922599999999932,388313.8734512891,367511.34451639856
"244.3.41.252",64349,"41.177.3.203",5666,15,3706,9,1904,6,1802,55.551294,0.05702200000000346,267124.96931007464,252814.70309703492
"244.3.41.252",64397,"41.177.3.224",5666,15,3706,9,1904,6,1802,58.43294,0.07665599999999984,198705.90690878773,188060.94761010268
"244.3.41.252",64830,"41.177.3.203",5666,16,3770,9,1904,7,1866,82.536489,0.31901999999999475,47746.222807348284,46793.30449501675
"244.3.41.252",64868,"41.177.3.224",5666,16,3770,9,1904,7,1866,85.325592,0.33635300000000257,45285.756333375604,44381.94396957924
"244.3.47.184",1634,"244.3.41.84",923,4,367,2,169,2,198,83.433916,0.2034400000000005,6645.694062131324,7786.079433739658
"244.3.47.184",1641,"244.3.41.38",923,4,367,2,169,2,198,109.858969,0.1379659999999916,9799.515822739533,11481.089543801347
"244.3.48.41",14538,"244.3.160.239",80,10,2147,5,1286,5,861,39.194096,0.09702800000000167,106031.24871171026,70989.81737230367
"244.3.48.41",15164,"244.3.160.239",80,10,1950,5,1287,5,663,56.162628,0.726742999999999,14167.319121064824,7298.3159108515765
"244.3.48.41",7863,"244.3.160.239",80,149,109721,46,3911,103,105810,56.890429,1.0851919999999993,28831.764332947554,780027.8660366097
"244.3.48.41",15223,"244.3.160.239",80,10,1490,5,1054,5,436,57.555356,0.07689799999999991,109651.74646934913,45358.7869645505
"244.3.48.41",7857,"244.3.160.239",80,10,1483,5,1047,5,436,57.978165,0.07627600000000001,109811.73632597408,45728.66956840945
"244.3.48.41",10876,"244.3.160.239",80,10,1486,5,1050,5,436,57.984052,0.0771920000000037,108819.56679448126,45186.029640375076
"244.3.48.41",4848,"244.3.160.239",80,10,1485,5,1049,5,436,58.055671,0.07499900000000537,111894.82526432886,46507.286763820186
"244.3.48.41",6976,"244.3.160.239",80,10,1487,5,1051,5,436,58.137088,0.07626199999999983,110251.50140305812,45737.06433085951
"244.3.48.41",15242,"244.3.160.239",80,10,1494,5,1058,5,436,58.284392,0.07520900000000097,112539.72263957626,46377.42823332254
"244.3.48.41",5255,"244.3.160.239",80,10,1491,5,1055,5,436,58.363437,0.07446500000000356,113341.83844758742,46840.797690187785
"244.3.48.41",7090,"244.3.160.239",80,10,1492,5,1056,5,436,58.444979000000004,0.07425599999999832,113768.58435682222,46972.63520793038
"244.3.48.41",14531,"244.3.160.239",80,24,11452,10,1377,14,10075,58.533773,0.35539900000000557,30996.147991411985,226787.35730826124
"244.3.48.41",12056,"244.3.160.239",80,10,1497,5,1061,5,436,58.892632,0.07374200000000286,115104.01128257535,47300.046106694484
"244.3.48.41",9463,"244.3.160.239",80,10,1492,5,1056,5,436,58.969536,0.07560300000000097,111741.59755565111,46135.73535441656
"244.3.48.41",15622,"244.3.160.239",80,10,1492,5,1056,5,436,59.050847,0.07426399999999944,113756.32877302682,46967.57513734819
"244.3.48.41",11692,"244.3.160.239",80,12,4150,6,1064,6,3086,59.129897,0.0849410000000006,100210.73450983553,290648.8032869854
"244.3.48.41",11430,"244.3.160.239",80,10,1478,5,1042,5,436,59.13063,0.08081600000000577,103147.89150662499,43159.770342503354
"244.3.48.41",4127,"244.3.160.239",80,10,1477,5,1041,5,436,59.212619,0.07819700000000296,106500.24937017642,44605.29176310943
"244.3.48.41",15206,"244.3.160.239",80,10,1481,5,1045,5,436,59.215904,0.0779849999999982,107200.1025838327,44726.549977560826
"244.3.48.41",9987,"244.3.160.239",80,10,1488,5,1052,5,436,59.294571,0.07564500000000152,111256.5271994161,46110.11963778082
"244.3.48.41",15896,"244.3.160.239",80,10,1491,5,1055,5,436,59.380262,0.07722799999999808,109286.7871756385,45164.96607448188
"244.3.48.41",7658,"244.3.160.239",80,10,1481,5,1045,5,436,59.467423,0.07372900000000016,113388.2190182965,47308.386116724665
"244.3.48.41",2704,"244.3.160.239",80,10,1480,5,1044,5,436,59.567534,0.07517999999999603,111093.37589785105,46395.31790370024
"244.3.48.41",12094,"244.3.160.239",80,10,1498,5,1062,5,436,59.56994,0.07920000000000016,107272.72727272706,44040.404040403955
"244.3.48.41",5138,"244.3.160.239",80,15,5414,7,1188,8,4226,59.644034,0.2596680000000049,36600.58228199016,130197.02081118722
"244.3.48.41",14323,"244.3.160.239",80,14,4818,6,1118,8,3700,59.651925,0.47819199999999995,18703.78425402349,61899.822665372914
"244.3.48.41",15584,"244.3.160.239",80,34,18581,14,1661,20,16920,59.904306,0.4973060000000018,26719.967183182893,272186.54108335613
"244.3.48.41",12482,"244.3.160.239",80,10,1503,5,1067,5,436,60.130872,0.07588100000000253,112491.9281506532,45966.71103438125
"244.3.48.41",9154,"244.3.160.239",80,10,1505,5,1069,5,436,60.207334,0.07703999999999667,111007.26895119899,45275.18172378181
"244.3.48.41",12939,"244.3.160.239",80,10,1511,5,1075,5,436,60.286114,0.0758520000000047,113378.68480724921,45984.28518694015
"244.3.48.41",6042,"244.3.160.239",80,13,4030,6,1118,7,2912,60.362963,0.22377600000000086,39968.539968539815,104104.10410410371
"244.3.48.41",3585,"244.3.160.239",80,14,5547,6,1195,8,4352,60.385133,0.11457699999999704,83437.33908201687,303865.5227489016
"244.3.48.41",5999,"244.3.160.239",80,12,3025,6,1118,6,1907,60.402409,0.26005899999999826,34392.195617148645,58663.61094982332
"244.3.48.41",8246,"244.3.160.239",80,10,1505,5,1069,5,436,60.587316,0.07685099999999778,111280.26961263025,45386.52717596519
"244.3.48.41",4689,"244.3.160.239",80,13,3385,6,1118,7,2267,60.66345,0.22575300000000453,39618.52112707171,80335.58800990302
"244.3.48.41",4217,"244.3.160.239",80,14,6160,6,1118,8,5042,60.667464,0.5257779999999954,17010.981821225076,76716.78921522078
"244.3.48.41",7782,"244.3.160.239",80,10,1505,5,1069,5,436,60.890992,0.0774200000000036,110462.41281322142,45052.957892015474
"244.3.48.41",2901,"244.3.160.239",80,10,1503,5,1067,5,436,60.970458,0.07580000000000098,112612.13720316478,46015.83113456405
"244.3.48.41",14670,"244.3.160.239",80,11,3057,5,1054,6,2003,61.047754,0.3809540000000027,22133.905930899637,42062.82123300946
"244.3.48.41",4493,"244.3.160.239",80,10,1491,5,1055,5,436,61.194771,0.07531900000000036,112056.718756223,46309.696092619175
"244.3.48.41",2832,"244.3.160.239",80,10,1480,5,1044,5,436,61.27087,0.07649399999999673,109185.03412032782,45598.347582818904
"244.3.48.41",11428,"244.3.160.239",80,10,1489,5,1053,5,436,61.348944,0.07494099999999548,112408.42796333793,46543.28071416461
"244.3.48.41",5544,"244.3.160.239",80,10,1496,5,1060,5,436,61.426079,0.07678699999999594,110435.36015211491,45424.355685209535
"244.3.48.41",6651,"244.3.160.239",80,10,1489,5,1053,5,436,61.449841,0.07701500000000294,109381.28935921156,45289.87859507715
"244.3.48.41",12747,"244.3.160.239",80,10,1483,5,1047,5,436,61.50341,0.07533499999999549,111183.38089865934,46299.860622555374
"244.3.48.41",7680,"244.3.160.239",80,10,1488,5,1052,5,436,61.527849,0.0744979999999984,112969.475690625,46820.0488603731
"244.3.48.41",7695,"244.3.160.239",80,10,1491,5,1055,5,436,61.579349,0.07613500000000073,110855.71681880763,45813.357851184956
"244.3.48.41",15834,"244.3.160.239",80,10,1488,5,1052,5,436,61.603538,0.0752209999999991,111883.64951277038,46370.02964597708
"244.3.48.41",14808,"244.3.160.239",80,10,1491,5,1055,5,436,61.657,0.07478100000000154,112862.89298083505,46642.863829046524
"244.3.48.41",9557,"244.3.160.239",80,10,1504,5,1068,5,436,61.679715,0.07428600000000074,115014.94225022096,46953.66556282429
"244.3.48.41",8498,"244.3.160.239",80,10,1492,5,1056,5,436,61.734443,0.07560800000000256,111734.20802031152,46132.68437202256
"244.3.48.41",15335,"244.3.160.239",80,13,4165,6,1065,7,3100,61.755179,0.11898899999999912,71603.25744396594,208422.62730168487
"244.3.48.41",11318,"244.3.160.239",80,10,1497,5,1061,5,436,61.811037,0.07541299999999751,112553.53851458343,46251.9724715913
"244.3.48.41",12633,"244.3.160.239",80,10,1494,5,1058,5,436,61.87513,0.07508700000000346,112722.57514615859,46452.7814401939
"244.3.48.41",12265,"244.3.160.239",80,10,1501,5,1065,5,436,61.888822,0.07526500000000169,113200.02657277364,46342.921676741134
"244.3.48.41",15047,"244.3.160.239",80,10,1490,5,1054,5,436,61.95285,0.0772400000000033,109166.2351113366,45157.9492490918
"244.3.48.41",5674,"244.3.160.239",80,10,1486,5,1050,5,436,61.966291,0.07509300000000252,111861.29199791883,46449.069820088196
"244.3.48.41",9576,"244.3.160.239",80,10,1489,5,1053,5,436,62.030906,0.07421099999999825,113514.16905849805,47001.118432578485
"244.3.48.41",2478,"244.3.160.239",80,10,1491,5,1055,5,436,62.043571,0.07458599999999649,113157.9653018046,46764.80840908702
"244.3.48.41",4351,"244.3.160.239",80,10,1490,5,1054,5,436,62.107261,0.07468999999999681,112893.2922747404,46699.69206051879
"244.3.48.41",2604,"244.3.160.239",80,10,1492,5,1056,5,436,62.119442,0.07695900000000222,109772.73613222309,45322.83423641029
"244.3.48.41",5062,"244.3.160.239",80,10,1541,5,1115,5,426,62.213833,0.07440700000000078,119881.19397368401,45802.14227155999
"244.3.48.41",15122,"244.3.160.239",80,10,1526,5,1110,5,416,62.359986,0.07397300000000229,120043.79976477534,44989.38801995183
"244.3.48.41",2522,"244.3.160.239",80,10,1529,5,1113,5,416,62.366509,0.07368799999999709,120833.78569102638,45163.391597005364
"244.3.48.41",14223,"244.3.160.239",80,48,29520,17,1886,31,27634,63.222743,0.18754099999999596,80451.74121925513,1178792.9039516947
"244.3.48.41",14183,"244.3.160.239",80,10,2501,5,1342,5,1159,63.454017,0.10931999999999675,98207.09842664031,84815.22136846208
"244.3.48.41",12882,"244.3.160.239",80,10,1534,5,1118,5,416,63.584393,0.07379099999999994,121207.1932891546,45100.35099131334
"244.3.48.41",3025,"244.3.160.239",80,10,1524,5,1108,5,416,63.590119,0.07366799999999785,120323.61405223787,45175.65292936007
"244.3.48.41",7123,"244.3.160.239",80,10,1537,5,1111,5,426,63.659141,0.07383800000000207,120371.62436685381,46155.09629188094
"244.3.48.41",15367,"244.3.160.239",80,10,1533,5,1107,5,426,63.664803,0.07264200000000187,121912.9429255771,46915.007846699045
"244.3.48.41",11367,"244.3.160.239",80,10,1529,5,1113,5,416,63.734061,0.0748440000000059,118967.45230077625,44465.822243596514
"244.3.48.41",14265,"244.3.160.239",80,10,1537,5,1121,5,416,63.739147,0.0738799999999955,121386.03140228134,45046.02057390637
"244.3.48.41",2179,"244.3.160.239",80,10,1527,5,1111,5,416,63.81021,0.07483300000000526,118771.13038364593,44472.358451482185
"244.3.48.41",15756,"244.3.160.239",80,10,1539,5,1113,5,426,63.814462,0.07472400000000334,119158.50329210966,45607.83683956758
"244.3.48.41",8482,"244.3.160.239",80,11,1714,5,1067,6,647,63.947968,0.07713799999999083,110658.81925900355,67100.52114393185
"244.3.48.41",13454,"244.3.160.239",80,10,2501,5,1342,5,1159,64.702501,0.11074899999999843,96939.92722282054,83720.84623789047
"244.3.48.41",9890,"244.3.160.239",80,12,2640,6,1731,6,909,65.202094,0.1838470000000001,75323.50269517585,39554.62966488437
"244.3.48.41",16078,"244.3.160.239",80,12,4406,5,1256,7,3150,65.418355,0.13228999999999758,75954.34273187832,190490.58885781586
"244.3.48.41",9504,"244.3.160.239",80,10,1423,5,987,5,436,65.555046,0.07425399999999627,106337.7057128289,46973.900395940625
"244.3.48.41",13534,"244.3.160.239",80,10,1432,5,996,5,436,65.561271,0.07418399999998826,107408.6056292632,47018.22495417546
"244.3.48.41",16101,"244.3.160.239",80,21,11374,12,10308,9,1066,65.765132,0.1599040000000116,515709.42565535585,53331.99919951585
"244.3.48.41",14328,"244.3.160.239",80,12,4406,5,1256,7,3150,65.955412,0.07850400000000946,127993.47803932017,321002.75145211664
"244.3.48.41",4520,"244.3.160.239",80,10,1423,5,987,5,436,66.037793,0.07601100000000827,103879.70162212235,45888.09514411889
"244.3.48.41",11960,"244.3.160.239",80,10,1432,5,996,5,436,66.039071,0.07505699999998683,106159.31891764124,46471.348441859016
"244.3.48.41",12512,"244.3.160.239",80,109,73630,39,3511,70,70119,66.896919,0.5814820000000083,48304.16074788145,964693.6620565933
"244.3.48.41",3671,"244.3.160.239",80,10,1504,5,1068,5,436,67.236572,0.07754100000001074,110186.86888225348,44982.65433769899
"244.3.48.41",9554,"244.3.160.239",80,10,1497,5,1061,5,436,67.480777,0.07528800000000047,112740.41015832467,46328.76421209195
"244.3.48.41",10562,"244.3.160.239",80,10,1500,5,1064,5,436,67.485764,0.08524099999999635,99858.04953015996,40919.27593529111
"244.3.48.41",10443,"244.3.160.239",80,10,1499,5,1063,5,436,67.556856,0.0750150000000076,113363.9938678816,46497.367193223305
"244.3.48.41",14765,"244.3.160.239",80,10,1501,5,1065,5,436,67.638569,0.07592999999999961,112208.61319636565,45937.04728039007
"244.3.48.41",12889,"244.3.160.239",80,10,1508,5,1072,5,436,67.784813,0.0750500000000045,114270.48634243153,46475.68287807849
"244.3.48.41",4416,"244.3.160.239",80,10,1505,5,1069,5,436,67.863864,0.07346899999998868,116402.83657054427,47475.8061223174
"244.3.48.41",3605,"244.3.160.239",80,10,1506,5,1070,5,436,67.944915,0.07430500000000961,115200.86131483605,46941.65937688646
"244.3.48.41",5970,"244.3.160.239",80,24,11466,10,1391,14,10075,68.029252,0.187689000000006,59289.56944732853,429433.7973988749
"244.3.48.41",15793,"244.3.160.239",80,10,1511,5,1075,5,436,68.225503,0.07445299999999122,115509.11313178804,46848.347279497284
"244.3.48.41",7770,"244.3.160.239",80,10,1506,5,1070,5,436,68.303402,0.07603899999999442,112573.81080762015,45871.197674880736
"244.3.48.41",16112,"244.3.160.239",80,10,1506,5,1070,5,436,68.385073,0.0839639999999946,101948.45409938248,41541.61307227174
"244.3.48.41",2075,"244.3.160.239",80,12,4164,6,1078,6,3086,68.473778,0.07659600000000921,112590.73580864488,322314.4811739129
"244.3.48.41",2705,"244.3.160.239",80,10,1492,5,1056,5,436,68.475868,0.07566599999999823,111648.5607802738,46097.32244337062
"244.3.48.41",4405,"244.3.160.239",80,10,1491,5,1055,5,436,68.551335,0.07561600000001079,111616.58908165991,46127.80363943481
"244.3.48.41",12470,"244.3.160.239",80,10,1495,5,1059,5,436,68.552146,0.0776260000000093,109138.69064487395,44933.39860355528
"244.3.48.41",7978,"244.3.160.239",80,10,1502,5,1066,5,436,68.628786,0.07906599999999742,107859.25682341687,44115.04312852698
"244.3.48.41",4507,"244.3.160.239",80,10,1505,5,1069,5,436,68.721872,0.07508399999998971,113899.09967504624,46454.63747270361
"244.3.48.41",12692,"244.3.160.239",80,10,1495,5,1059,5,436,68.808003,0.07571400000000494,111894.7618670186,46068.09837017952
"244.3.48.41",13925,"244.3.160.239",80,10,1494,5,1058,5,436,68.911134,0.07507499999999823,112740.5927405954,46460.206460207555
"244.3.48.41",4621,"244.3.160.239",80,10,1512,5,1076,5,436,68.912145,0.07825100000000873,110004.98396185403,44574.510229896245
"244.3.48.41",9530,"244.3.160.239",80,10,1519,5,1083,5,436,68.987479,0.07526100000001179,115119.38454177653,46345.38472780662
"244.3.48.41",12707,"244.3.160.239",80,10,1517,5,1081,5,436,68.992491,0.07470499999999447,115761.99718895175,46690.31523994724
"244.3.48.41",13336,"244.3.160.239",80,10,1517,5,1081,5,436,69.063614,0.07586700000000235,113988.95435432707,45975.1934306074
"244.3.48.41",12109,"244.3.160.239",80,10,1519,5,1083,5,436,69.068036,0.07548500000000047,114777.77041796313,46207.855865403435
"244.3.48.41",5243,"244.3.160.239",80,10,1525,5,1089,5,436,69.140862,0.07543400000000133,115491.68809820301,46239.0964286653
"244.3.48.41",14647,"244.3.160.239",80,223,158283,73,5417,150,152866,69.144482,0.983514999999997,44062.36813876771,1243425.875558587
"244.3.48.41",8655,"244.3.160.239",80,10,1519,5,1083,5,436,69.21871,0.07580500000000256,114293.25242397872,46012.79598970889
"244.3.48.41",14817,"244.3.160.239",80,10,1494,5,1058,5,436,69.295758,0.07517199999999491,112595.11520247663,46400.25541425313
"244.3.48.41",14537,"244.3.160.239",80,10,1505,5,1069,5,436,69.373053,0.07510399999999606,113868.76864082404,46442.26672347922
"244.3.48.41",6306,"244.3.160.239",80,14,5561,6,1209,8,4352,69.387719,0.11327699999999652,85383.61715088056,307352.7724074708
"244.3.48.41",4250,"244.3.160.239",80,10,1503,5,1067,5,436,69.451662,0.07431200000000615,114867.0470448823,46937.23759284787
"244.3.48.41",6975,"244.3.160.239",80,10,1510,5,1074,5,436,69.527229,0.07543299999998965,113902.4034573884,46239.709411006836
"244.3.48.41",4101,"244.3.160.239",80,10,1503,5,1067,5,436,69.604014,0.07544899999999188,113136.02565972933,46229.90364352576
"244.3.48.41",5906,"244.3.160.239",80,10,1497,5,1061,5,436,69.682574,0.07642599999999788,111061.68057991043,45638.918692592786
"244.3.48.41",8236,"244.3.160.239",80,10,1502,5,1066,5,436,69.760826,0.07489500000001215,113866.07917749672,46571.86728085232
"244.3.48.41",15127,"244.3.160.239",80,10,1502,5,1066,5,436,69.837833,0.07855800000000102,108556.73515109715,44400.31569031741
"244.3.48.41",16212,"244.3.160.239",80,10,1505,5,1069,5,436,69.917244,0.07502999999999815,113981.07423697469,46488.07143809257
"244.3.48.41",3006,"244.3.160.239",80,10,1505,5,1069,5,436,69.994837,0.07544899999999188,113348.08943791065,46229.90364352576
"244.3.48.41",16011,"244.3.160.239",80,10,1518,5,1082,5,436,70.024636,0.07469000000000392,115892.35506760672,46699.69206051435
"244.3.48.41",3169,"244.3.160.239",80,10,1506,5,1070,5,436,70.071943,0.07517199999999491,113872.1864524102,46400.25541425313
"244.3.48.41",7215,"244.3.160.239",80,10,3987,5,1015,5,2972,70.101504,0.08923599999999965,90994.66582993447,266439.55354341405
"244.3.48.41",8937,"244.3.160.239",80,10,1511,5,1075,5,436,70.14858,0.07634400000000596,112648.01425127487,45687.938803307756
"244.3.48.41",9086,"244.3.160.239",80,10,1508,5,1072,5,436,70.191713,0.07591900000001317,112962.49950603291,45943.70315730443
"244.3.48.41",13905,"244.3.160.239",80,10,1515,5,1079,5,436,70.225894,0.07414599999999893,116418.95719256769,47042.3219054305
"244.3.48.41",4372,"244.3.160.239",80,10,1504,5,1068,5,436,70.268477,0.07434200000000146,114928.3043232605,46918.29652148088
"244.3.48.41",12179,"244.3.160.239",80,10,1500,5,1064,5,436,70.30097,0.07536899999999491,112937.67994799685,46278.97411402879
"244.3.48.41",15226,"244.3.160.239",80,10,1503,5,1067,5,436,70.34373,0.0765440000000126,111517.55852840973,45568.561872902195
"244.3.48.41",5637,"244.3.160.239",80,10,1505,5,1069,5,436,70.377614,0.07510800000000017,113862.7043723702,46439.79336422208
"244.3.48.41",3306,"244.3.160.239",80,10,1504,5,1068,5,436,70.421837,0.07621400000000733,112105.38746161044,45765.86978769864
"244.3.48.41",15136,"244.3.160.239",80,10,1545,5,1129,5,416,70.516467,0.07483099999998899,120698.6409375971,44473.54705938033
"244.3.48.41",2142,"244.3.160.239",80,10,1506,5,1070,5,436,70.557274,0.07619499999999846,112343.3296148064,45777.28197388373
"244.3.48.41",5267,"244.3.160.239",80,10,1550,5,1124,5,426,70.626899,0.07438400000000911,120886.21208860641,45816.30458162485
"244.3.48.41",14268,"244.3.160.239",80,10,1553,5,1127,5,426,70.632916,0.07399700000000564,121842.7774098857,46055.92118599052
"244.3.48.41",3119,"244.3.160.239",80,47,29464,16,1830,31,27634,71.259746,0.18497399999999686,79146.2583930728,1195151.7510569256
"244.3.48.41",6843,"244.3.160.239",80,10,2515,5,1356,5,1159,71.460769,0.11404199999999776,95122.84947651053,81303.379456693
"244.3.48.41",3064,"244.3.160.239",80,10,1548,5,1132,5,416,71.665686,0.07442100000000096,121686.0832291945,44718.56062132942
"244.3.48.41",5491,"244.3.160.239",80,10,1538,5,1122,5,416,71.670824,0.07390399999999886,121454.86035938702,45031.39207620767
"244.3.48.41",15547,"244.3.160.239",80,10,1541,5,1125,5,416,71.741386,0.0747169999999926,120454.51503675057,44541.40289358954
"244.3.48.41",14777,"244.3.160.239",80,10,1537,5,1121,5,416,71.748637,0.07421899999999937,120831.59298831939,44840.270011722445
"244.3.48.41",3950,"244.3.160.239",80,10,1543,5,1127,5,416,71.818561,0.07443499999999403,121125.8144690095,44710.14979512685
"244.3.48.41",6025,"244.3.160.239",80,10,1551,5,1135,5,416,71.824,0.07428500000000327,122231.94453792287,44800.43077337085
"244.3.48.41",9499,"244.3.160.239",80,10,1541,5,1125,5,416,71.893991,0.07426700000000608,121184.37529453544,44811.28899780155
"244.3.48.41",15334,"244.3.160.239",80,10,1543,5,1127,5,416,71.899246,0.07586099999998908,118848.94741700344,43869.70907317962
"244.3.48.41",10742,"244.3.160.239",80,12,1792,6,1145,6,647,71.969049,0.13378000000000156,68470.62341157044,38690.38720286993
"244.3.48.41",2384,"244.3.160.239",80,10,2515,5,1356,5,1159,72.259459,0.18152800000000013,59759.37596403856,51077.51972147544
"244.3.48.41",13860,"244.3.160.239",80,12,2815,6,1745,6,1070,72.615462,0.15594900000000678,89516.44447863977,54889.73959435218
"244.3.48.41",13456,"244.3.160.239",80,13,4484,6,1334,7,3150,72.801217,0.07759300000000735,137538.17999045004,324771.56444521557
"244.3.48.41",12641,"244.3.160.239",80,10,1423,5,987,5,436,72.882796,0.07601999999999975,103867.40331491746,45882.66245724824
"244.3.48.41",3826,"244.3.160.239",80,10,1432,5,996,5,436,72.883639,0.07650300000000243,104152.77832241543,45592.983281699926
"244.3.48.41",10701,"244.3.160.239",80,12,3460,6,2586,6,874,73.060571,0.08469100000000651,244276.25131358005,82558.9495932208
"244.3.48.41",7747,"244.3.160.239",80,12,4420,5,1270,7,3150,73.171888,0.07730700000000468,131424.06250403437,325973.0684155183
"244.3.48.41",11787,"244.3.160.239",80,10,1423,5,987,5,436,73.252978,0.07478799999999808,105578.43504305775,46638.49815478539
"244.3.48.41",9164,"244.3.160.239",80,10,1432,5,996,5,436,73.256231,0.07486199999999599,106435.84194919221,46592.39667655402
"244.3.48.41",2714,"244.3.160.239",80,11,4086,5,1000,6,3086,79.201742,0.07911000000000001,101125.0158007837,312071.7987612185
"244.3.48.41",12249,"244.3.160.239",80,12,4101,6,1065,6,3036,79.534755,0.2230299999999943,38201.138860244,108900.14796216035
"244.3.48.41",5157,"244.3.160.239",80,14,5386,6,1195,8,4191,80.097664,0.11022700000000896,86730.11149717604,304172.2989829831
"244.3.48.41",11637,"244.3.160.239",80,10,2501,5,1342,5,1159,82.36592,0.10288199999999392,104352.55924263364,90122.66480045633
"244.3.48.41",14445,"244.3.160.239",80,12,1778,6,1131,6,647,83.019306,0.21835799999999495,41436.53999395584,23704.19219813389
"244.3.48.41",4484,"244.3.160.239",80,10,2340,5,1342,5,998,83.554695,0.10075199999999995,106558.67873590604,79244.08448467527
"244.3.48.41",13024,"244.3.160.239",80,12,2800,6,1731,6,1069,83.729316,0.116501999999997,118864.91219035172,73406.46512506412
"244.3.48.41",2943,"244.3.160.239",80,12,4406,5,1256,7,3150,83.877336,0.0775069999999971,129639.90349259261,325131.92356820597
"244.3.48.41",7274,"244.3.160.239",80,10,1423,5,987,5,436,83.958577,0.0776869999999974,101638.62679727965,44898.11680204046
"244.3.48.41",7071,"244.3.160.239",80,10,1432,5,996,5,436,83.959463,0.07610900000000242,104691.9549593313,45829.00839585186
"244.3.48.41",13191,"244.3.160.239",80,21,11374,12,10308,9,1066,84.663317,0.1899309999999872,434178.72806443163,44900.51650336477
"244.3.48.41",15149,"244.3.160.239",80,13,4470,6,1320,7,3150,84.892195,0.07804199999999639,135311.75520874,322903.052202675
"244.3.48.41",14602,"244.3.160.239",80,10,1423,5,987,5,436,84.973783,0.07489400000000046,105429.00632894426,46572.48911795309
"244.3.48.41",2674,"244.3.160.239",80,10,1432,5,996,5,436,84.977307,0.07410600000000045,107521.6581653301,47067.7138153453
"244.3.48.41",4365,"244.3.160.239",80,131,90092,46,3911,85,86181,85.688141,0.5602760000000018,55843.90550371585,1230550.6571761023
"244.3.48.41",13487,"244.3.160.239",80,10,1456,5,1020,5,436,86.022181,0.07495899999999267,108859.50986540373,46532.10421697649
"244.3.48.41",8066,"244.3.160.239",80,10,1449,5,1013,5,436,86.22626,0.07601499999999817,106610.53739393798,45885.68045780549
"244.3.48.41",14371,"244.3.160.239",80,10,1452,5,1016,5,436,86.249166,0.07466699999999094,108856.65688993782,46714.07716930402
"244.3.48.41",7946,"244.3.160.239",80,10,1451,5,1015,5,436,86.303488,0.07629899999999168,106423.4131509048,45714.88486088128
"244.3.48.41",13700,"244.3.160.239",80,10,1453,5,1017,5,436,86.385716,0.08296599999999899,98064.26729021646,42041.318130318956
"244.3.48.41",8656,"244.3.160.239",80,10,1460,5,1024,5,436,86.539619,0.07422499999999843,110367.12697878307,46992.25328393498
"244.3.48.41",10289,"244.3.160.239",80,10,1457,5,1021,5,436,86.617686,0.07468499999998812,109366.00388299256,46702.81850439251
"244.3.48.41",7649,"244.3.160.239",80,10,1458,5,1022,5,436,86.699566,0.07531899999999325,108551.6270794983,46309.69609262354
"244.3.48.41",4740,"244.3.160.239",80,24,11418,10,1343,14,10075,86.781813,0.18825999999999965,57070.00956124519,428131.3077658565
"244.3.48.41",8092,"244.3.160.239",80,10,1463,5,1027,5,436,86.973239,0.07612099999998634,107933.42178901321,45821.78373905527
"244.3.48.41",10163,"244.3.160.239",80,10,1458,5,1022,5,436,87.052244,0.07440099999999461,109890.9960887702,46881.090307929364
"244.3.48.41",7663,"244.3.160.239",80,10,1458,5,1022,5,436,87.132015,0.0741480000000081,110265.95457731979,47041.053029071845
"244.3.48.41",15395,"244.3.160.239",80,11,4052,5,966,6,3086,87.210767,0.07702899999999602,100325.8513027613,320502.66782641964
"244.3.48.41",10015,"244.3.160.239",80,10,1444,5,1008,5,436,87.214043,0.07681599999999378,104978.12955635093,45407.206831913696
"244.3.48.41",12494,"244.3.160.239",80,10,1443,5,1007,5,436,87.288744,0.07414200000000903,108656.36211592644,47044.859863499434
"244.3.48.41",4424,"244.3.160.239",80,10,1447,5,1011,5,436,87.291762,0.07462199999999086,108386.26678460762,46742.24759454889
"244.3.48.41",6635,"244.3.160.239",80,10,1454,5,1018,5,436,87.363843,0.07407599999999093,109941.14153033368,47086.77574383643
"244.3.48.41",4497,"244.3.160.239",80,10,1457,5,1021,5,436,87.450295,0.07431100000000868,109916.4322913034,46937.86922527745
"244.3.48.41",14029,"244.3.160.239",80,10,1447,5,1011,5,436,87.53526,0.07443600000000572,108657.1014025388,46859.04669783078
"244.3.48.41",15910,"244.3.160.239",80,10,1446,5,1010,5,436,87.636289,0.07592400000000055,106422.21168536882,45940.67751962456
"244.3.48.41",12920,"244.3.160.239",80,10,1464,5,1028,5,436,87.639004,0.0757509999999968,108566.22354820858,46045.59675780053
"244.3.48.41",2872,"244.3.160.239",80,10,1471,5,1035,5,436,87.713585,0.07605500000001086,108868.58194725944,45861.54756425615
"244.3.48.41",12232,"244.3.160.239",80,10,1469,5,1033,5,436,87.71612,0.07568200000000047,109193.73166671002,46087.57696678177
"244.3.48.41",15134,"244.3.160.239",80,10,1469,5,1033,5,436,87.790797,0.07505199999999945,110110.32350903454,46474.44438522658
"244.3.48.41",10027,"244.3.160.239",80,10,1471,5,1035,5,436,87.793795,0.07559700000000191,109528.15587919878,46139.39706601997
"244.3.48.41",2633,"244.3.160.239",80,35,18354,15,1653,20,16701,87.866762,0.3560990000000004,37135.740341871184,375199.03172993986
"244.3.48.41",8897,"244.3.160.239",80,10,1477,5,1041,5,436,87.870387,0.07479800000000125,111339.87539773605,46632.26289472902
"244.3.48.41",2368,"244.3.160.239",80,15,5675,7,1148,8,4527,87.946283,0.4667710000000085,19675.601097754217,77588.36774349594
"244.3.48.41",4359,"244.3.160.239",80,14,5352,6,1161,8,4191,88.211649,0.11080400000000168,83823.6886754978,302588.3542110347
"244.3.48.41",9586,"244.3.160.239",80,10,1457,5,1021,5,436,88.223745,0.07639400000000762,106919.39157524394,45658.03597140681
"244.3.48.41",2220,"244.3.160.239",80,10,1471,5,1035,5,436,88.301094,0.07466499999999598,110895.33248510608,46715.3284671558
"244.3.48.41",7628,"244.3.160.239",80,10,1446,5,1010,5,436,88.323988,0.07635199999999998,105825.6496227997,45683.1517183571
"244.3.48.41",15795,"244.3.160.239",80,10,1455,5,1019,5,436,88.376547,0.07590999999999326,107390.33065473223,45949.15030958121
"244.3.48.41",10164,"244.3.160.239",80,10,1462,5,1026,5,436,88.401456,0.07645300000000077,107360.07743319318,45622.80093652263
"244.3.48.41",11992,"244.3.160.239",80,10,1455,5,1019,5,436,88.45342,0.0747300000000024,109086.04308844825,46674.69557071976
"244.3.48.41",12194,"244.3.160.239",80,10,1449,5,1013,5,436,88.479429,0.07625300000000834,106277.78579202278,45742.462591630734
"244.3.48.41",11529,"244.3.160.239",80,10,1454,5,1018,5,436,88.530458,0.07605100000000675,107086.03437166213,45863.95971124233
"244.3.48.41",8397,"244.3.160.239",80,10,1457,5,1021,5,436,88.557043,0.07591900000001317,107588.35074221977,45943.70315730443
"244.3.48.41",16175,"244.3.160.239",80,10,1457,5,1021,5,436,88.607653,0.07631200000000149,107034.28032288291,45707.097179997014
"244.3.48.41",3617,"244.3.160.239",80,10,1470,5,1034,5,436,88.634507,0.07533200000000306,109807.25322571634,46301.70445494422
"244.3.48.41",10718,"244.3.160.239",80,10,1458,5,1022,5,436,88.685062,0.07665400000000488,106661.10052964593,45503.17008896832
"244.3.48.41",2199,"244.3.160.239",80,10,3939,5,967,5,2972,88.710746,0.13947799999999688,55463.94413456009,170464.15922224676
"244.3.48.41",4603,"244.3.160.239",80,10,1463,5,1027,5,436,88.762687,0.07452100000000428,110250.80178740929,46805.59842191865
"244.3.48.41",4457,"244.3.160.239",80,10,1460,5,1024,5,436,88.838092,0.07453499999999735,109908.09686724748,46796.806869257714
"244.3.48.41",7927,"244.3.160.239",80,10,1467,5,1031,5,436,88.851304,0.07484900000000039,110195.19298854971,46600.48898448853
"244.3.48.41",9566,"244.3.160.239",80,10,1456,5,1020,5,436,88.914003,0.07469200000001308,109248.6477801983,46698.44160016319
"244.3.48.41",14735,"244.3.160.239",80,10,1452,5,1016,5,436,88.928767,0.07455200000001128,109024.57345207065,46786.135851479135
"244.3.48.41",7321,"244.3.160.239",80,10,1455,5,1019,5,436,88.990222,0.07658700000000351,106441.04090772098,45542.97726768041
"244.3.48.41",14234,"244.3.160.239",80,10,1457,5,1021,5,436,89.004148,0.07474399999999548,109279.6746227188,46665.953119985694
"244.3.48.41",8575,"244.3.160.239",80,10,1456,5,1020,5,436,89.067795,0.07647000000000048,106708.51314240812,45612.6585589117
"244.3.48.41",2462,"244.3.160.239",80,10,1454,5,1018,5,436,89.07974,0.0752690000000058,108198.59437483389,46340.45888745342
"244.3.48.41",10992,"244.3.160.239",80,10,1507,5,1081,5,426,89.333389,0.07373900000000333,117278.50933698055,46217.062883953484
"244.3.48.41",3455,"244.3.160.239",80,10,1502,5,1076,5,426,89.688748,0.07434999999999548,115776.73167451948,45837.256220581134
"244.3.48.41",9458,"244.3.160.239",80,10,1495,5,1079,5,416,89.69447,0.07862599999999986,109785.56711520381,42326.96563477737
"244.3.48.41",5291,"244.3.160.239",80,10,1458,5,1022,5,436,89.716852,0.0750409999999988,108953.77193800895,46481.25691288836
"244.3.48.41",16043,"244.3.160.239",80,48,29480,17,1846,31,27634,90.365824,0.18605800000000272,79373.09871115342,1188188.6293521202
"244.3.48.41",10891,"244.3.160.239",80,10,2467,5,1308,5,1159,90.568674,0.1059319999999957,98780.34965827536,87527.84805347183
"244.3.48.41",12289,"244.3.160.239",80,10,1500,5,1084,5,416,90.684566,0.07447100000000262,116448.01332061735,44688.53647728489
"244.3.48.41",11598,"244.3.160.239",80,10,1490,5,1074,5,416,90.689962,0.0750720000000058,114450.12787722901,44330.77578857287
"244.3.48.41",2631,"244.3.160.239",80,10,1503,5,1077,5,426,90.760264,0.07642699999999536,112735.02819684827,44591.57104165029
"244.3.48.41",10430,"244.3.160.239",80,10,1489,5,1073,5,416,90.766607,0.07364300000000412,116562.33450564914,45190.98896025167
"244.3.48.41",13734,"244.3.160.239",80,10,1495,5,1079,5,416,90.837109,0.07468599999999981,115577.21661355572,44559.8907425757
"244.3.48.41",16239,"244.3.160.239",80,10,1503,5,1087,5,416,90.841141,0.0744630000000086,116782.83174192546,44693.33763076448
"244.3.48.41",4261,"244.3.160.239",80,10,1493,5,1077,5,416,90.912613,0.07403100000000506,116383.67710823048,44954.14083289125
"244.3.48.41",12051,"244.3.160.239",80,10,1505,5,1079,5,426,90.916366,0.0740690000000086,116539.9829888212,46011.151763890484
"244.3.48.41",8579,"244.3.160.239",80,11,1680,5,1033,6,647,90.987478,0.09019800000000089,91620.65677731123,57384.86440940984
"244.3.48.41",3305,"244.3.160.239",80,10,2306,5,1308,5,998,91.34384,0.09994600000000275,104696.53612950705,79883.13689392051
"244.3.48.41",15833,"244.3.160.239",80,12,2605,6,1697,6,908,91.745836,0.1368180000000052,99226.70993582338,53092.42935870809
"244.3.48.41",6594,"244.3.160.239",80,12,4372,5,1222,7,3150,91.908347,0.07876599999998746,124114.46563239922,319934.997333926
"244.3.48.41",3650,"244.3.160.239",80,10,1423,5,987,5,436,91.994071,0.07550299999999766,104578.62601486358,46196.83986066922
"244.3.48.41",14335,"244.3.160.239",80,10,1432,5,996,5,436,92.001199,0.07553900000000624,105481.93648313245,46174.823601049946
"244.3.48.41",9510,"244.3.160.239",80,40,26032,18,10648,22,15384,92.186115,1.0228060000000028,83284.61115793197,120327.80409970187
"244.3.48.41",12819,"244.3.160.239",80,126,85624,45,3813,81,81811,93.198186,0.8978089999999952,33976.04613007908,728983.5588638602
"244.3.48.41",7554,"244.3.160.239",80,12,4372,5,1222,7,3150,93.244528,0.07785499999999956,125566.75871813056,323678.6333568832
"244.3.48.41",14526,"244.3.160.239",80,10,1423,5,987,5,436,93.326651,0.0745809999999949,105871.46860461163,46767.94357812631
"244.3.48.41",10504,"244.3.160.239",80,10,1432,5,996,5,436,93.402125,0.0777180000000044,102524.51169612637,44880.207931236044
"244.3.48.41",14960,"244.3.160.239",80,10,1490,5,1074,5,416,93.533374,0.0750060000000019,114550.83593312243,44369.78375063216
"244.3.48.41",5502,"244.3.160.239",80,10,1498,5,1082,5,416,93.57945,0.07396700000001033,117025.1598685737,44993.03743560689
"244.3.48.41",5284,"244.3.160.239",80,10,1495,5,1079,5,416,93.609086,0.07736099999999624,111580.77067256653,43019.09230749553
"244.3.48.41",8466,"244.3.160.239",80,10,1456,5,1020,5,436,93.770909,0.07436599999999771,109727.56367157372,46903.154667457
"244.3.48.41",9386,"244.3.160.239",80,10,1452,5,1016,5,436,94.069286,0.07510800000000017,108217.50013314135,46439.79336422208
"244.3.48.41",13187,"244.3.160.239",80,10,1449,5,1013,5,436,94.096967,0.0741999999999905,109218.32884098434,47008.086253375295
"244.3.48.41",6011,"244.3.160.239",80,10,1451,5,1015,5,436,94.146269,0.0764080000000007,106271.59459742338,45649.670191602556
"244.3.48.41",5734,"244.3.160.239",80,10,1453,5,1017,5,436,94.232823,0.0769860000000051,105681.55249005611,45306.9389239572
"244.3.48.41",10803,"244.3.160.239",80,10,1460,5,1024,5,436,94.415467,0.07533599999999296,108739.51364554482,46299.24604439213
"244.3.48.41",10821,"244.3.160.239",80,10,1457,5,1021,5,436,94.494576,0.0753830000000022,108353.34226549437,46270.37926322776
"244.3.48.41",2724,"244.3.160.239",80,10,1458,5,1022,5,436,94.577775,0.07419699999999807,110193.13449331123,47009.98692669637
"244.3.48.41",12216,"244.3.160.239",80,23,11354,9,1279,14,10075,94.665228,0.2345590000000044,43622.28692994005,343623.5659258374
"244.3.48.41",11611,"244.3.160.239",80,10,1463,5,1027,5,436,94.90379,0.07383099999999843,111281.16915658972,47243.02799637109
"244.3.48.41",8674,"244.3.160.239",80,10,1458,5,1022,5,436,94.981111,0.07535000000000025,108506.96748506931,46290.64366290628
"244.3.48.41",2858,"244.3.160.239",80,10,1458,5,1022,5,436,95.062232,0.07566500000000076,108055.24350756516,46097.931672503335
"244.3.48.41",2597,"244.3.160.239",80,12,4116,6,1030,6,3086,95.142378,0.07761900000001276,106159.57433100975,318066.4528014525
"244.3.48.41",13855,"244.3.160.239",80,10,1444,5,1008,5,436,95.143214,0.07667700000000366,105168.43381978449,45489.52097760519
"244.3.48.41",7360,"244.3.160.239",80,10,1443,5,1007,5,436,95.221326,0.07478599999998892,107720.69638704027,46639.74540690125
"244.3.48.41",15946,"244.3.160.239",80,10,1447,5,1011,5,436,95.221922,0.07751499999999112,104341.09527189481,44997.7423724492
"244.3.48.41",12172,"244.3.160.239",80,10,1454,5,1018,5,436,95.297225,0.07380000000000564,110352.3035230268,47262.872628722675
"244.3.48.41",12061,"244.3.160.239",80,10,1457,5,1021,5,436,95.383959,0.08515699999999526,95916.95339197546,40959.63925455563
"244.3.48.41",16086,"244.3.160.239",80,10,1447,5,1011,5,436,95.47872,0.07361200000001134,109873.39020810132,47383.57876432461
"244.3.48.41",7753,"244.3.160.239",80,10,1446,5,1010,5,436,95.577724,0.0774550000000005,104318.63662771865,45032.599573945874
"244.3.48.41",6096,"244.3.160.239",80,10,1464,5,1028,5,436,95.578469,0.080600000000004,102034.73945408923,43275.43424317403
"244.3.48.41",11646,"244.3.160.239",80,10,1471,5,1035,5,436,95.656241,0.0748660000000001,110597.6010472042,46589.90730104447
"244.3.48.41",14548,"244.3.160.239",80,10,1469,5,1033,5,436,95.65982,0.07583900000000199,108967.68153588238,45992.1676182427
"244.3.48.41",3475,"244.3.160.239",80,32,17488,13,1519,19,15969,95.732084,0.4331449999999961,28055.27017511482,294940.49336827424
"244.3.48.41",9387,"244.3.160.239",80,10,1469,5,1033,5,436,95.736779,0.07700400000000229,107319.10030647439,45296.34824164843
"244.3.48.41",11427,"244.3.160.239",80,10,1471,5,1035,5,436,95.814107,0.07768499999998824,106584.2826800702,44899.27270387499
"244.3.48.41",7971,"244.3.160.239",80,10,1477,5,1041,5,436,95.89276,0.07640299999999911,109000.9554598654,45652.65761815689
"244.3.48.41",10426,"244.3.160.239",80,10,1457,5,1021,5,436,95.970248,0.07565800000000422,107959.50196938255,46102.19672737589
"244.3.48.41",7684,"244.3.160.239",80,10,1446,5,1010,5,436,96.047324,0.07434700000000305,108679.57012387412,46915.14116238526
"244.3.48.41",14418,"244.3.160.239",80,10,1471,5,1035,5,436,96.122689,0.07526200000000927,110015.67856287344,46344.76894049548
"244.3.48.41",8014,"244.3.160.239",80,14,5513,6,1161,8,4352,96.132047,0.11001299999999503,84426.38597257069,316471.6897094123
"244.3.48.41",10620,"244.3.160.239",80,10,1455,5,1019,5,436,96.166141,0.0744720000000001,109463.95960898043,46836.39488666876
"244.3.48.41",11538,"244.3.160.239",80,10,1462,5,1026,5,436,96.198739,0.07380299999999806,111214.99126052078,47260.95145183924
"244.3.48.41",4585,"244.3.160.239",80,10,1455,5,1019,5,436,96.241671,0.07615800000000661,107040.6260668517,45799.52204626825
"244.3.48.41",5133,"244.3.160.239",80,10,1449,5,1013,5,436,96.273315,0.07407899999999756,109396.72511778327,47084.86885622261
"244.3.48.41",11808,"244.3.160.239",80,10,1454,5,1018,5,436,96.31863799999999,0.07480400000000031,108871.18335917819,46628.52253890147
"244.3.48.41",9092,"244.3.160.239",80,10,1454,5,1018,5,436,96.348235,0.07491199999999765,108714.2246903067,46561.29859034747
"244.3.48.41",8017,"244.3.160.239",80,10,1452,5,1016,5,436,96.394659,0.0754659999999916,107704.13166195247,46219.48957146779
"244.3.48.41",5707,"244.3.160.239",80,10,1457,5,1021,5,436,96.424272,0.07671200000000056,106476.170612159,45468.76629471236
"244.3.48.41",4670,"244.3.160.239",80,10,1457,5,1021,5,436,96.471685,0.0749580000000094,108967.68857225346,46532.72499265672
"244.3.48.41",13275,"244.3.160.239",80,10,1470,5,1034,5,436,96.50186,0.0744760000000042,111069.33777323611,46833.87937053283
"244.3.48.41",7198,"244.3.160.239",80,10,1458,5,1022,5,436,96.54754,0.07457899999999995,109628.71585835161,46769.1977634455
"244.3.48.41",4142,"244.3.160.239",80,10,3939,5,967,5,2972,96.577411,0.10255999999999688,75429.01716068873,231825.27301092749
"244.3.48.41",3081,"244.3.160.239",80,10,1463,5,1027,5,436,96.622973,0.07402499999999179,110989.53056401096,47119.21648092383
"244.3.48.41",11424,"244.3.160.239",80,10,1460,5,1024,5,436,96.680998,0.07555599999999174,108422.89163006109,46164.43432686195
"244.3.48.41",13551,"244.3.160.239",80,10,1467,5,1031,5,436,96.697861,0.07611500000000149,108362.34644944937,45825.39578269634
"244.3.48.41",5415,"244.3.160.239",80,10,1456,5,1020,5,436,96.757995,0.07436600000001192,109727.56367155275,46903.15466744804
"244.3.48.41",11844,"244.3.160.239",80,10,1455,5,1019,5,436,96.774923,0.07512099999999577,108518.25721170456,46431.75676575387
"244.3.48.41",14261,"244.3.160.239",80,10,1457,5,1021,5,436,96.833831,0.07590700000000083,107605.35918953338,45950.966314041674
"244.3.48.41",14752,"244.3.160.239",80,10,1456,5,1020,5,436,96.850954,0.074380000000005,109706.91045979365,46894.32643183337
"244.3.48.41",12538,"244.3.160.239",80,10,1497,5,1081,5,416,97.243311,0.07619599999999593,113496.77148407346,43676.833429578684
"244.3.48.41",9072,"244.3.160.239",80,10,1492,5,1076,5,416,97.656969,0.0744629999999944,115601.03675651865,44693.33763077301
"244.3.48.41",10572,"244.3.160.239",80,10,1495,5,1079,5,416,97.663714,0.07393500000000586,116751.20037870177,45012.510989379
"244.3.48.41",15351,"244.3.160.239",80,10,1458,5,1022,5,436,97.683446,0.07417999999999836,110218.38770558346,47020.7603127538
"244.3.48.41",11555,"244.3.160.239",80,47,29416,16,1782,31,27634,98.331378,0.18958299999999895,75196.61573031379,1166096.116212958
"244.3.48.41",15054,"244.3.160.239",80,10,2467,5,1308,5,1159,98.543894,0.13196600000000558,79293.15126623189,70260.52164951281
"244.3.48.41",9288,"244.3.160.239",80,10,1510,5,1084,5,426,98.691221,0.0737620000000021,117567.31108158338,46202.65177191376
"244.3.48.41",13157,"244.3.160.239",80,10,1490,5,1074,5,416,98.696846,0.07443900000001236,115423.36678352172,44707.74728300283
"244.3.48.41",7344,"244.3.160.239",80,10,1493,5,1077,5,416,98.766261,0.07592800000000466,113475.92456010262,43830.99778737483
"244.3.48.41",9522,"244.3.160.239",80,10,1489,5,1073,5,416,98.772714,0.07357600000000275,116668.47885179514,45232.14091551424
"244.3.48.41",10951,"244.3.160.239",80,10,1495,5,1079,5,416,98.843078,0.07348299999999597,117469.34665161294,45289.38666086282
"244.3.48.41",8523,"244.3.160.239",80,10,1513,5,1087,5,426,98.857799,0.07308399999999438,118986.37184610406,46631.27360298098
"244.3.48.41",13034,"244.3.160.239",80,10,1493,5,1077,5,416,98.917511,0.07380499999999302,116740.05826164644,45091.795948788225
"244.3.48.41",2972,"244.3.160.239",80,10,1495,5,1079,5,416,98.931895,0.07458599999999649,115732.17493900204,44619.63371142247
"244.3.48.41",15057,"244.3.160.239",80,12,1744,6,1097,6,647,99.02945,0.09772200000000453,89805.7755674218,52966.57866191605
"244.3.48.41",4039,"244.3.160.239",80,10,2467,5,1308,5,1159,99.410543,0.11244800000000055,93056.3460443934,82455.89072282259
"244.3.48.41",5607,"244.3.160.239",80,12,2766,6,1697,6,1069,99.806395,0.11565900000000795,117379.53812499733,73941.50044526938
"244.3.48.41",12593,"244.3.160.239",80,13,4436,6,1286,7,3150,99.951135,0.07771200000000533,132386.24665430427,324274.24336007657
"244.3.48.41",5721,"244.3.160.239",80,10,1423,5,987,5,436,100.032662,0.07484599999999375,105496.61972584586,46602.35683938074
"244.3.48.41",13773,"244.3.160.239",80,10,1432,5,996,5,436,100.036714,0.07376099999999042,108024.56582748384,47287.862149380475
"244.3.48.41",13637,"244.3.160.239",80,18,9153,10,8151,8,1002,100.233145,0.1620150000000109,402481.2517359233,49476.900287007134
"244.3.48.41",8462,"244.3.160.239",80,12,4372,5,1222,7,3150,100.419253,0.11185500000000559,87398.86460148863,225291.67225424648
"244.3.48.41",16275,"244.3.160.239",80,10,1423,5,987,5,436,100.53667,0.07450400000000457,105980.88693223875,46816.27832062421
"244.3.48.41",8426,"244.3.160.239",80,10,1432,5,996,5,436,100.542617,0.07425799999998617,107301.57020121043,46971.37008808007
"244.3.48.41",16057,"244.3.160.239",80,12,4143,5,1030,7,3113,109.677284,0.20595699999999795,40008.35125778722,120918.44414125399
"244.3.48.41",4770,"244.3.160.239",80,10,1456,5,1020,5,436,109.687141,0.0752250000000032,108474.57627118182,46367.563974740464
"244.3.48.41",8186,"244.3.160.239",80,181,126173,62,4980,119,121193,112.263445,0.7410089999999911,53764.52917575964,1308410.5591160317
"244.3.48.41",4546,"244.3.160.239",80,10,1490,5,1054,5,436,112.745774,0.07586600000000487,111143.33166371574,45975.79943584446
"244.3.48.41",14503,"244.3.160.239",80,10,1483,5,1047,5,436,112.951413,0.07642400000000293,109599.07882340206,45640.113053489295
"244.3.48.41",10318,"244.3.160.239",80,10,1486,5,1050,5,436,113.005518,0.07477700000001164,112334.00644581478,46645.35886702404
"244.3.48.41",16099,"244.3.160.239",80,10,1485,5,1049,5,436,113.029006,0.07605000000000928,110348.45496382612,45864.56278763412
"244.3.48.41",8775,"244.3.160.239",80,10,1487,5,1051,5,436,113.111008,0.07638300000000697,110076.84956075609,45664.611235480166
"244.3.48.41",6480,"244.3.160.239",80,10,1494,5,1058,5,436,113.257584,0.07457400000001257,113498.00198458675,46772.333521058434
"244.3.48.41",16237,"244.3.160.239",80,10,1491,5,1055,5,436,113.335976,0.07427299999999093,113634.83365423547,46961.88386089731
"244.3.48.41",7587,"244.3.160.239",80,10,1492,5,1056,5,436,113.418362,0.07578399999999874,111474.71761849652,46025.546289455
"244.3.48.41",5450,"244.3.160.239",80,24,11452,10,1377,14,10075,113.503903,0.18840500000000304,58469.78583370835,427801.8099307274
"244.3.48.41",6278,"244.3.160.239",80,10,1497,5,1061,5,436,113.695506,0.07399200000000405,114715.10433559756,47140.231376362426
"244.3.48.41",16061,"244.3.160.239",80,10,1492,5,1056,5,436,113.772422,0.07407899999999756,114040.41631231898,47084.86885622261
"244.3.48.41",2337,"244.3.160.239",80,10,1492,5,1056,5,436,113.852071,0.07411600000000362,113983.48534728786,47061.36326838779
"244.3.48.41",13408,"244.3.160.239",80,12,4150,6,1064,6,3086,113.930946,0.07990099999999245,106531.83314352516,308982.36567755515
"244.3.48.41",14781,"244.3.160.239",80,10,1478,5,1042,5,436,113.931885,0.07544800000000862,110486.69282153335,46230.51638213871
"244.3.48.41",3019,"244.3.160.239",80,10,1477,5,1041,5,436,114.008105,0.07427099999999598,112129.90265380096,46963.1484697956
"244.3.48.41",8524,"244.3.160.239",80,10,1481,5,1045,5,436,114.013469,0.07507499999999823,111355.31135531398,46460.206460207555
"244.3.48.41",13474,"244.3.160.239",80,10,1488,5,1052,5,436,114.08333,0.0746029999999962,112810.47679048334,46754.15197780488
"244.3.48.41",6840,"244.3.160.239",80,10,1491,5,1055,5,436,114.177667,0.0746249999999975,113098.82747069056,46740.3685092143
"244.3.48.41",6735,"244.3.160.239",80,10,1481,5,1045,5,436,114.269718,0.07400400000000218,112966.86665585311,47132.58742770522
"244.3.48.41",15461,"244.3.160.239",80,10,1498,5,1062,5,436,114.384136,0.0849720000000076,99985.87770088077,41048.81608058758
"244.3.48.41",4331,"244.3.160.239",80,10,1480,5,1044,5,436,114.38521,0.08512600000000248,98113.38486478581,40974.55536498718
"244.3.48.41",7426,"244.3.160.239",80,10,1505,5,1069,5,436,114.470187,0.08855200000000707,96576.0231276461,39389.28539163115
"244.3.48.41",12850,"244.3.160.239",80,10,1503,5,1067,5,436,114.473002,0.07539400000000285,113218.55850597763,46263.628405441654
"244.3.48.41",6775,"244.3.160.239",80,10,1503,5,1067,5,436,114.549319,0.07586299999999824,112518.61908967742,45977.61754742208
"244.3.48.41",10979,"244.3.160.239",80,10,1505,5,1069,5,436,114.570813,0.07727199999999357,110673.9828139651,45139.24836940018
"244.3.48.41",5010,"244.3.160.239",80,10,1511,5,1075,5,436,114.626786,0.07459300000000724,115292.3196546481,46760.41987853635
"244.3.48.41",4915,"244.3.160.239",80,15,5912,7,1228,8,4684,114.648966,0.41836399999999685,23481.94395311278,89567.93605568424
"244.3.48.41",3385,"244.3.160.239",80,13,4556,6,1164,7,3392,114.702633,0.47450299999999856,19624.744206043015,57188.258029981014
"244.3.48.41",3191,"244.3.160.239",80,33,19035,13,1598,20,17437,114.962402,1.6372450000000072,7808.238840246844,85201.66499210527
"244.3.48.41",11378,"244.3.160.239",80,15,5591,7,1227,8,4364,115.070033,0.6072300000000013,16165.20922879301,57493.865586351014
"244.3.48.41",8229,"244.3.160.239",80,14,5547,6,1195,8,4352,115.393068,0.11022800000000643,86729.32467249194,315854.41085747693
"244.3.48.41",8758,"244.3.160.239",80,15,5213,7,1228,8,3985,115.569613,0.27486999999999284,35740.53188780243,115982.10062939145
"244.3.48.41",3629,"244.3.160.239",80,15,5217,7,1228,8,3989,115.78956,0.3732750000000067,26318.397963967112,85491.92954256092
"244.3.48.41",14617,"244.3.160.239",80,15,4873,7,1228,8,3645,116.060589,0.31660700000000475,31029.004412409875,92101.56440002768
"244.3.48.41",5471,"244.3.160.239",80,15,5433,7,1228,8,4205,116.271039,0.32647199999999543,30091.401406552897,103040.99585875809
"244.3.48.41",11099,"244.3.160.239",80,10,1491,5,1055,5,436,116.490451,0.07752100000000439,108873.72453915096,44994.259619971395
"244.3.48.41",8415,"244.3.160.239",80,10,1480,5,1044,5,436,116.568761,0.07431600000001026,112384.95075083221,46934.71123310617
"244.3.48.41",8411,"244.3.160.239",80,10,1489,5,1053,5,436,116.600739,0.0762280000000004,110510.57354252972,45757.46444875874
"244.3.48.41",11936,"244.3.160.239",80,10,1496,5,1060,5,436,116.644365,0.07596500000001072,111630.3560850234,45915.882314217175
"244.3.48.41",16380,"244.3.160.239",80,10,1489,5,1053,5,436,116.678529,0.07665099999999825,109900.7188425486,45504.95101172952
"244.3.48.41",9622,"244.3.160.239",80,10,1483,5,1047,5,436,116.721186,0.07507699999999318,111565.45946162954,46458.9687920444
"244.3.48.41",14195,"244.3.160.239",80,10,1488,5,1052,5,436,116.756011,0.07431200000000615,113252.23382494487,46937.23759284787
"244.3.48.41",10650,"244.3.160.239",80,10,1505,5,1069,5,436,116.797054,0.07470499999999447,114476.94264106329,46690.31523994724
"244.3.48.41",13493,"244.3.160.239",80,10,1488,5,1052,5,436,116.831355,0.07751199999999869,108576.73650531714,44999.483950872884
"244.3.48.41",8436,"244.3.160.239",80,10,1491,5,1055,5,436,116.873235,0.07733200000001261,109139.81275537453,45104.22593492256
"244.3.48.41",8731,"244.3.160.239",80,10,1491,5,1055,5,436,116.909868,0.0762239999999963,110726.28043661328,45759.86565911221
"244.3.48.41",9561,"244.3.160.239",80,10,1504,5,1068,5,436,116.951494,0.07685700000000395,111167.4928763751,45382.983983239275
"244.3.48.41",10082,"244.3.160.239",80,10,1492,5,1056,5,436,116.987524,0.0762200000000064,110837.05064286658,45762.267121486584
"244.3.48.41",13552,"244.3.160.239",80,10,3973,5,1001,5,2972,117.029473,0.1882930000000016,42529.462061786326,126271.28995767128
"244.3.48.41",10820,"244.3.160.239",80,10,1497,5,1061,5,436,117.065309,0.07644200000000012,111038.43436854068,45629.36605530984
"244.3.48.41",13570,"244.3.160.239",80,10,1494,5,1058,5,436,117.142981,0.07490899999999101,112990.42838645578,46563.163304815425
"244.3.48.41",2782,"244.3.160.239",80,10,1501,5,1065,5,436,117.219254,0.07677199999999118,110977.9607148567,45433.23086542491
"244.3.48.41",9613,"244.3.160.239",80,10,1490,5,1054,5,436,117.222144,0.07478000000000407,112757.42177052076,46643.48756351712
"244.3.48.41",4999,"244.3.160.239",80,10,1486,5,1050,5,436,117.298282,0.07688199999999767,109258.34395567563,45368.226633023405
"244.3.48.41",6721,"244.3.160.239",80,10,1490,5,1054,5,436,117.29874,0.07500699999999938,112416.17449038183,46502.32644953176
"244.3.48.41",12918,"244.3.160.239",80,10,1489,5,1053,5,436,117.374932,0.07906900000000405,106539.85759273,44113.36933564129
"244.3.48.41",11563,"244.3.160.239",80,10,1491,5,1055,5,436,117.376412,0.07745900000000461,108960.86962134158,45030.27408047861
"244.3.48.41",4888,"244.3.160.239",80,10,1492,5,1056,5,436,117.45576,0.07605800000000329,111073.1284020042,45859.738620524455
"244.3.48.41",3284,"244.3.160.239",80,10,1490,5,1054,5,436,117.456215,0.07559799999999939,111537.34225773258,46138.78674039033
"244.3.48.41",4515,"244.3.160.239",80,10,1531,5,1115,5,416,117.547428,0.07459800000000882,119574.2513203966,44612.456098013434
"244.3.48.41",8730,"244.3.160.239",80,10,1526,5,1110,5,416,117.660903,0.07371099999998876,120470.48608757654,45149.29929047914
"244.3.48.41",16256,"244.3.160.239",80,10,1529,5,1113,5,416,117.672298,0.0753130000000084,118226.60098520848,44188.91824784073
"244.3.48.41",8046,"244.3.160.239",80,47,29456,17,1880,30,27576,118.561623,0.18945200000000284,79386.86316322749,1164453.2652070008
"244.3.48.41",16137,"244.3.160.239",80,10,2501,5,1342,5,1159,118.821828,0.10766200000000481,99719.49248573797,86121.37987404643
"244.3.48.41",4108,"244.3.160.239",80,10,1534,5,1118,5,416,118.940803,0.07471400000000017,119709.82680622078,44543.19136975657
"244.3.48.41",2104,"244.3.160.239",80,10,1524,5,1108,5,416,118.947029,0.07880899999999258,112474.46357650566,42228.679465547255
"244.3.48.41",2460,"244.3.160.239",80,10,1527,5,1111,5,416,119.016553,0.07374799999999482,120518.52253621284,45126.64750230832
"244.3.48.41",3061,"244.3.160.239",80,10,1533,5,1107,5,426,119.028138,0.07322100000000376,120948.908100129,46544.024255334196
"244.3.48.41",10593,"244.3.160.239",80,10,1539,5,1113,5,426,119.09132,0.07363500000001011,120920.75779179436,46282.33856181886
"244.3.48.41",11857,"244.3.160.239",80,10,1547,5,1121,5,426,119.102063,0.07293500000000108,122958.79893055277,46726.5373277569
"244.3.48.41",10518,"244.3.160.239",80,10,1527,5,1111,5,416,119.165852,0.07516499999999837,118246.52431318024,44275.92629548423
"244.3.48.41",14181,"244.3.160.239",80,10,1529,5,1113,5,416,119.17645,0.07385899999999879,120554.02862210626,45058.828307993
"244.3.48.41",10267,"244.3.160.239",80,12,1778,6,1131,6,647,119.372638,0.27444100000001015,32968.83483152906,18860.15573474739
"244.3.48.41",4255,"244.3.160.239",80,10,2340,5,1342,5,998,119.902001,0.14845200000000602,72319.67235200311,53781.69374612451
"244.3.48.41",12587,"244.3.160.239",80,12,2639,6,1731,6,908,120.449224,0.21434200000000203,64607.029886815784,33889.76495507148
"244.3.48.41",12952,"244.3.160.239",80,12,4406,5,1256,7,3150,120.692686,0.09027800000001207,111300.64910607963,279137.7744300564
"244.3.48.41",5125,"244.3.160.239",80,10,1423,5,987,5,436,120.787601,0.07508900000000551,105155.21581056374,46451.54416758438
"244.3.48.41",15052,"244.3.160.239",80,10,1432,5,996,5,436,120.791885,0.07604600000000517,104778.68658442862,45866.97525181815
"244.3.48.41",10423,"244.3.160.239",80,21,11364,12,10298,9,1066,120.983426,0.1624050000000068,507275.02232072013,52510.69856223419
"244.3.48.41",15784,"244.3.160.239",80,12,4406,5,1256,7,3150,121.173311,0.0774770000000018,129690.10157852998,325257.8184493387
"244.3.48.41",12389,"244.3.160.239",80,10,1423,5,987,5,436,121.254362,0.07482100000000003,105531.86939495592,46617.928121783974
"244.3.48.41",5546,"244.3.160.239",80,10,1432,5,996,5,436,121.255083,0.0753040000000027,105811.11229150795,46318.92064166412
"244.3.48.41",4697,"244.3.160.239",80,108,73806,38,3493,70,70313,122.080394,0.5463550000000055,51146.23276075028,1029557.7051550628
"244.3.48.41",7267,"244.3.160.239",80,10,1505,5,1069,5,436,122.388061,0.08314400000000433,102857.69267775853,41951.31338400629
"244.3.48.41",14298,"244.3.160.239",80,10,1498,5,1062,5,436,122.630265,0.07555100000000436,112453.83912852919,46167.48951039428
"244.3.48.41",5443,"244.3.160.239",80,10,1501,5,1065,5,436,122.634874,0.07452200000000175,114328.65462547704,46804.97034432675
"244.3.48.41",11408,"244.3.160.239",80,10,1500,5,1064,5,436,122.706845,0.07456999999999425,114147.78060883272,46774.84242993521
"244.3.48.41",12974,"244.3.160.239",80,10,1502,5,1066,5,436,122.787435,0.07376899999999864,115604.11554989436,47282.733939731654
"244.3.48.41",2915,"244.3.160.239",80,10,1509,5,1073,5,436,122.926106,0.07665899999999226,111976.41503281893,45500.20219413705
"244.3.48.41",14888,"244.3.160.239",80,10,1506,5,1070,5,436,123.006655,0.07454700000000969,114826.88773523935,46789.273880901266
"244.3.48.41",6130,"244.3.160.239",80,10,1507,5,1071,5,436,123.090994,0.07514799999999866,114015.01037951978,46415.07425347398
"244.3.48.41",4247,"244.3.160.239",80,24,11467,10,1392,14,10075,123.175698,0.18815399999999727,59185.56076405584,428372.50337490125
"244.3.48.41",12554,"244.3.160.239",80,10,1512,5,1076,5,436,123.371626,0.07553899999999203,113954.38118059424,46174.82360105863
"244.3.48.41",10271,"244.3.160.239",80,10,1507,5,1071,5,436,123.451721,0.07374799999999482,116179.42181483704,47296.19786299622
"244.3.48.41",9068,"244.3.160.239",80,10,1507,5,1071,5,436,123.531049,0.07615100000001007,112513.29595144997,45803.73205866684
"244.3.48.41",11100,"244.3.160.239",80,11,4101,5,1015,6,3086,123.611842,0.07923200000000463,102483.84491114102,311591.2762520012
"244.3.48.41",3718,"244.3.160.239",80,10,1493,5,1057,5,436,123.612706,0.07510299999999859,112592.04026470525,46442.88510445742
"244.3.48.41",5261,"244.3.160.239",80,10,1492,5,1056,5,436,123.688725,0.07540799999999592,112030.55378740262,46255.03925313214
"244.3.48.41",10884,"244.3.160.239",80,10,1496,5,1060,5,436,123.692009,0.07411600000000362,114415.24097360334,47061.36326838779
"244.3.48.41",9261,"244.3.160.239",80,10,1503,5,1067,5,436,123.765542,0.0749100000000027,113950.07342143496,46562.54171672506
"244.3.48.41",15118,"244.3.160.239",80,10,1506,5,1070,5,436,123.850475,0.07479299999999967,114449.21316166002,46635.38031633997
"244.3.48.41",15995,"244.3.160.239",80,10,1496,5,1060,5,436,123.94216,0.0738319999999959,114855.34727490073,47242.38812439313
"244.3.48.41",11928,"244.3.160.239",80,10,1495,5,1059,5,436,124.039188,0.0776610000000062,109089.50438443136,44913.14816960536
"244.3.48.41",7397,"244.3.160.239",80,10,1513,5,1077,5,436,124.041432,0.07607000000000141,113264.09885631445,45852.50427237985
"244.3.48.41",13383,"244.3.160.239",80,10,1518,5,1082,5,436,124.121144,0.07490699999999606,115556.62354653711,46564.406530767264
"244.3.48.41",8085,"244.3.160.239",80,10,1520,5,1084,5,436,124.127749,0.07495300000000782,115699.17148078256,46535.82911957675
"244.3.48.41",3314,"244.3.160.239",80,10,1518,5,1082,5,436,124.196954,0.077147999999994,112199.92741225532,45211.80069477201
"244.3.48.41",15616,"244.3.160.239",80,10,1520,5,1084,5,436,124.209983,0.07457100000000594,116291.85608345483,46774.21517747814
"244.3.48.41",5411,"244.3.160.239",80,10,1526,5,1090,5,436,124.275117,0.07550799999999924,115484.45197859945,46193.78079143978
"244.3.48.41",7596,"244.3.160.239",80,171,116412,56,4376,115,112036,124.291006,0.6764660000000049,51751.30753060723,1324956.4649221003
"244.3.48.41",14200,"244.3.160.239",80,10,1506,5,1070,5,436,124.35374,0.07610900000000242,112470.2728980768,45829.00839585186
"244.3.48.41",9305,"244.3.160.239",80,10,1495,5,1059,5,436,124.430631,0.07969999999998834,106298.61982435684,43764.11543287968
"244.3.48.41",3991,"244.3.160.239",80,10,1504,5,1068,5,436,124.511088,0.09730999999999312,87801.87031138221,35844.20922824218
"244.3.48.41",12281,"244.3.160.239",80,10,1511,5,1075,5,436,124.609499,0.08284600000000353,103807.06370856328,42102.213745984736
"244.3.48.41",13124,"244.3.160.239",80,10,1504,5,1068,5,436,124.693277,0.07696500000000128,111011.49873318856,45319.30098096462
"244.3.48.41",15238,"244.3.160.239",80,14,5401,6,1210,8,4191,124.715665,0.10944800000000043,88443.82720561327,306337.25604853325
"244.3.48.41",7763,"244.3.160.239",80,10,1498,5,1062,5,436,124.77106,0.074317999999991,114319.54573590554,46933.44815523053
"244.3.48.41",8267,"244.3.160.239",80,10,1503,5,1067,5,436,124.846224,0.07511199999999008,113643.62551923963,46437.320268405325
"244.3.48.41",5322,"244.3.160.239",80,10,1503,5,1067,5,436,124.863382,0.07632300000000214,111840.4674868619,45700.509675981055
"244.3.48.41",14212,"244.3.160.239",80,10,1501,5,1065,5,436,124.922783,0.07475999999999772,113964.68699839835,46655.96575709078
"244.3.48.41",3152,"244.3.160.239",80,10,1506,5,1070,5,436,124.940733,0.07706100000000049,111080.83206810118,45262.84372120759
"244.3.48.41",12886,"244.3.160.239",80,10,1506,5,1070,5,436,124.998746,0.07413800000000492,115460.35771128749,47047.398095440505
"244.3.48.41",3221,"244.3.160.239",80,10,1519,5,1083,5,436,125.019102,0.07457899999999995,116172.1127931456,46769.1977634455
"244.3.48.41",11476,"244.3.160.239",80,10,1520,5,1084,5,436,125.073789,0.07645899999999983,113420.26445546004,45619.22075883817
"244.3.48.41",10047,"244.3.160.239",80,10,1507,5,1071,5,436,125.094408,0.07599299999999687,112747.22671825501,45898.96437829989
"244.3.48.41",3675,"244.3.160.239",80,10,3988,5,1016,5,2972,125.151237,0.17340900000000659,46871.84632862015,137109.3772526172
"244.3.48.41",12902,"244.3.160.239",80,10,1512,5,1076,5,436,125.171694,0.07730700000000468,111348.26083018976,45118.81200925905
"244.3.48.41",9799,"244.3.160.239",80,10,1509,5,1073,5,436,125.249807,0.07509100000000046,114314.63158034848,46450.306960887174
"244.3.48.41",4446,"244.3.160.239",80,10,1516,5,1080,5,436,125.326068,0.07894799999999691,109439.12448700839,44180.97988549598
"244.3.48.41",12506,"244.3.160.239",80,10,1505,5,1069,5,436,125.32811,0.07558600000000126,113142.64546344373,46146.11171380866
"244.3.48.41",8341,"244.3.160.239",80,10,1504,5,1068,5,436,125.404664,0.07616000000000156,112184.87394957754,45798.319327730154
"244.3.48.41",10567,"244.3.160.239",80,10,1506,5,1070,5,436,125.406116,0.07655499999999904,111815.03494219983,45562.01423813002
"244.3.48.41",11775,"244.3.160.239",80,10,1505,5,1069,5,436,125.481744,0.0782609999999977,109275.37342993639,44568.81460753252
"244.3.48.41",4732,"244.3.160.239",80,10,1556,5,1130,5,426,125.711295,0.0742569999999887,121739.36463904247,45894.66312940893
"244.3.48.41",2489,"244.3.160.239",80,10,1507,5,1071,5,436,125.815757,0.07401699999999778,115757.19091560395,47124.30928030189
"244.3.48.41",3760,"244.3.160.239",80,10,1541,5,1125,5,416,125.826861,0.07456600000000435,120698.44164900189,44631.6015342087
"244.3.48.41",6169,"244.3.160.239",80,10,1554,5,1128,5,426,125.832713,0.07299700000000087,123621.51869254754,46686.85014452593
"244.3.48.41",14352,"244.3.160.239",80,47,29465,16,1831,31,27634,126.440234,0.1841269999999895,79553.7862453678,1200649.5516682107
"244.3.48.41",10809,"244.3.160.239",80,10,2355,5,1357,5,998,126.641602,0.10851999999999862,100036.8595650584,73571.69185403705
"244.3.48.41",9659,"244.3.160.239",80,10,1549,5,1133,5,416,126.840058,0.0738410000000016,122750.23361005138,45069.812163972965
"244.3.48.41",3664,"244.3.160.239",80,10,1539,5,1123,5,416,126.844868,0.0774459999999948,116003.40882680324,42971.87717894047
"244.3.48.41",2282,"244.3.160.239",80,10,1552,5,1126,5,426,126.914873,0.07392500000000268,121853.22962461512,46100.77781535173
"244.3.48.41",9155,"244.3.160.239",80,10,1538,5,1122,5,416,126.923183,0.07466000000000861,120225.0200910657,44575.408518612596
"244.3.48.41",7249,"244.3.160.239",80,10,1544,5,1128,5,416,126.98967,0.0752820000000014,119869.29146409276,44207.1145825023
"244.3.48.41",11723,"244.3.160.239",80,10,1552,5,1136,5,416,126.998727,0.07403899999999908,122746.12028795788,44949.28348573105
"244.3.48.41",11824,"244.3.160.239",80,10,1542,5,1126,5,416,127.065967,0.07439800000000218,121078.5236162227,44732.38527917286
"244.3.48.41",2867,"244.3.160.239",80,10,1554,5,1128,5,426,127.074309,0.07377700000000686,122314.54247257493,46193.25806145117
"244.3.48.41",11882,"244.3.160.239",80,12,1793,6,1146,6,647,127.141289,0.285775000000001,32081.182748665797,18112.151167876764
"244.3.48.41",8377,"244.3.160.239",80,10,2516,5,1357,5,1159,127.414413,0.10985399999999856,98822.07293316713,84402.93480437782
"244.3.48.41",15157,"244.3.160.239",80,12,2815,6,1746,6,1069,127.795374,0.10527100000000189,132686.11488443872,81237.94777288946
"244.3.48.41",3383,"244.3.160.239",80,12,4421,5,1271,7,3150,127.929971,0.07739900000001398,131371.2063463115,325585.6018811024
"244.3.48.41",5334,"244.3.160.239",80,10,1423,5,987,5,436,128.011444,0.07528199999998719,104885.63003110097,46332.45662974673
"244.3.48.41",4263,"244.3.160.239",80,10,1432,5,996,5,436,128.013497,0.0755670000000066,105442.85203857906,46157.71434620529
"244.3.48.41",12758,"244.3.160.239",80,12,3486,6,2612,6,874,128.200793,0.08342700000000036,250470.47119038092,83809.79778728672
"244.3.48.41",6062,"244.3.160.239",80,12,4421,5,1271,7,3150,128.307777,0.07946400000000153,127957.31400382316,317124.73572938074
"244.3.48.41",7615,"244.3.160.239",80,10,1432,5,996,5,436,128.392831,0.08415400000001227,94683.55633717754,41447.82185041105
"244.3.48.41",5385,"244.3.160.239",80,10,1423,5,987,5,436,128.39512,0.08334999999999582,94733.05338932689,41847.63047390732
"244.3.48.41",13685,"244.3.160.239",80,9,1458,5,1086,4,372,150.079461,0.07477099999999837,116194.7813992081,39801.52733011549
"244.3.48.41",14693,"244.3.160.239",80,12,4150,6,1064,6,3086,151.63496,0.0766879999999901,110995.20133529494,321927.81139165437
"244.3.48.41",14893,"244.3.160.239",80,12,4101,6,1065,6,3036,152.314094,0.27301299999999173,31207.305146642313,88962.79664338597
"244.3.48.41",8910,"244.3.160.239",80,10,2340,5,1342,5,998,155.058386,0.11099799999999505,96722.46346781455,71929.2239499843
"244.3.48.41",9271,"244.3.160.239",80,12,1778,6,1131,6,647,155.746033,0.21086799999997652,42908.35973215949,24546.16157975879
"244.3.48.41",11336,"244.3.160.239",80,10,2340,5,1342,5,998,156.349159,0.10668200000000638,100635.53364203294,74839.24185897829
"244.3.48.41",3665,"244.3.160.239",80,12,2800,6,1731,6,1069,156.512449,0.10276999999999248,134747.49440499186,83214.94599591929
"244.3.48.41",12874,"244.3.160.239",80,12,4406,5,1256,7,3150,156.646901,0.10467999999997346,95987.77225833538,240733.66450139845
"244.3.48.41",7874,"244.3.160.239",80,10,1423,5,987,5,436,156.755672,0.07455600000000118,105906.96925800573,46783.625730993415
"244.3.48.41",14749,"244.3.160.239",80,10,1432,5,996,5,436,156.75901,0.0745200000000068,106924.31561995803,46806.22651636717
"244.3.48.41",6684,"244.3.160.239",80,21,11372,12,10306,9,1066,156.958121,0.1637049999999931,503637.64087843057,52093.70514034611
"244.3.48.41",15410,"244.3.160.239",80,12,4406,5,1256,7,3150,157.151337,0.09551299999998264,105200.33922085816,263838.43037078285
"244.3.48.41",6629,"244.3.160.239",80,10,1423,5,987,5,436,157.255796,0.07645700000000488,103273.73556377436,45620.41408896213
"244.3.48.41",11245,"244.3.160.239",80,10,1432,5,996,5,436,157.256348,0.07653299999998353,104111.95170712915,45575.11138986778
"244.3.48.41",4532,"244.3.160.239",80,108,73576,38,3493,70,70083,159.679943,0.5353240000000028,52200.16289200532,1047335.8190553703
"244.3.48.41",10910,"244.3.160.239",80,10,1505,5,1069,5,436,159.992882,0.07494199999999296,114114.91553469088,46542.659656805634
"244.3.48.41",3933,"244.3.160.239",80,10,1498,5,1062,5,436,160.21801,0.07542200000000321,112646.17750788415,46246.45328948916
"244.3.48.41",12887,"244.3.160.239",80,10,1501,5,1065,5,436,160.223268,0.0746870000000115,114076.07749673555,46701.567876597845
"244.3.48.41",10757,"244.3.160.239",80,10,1500,5,1064,5,436,160.295581,0.07399100000000658,115041.01850224004,47140.86848400062
"244.3.48.41",11027,"244.3.160.239",80,10,1502,5,1066,5,436,160.377829,0.07590500000000588,112350.96502205834,45952.177063430994
"244.3.48.41",6208,"244.3.160.239",80,10,1509,5,1073,5,436,160.520185,0.07638500000001613,112378.08470247021,45663.41559205686
"244.3.48.41",14176,"244.3.160.239",80,10,1506,5,1070,5,436,160.600234,0.07587799999998879,112812.67297505555,45968.528427218895
"244.3.48.41",14760,"244.3.160.239",80,10,1507,5,1071,5,436,160.683056,0.07556800000000408,113381.3254287468,46157.10353588572
"244.3.48.41",7505,"244.3.160.239",80,24,11467,10,1392,14,10075,160.763296,0.1939649999999915,57412.41976645523,415538.88588149165
"244.3.48.41",12997,"244.3.160.239",80,10,1512,5,1076,5,436,160.960509,0.07429099999998812,115868.67857481225,46950.5054448124
"244.3.48.41",3526,"244.3.160.239",80,10,1507,5,1071,5,436,161.037637,0.07371600000001877,116229.85511961879,47316.729068304194
"244.3.48.41",7974,"244.3.160.239",80,10,1507,5,1071,5,436,161.116355,0.07452200000000175,114972.75972195859,46804.97034432675
"244.3.48.41",12108,"244.3.160.239",80,12,4165,6,1079,6,3086,161.19551,0.07801999999998088,110638.29787236753,316431.6841836202
"244.3.48.41",15713,"244.3.160.239",80,10,1493,5,1057,5,436,161.197627,0.07670799999999645,110236.22047244605,45471.1372998926
"244.3.48.41",13325,"244.3.160.239",80,10,1492,5,1056,5,436,161.274546,0.0745640000000094,113298.64277666078,46778.60629793949
"244.3.48.41",7804,"244.3.160.239",80,10,1496,5,1060,5,436,161.275157,0.07725499999997965,109766.35816454902,45149.181282776764
"244.3.48.41",9732,"244.3.160.239",80,10,1503,5,1067,5,436,161.3503,0.07610399999998663,112162.30421530406,45832.01934196117
"244.3.48.41",10765,"244.3.160.239",80,10,1506,5,1070,5,436,161.437148,0.07432499999998754,115169.86209218211,46929.027917935884
"244.3.48.41",15738,"244.3.160.239",80,10,1496,5,1060,5,436,161.528354,0.07494299999999043,113152.66269032574,46542.03861602078
"244.3.48.41",5203,"244.3.160.239",80,10,1495,5,1059,5,436,161.627357,0.0776740000000018,109071.24649174504,44905.631227951686
"244.3.48.41",12733,"244.3.160.239",80,10,1513,5,1077,5,436,161.62837,0.0770390000000134,111839.45793686966,45275.76941548298
"244.3.48.41",16139,"244.3.160.239",80,10,1518,5,1082,5,436,161.707024,0.07696800000002213,112462.32200391736,45317.53455980404
"244.3.48.41",3770,"244.3.160.239",80,10,1520,5,1084,5,436,161.707031,0.07578100000000632,114435.01669282904,46027.368337706146
"244.3.48.41",15492,"244.3.160.239",80,10,1518,5,1082,5,436,161.783833,0.07567200000002572,114388.41315145705,46093.667406686945
"244.3.48.41",7292,"244.3.160.239",80,10,1520,5,1084,5,436,161.785086,0.07777600000000007,111499.69142151812,44846.739354042336
"244.3.48.41",11831,"244.3.160.239",80,10,1526,5,1090,5,436,161.86012,0.07586600000001908,114939.49858958962,45975.79943583585
"244.3.48.41",3807,"244.3.160.239",80,205,139078,69,5214,136,133864,161.864247,0.6725219999999865,62023.2497970339,1592382.107945943
"244.3.48.41",5809,"244.3.160.239",80,10,1520,5,1084,5,436,161.937796,0.07587300000000141,114296.25822097239,45971.557734634654
"244.3.48.41",9147,"244.3.160.239",80,10,1506,5,1070,5,436,162.014824,0.07525899999998842,113740.54930309088,46346.61635153984
"244.3.48.41",3398,"244.3.160.239",80,14,5401,6,1210,8,4191,162.070251,0.1089849999999899,88819.56232509884,307638.66587147873
"244.3.48.41",6157,"244.3.160.239",80,10,1495,5,1059,5,436,162.090993,0.0761579999999924,111242.41708029158,45799.5220462768
"244.3.48.41",14365,"244.3.160.239",80,10,1504,5,1068,5,436,162.168464,0.07573199999998792,112818.88765649083,46057.14889347378
"244.3.48.41",4194,"244.3.160.239",80,10,1511,5,1075,5,436,162.245259,0.07441399999999021,115569.65087216292,46872.9002607098
"244.3.48.41",15104,"244.3.160.239",80,10,1504,5,1068,5,436,162.32111,0.07470499999999447,114369.85476207259,46690.31523994724
"244.3.48.41",3511,"244.3.160.239",80,10,1498,5,1062,5,436,162.397234,0.07645899999999983,111118.37716946361,45619.22075883817
"244.3.48.41",15150,"244.3.160.239",80,10,1503,5,1067,5,436,162.43651499999999,0.07515500000002362,113578.60421791387,46410.75111434906
"244.3.48.41",10237,"244.3.160.239",80,10,1503,5,1067,5,436,162.474839,0.07613799999998605,112112.2172896788,45811.55270693529
"244.3.48.41",7838,"244.3.160.239",80,10,1506,5,1070,5,436,162.513052,0.0761630000000082,112390.53083517034,45796.515368349785
"244.3.48.41",8015,"244.3.160.239",80,10,1506,5,1070,5,436,162.552318,0.0745759999999791,114782.23557179788,46771.07916757371
"244.3.48.41",8153,"244.3.160.239",80,10,1519,5,1083,5,436,162.590269,0.07719699999998397,112232.34063502208,45183.10297033206
"244.3.48.41",15709,"244.3.160.239",80,10,1507,5,1071,5,436,162.628448,0.07459400000001892,114861.78513014219,46759.793012830996
"244.3.48.41",14458,"244.3.160.239",80,10,3988,5,1016,5,2972,162.668845,0.18935999999999353,42923.53189691739,125559.78031263631
"244.3.48.41",4305,"244.3.160.239",80,10,1512,5,1076,5,436,162.704457,0.07605399999999918,113182.7385804835,45862.150577221946
"244.3.48.41",5718,"244.3.160.239",80,10,1509,5,1073,5,436,162.782141,0.07658200000000193,112089.00263769273,45545.950745604874
"244.3.48.41",9837,"244.3.160.239",80,10,1505,5,1069,5,436,162.859934,0.07506899999998495,113921.85855681726,46463.919860404414
"244.3.48.41",10364,"244.3.160.239",80,10,1516,5,1080,5,436,162.862847,0.07634200000001101,113174.9233711293,45689.13573130776
"244.3.48.41",9625,"244.3.160.239",80,10,1501,5,1065,5,436,162.935937,0.0769860000000051,110669.4723715927,45306.9389239572
"244.3.48.41",3658,"244.3.160.239",80,10,1504,5,1068,5,436,162.940081,0.07623399999999947,112075.97659836896,45753.86310570119
"244.3.48.41",3872,"244.3.160.239",80,10,1506,5,1070,5,436,163.013756,0.07495399999999108,114203.37807189768,46535.20826107232
"244.3.48.41",7720,"244.3.160.239",80,10,1505,5,1069,5,436,163.017024,0.07581400000000826,112802.38478380072,46007.333737827044
"244.3.48.41",12014,"244.3.160.239",80,10,1546,5,1130,5,416,163.117848,0.07543099999998049,119844.62621471727,44119.79159763043
"244.3.48.41",13001,"244.3.160.239",80,10,1507,5,1071,5,436,163.195016,0.07464799999999627,114778.69467367415,46725.96720608957
"244.3.48.41",7765,"244.3.160.239",80,10,1541,5,1125,5,416,163.222355,0.07448999999999728,120821.5867901776,44677.13787085678
"244.3.48.41",10136,"244.3.160.239",80,10,1544,5,1128,5,416,163.229262,0.07333599999998341,123050.07090654032,45380.16799390139
"244.3.48.41",6906,"244.3.160.239",80,48,29529,17,1895,31,27634,163.822691,0.18460000000001742,82123.51029251663,1197573.131094145
"244.3.48.41",8956,"244.3.160.239",80,10,2355,5,1357,5,998,164.024664,0.10847799999999097,100075.5913641559,73600.17699441974
"244.3.48.41",2129,"244.3.160.239",80,10,1542,5,1126,5,416,164.161241,0.07486300000002188,120326.463005722,44454.53695415662
"244.3.48.41",10958,"244.3.160.239",80,10,1539,5,1123,5,416,164.16754,0.07585800000001086,118431.80679689306,43871.44401380901
"244.3.48.41",5910,"244.3.160.239",80,10,1538,5,1122,5,416,164.237069,0.07358200000001602,121986.35535862093,45228.45261068298
"244.3.48.41",8334,"244.3.160.239",80,10,1549,5,1133,5,416,164.244369,0.07431299999998942,121970.58388170699,44783.550657361084
"244.3.48.41",2717,"244.3.160.239",80,10,1544,5,1128,5,416,164.312598,0.07361099999999965,122590.37372131941,45210.6342802029
"244.3.48.41",8766,"244.3.160.239",80,10,1562,5,1136,5,426,164.319679,0.0741390000000024,122580.55814078564,45967.70930279461
"244.3.48.41",5729,"244.3.160.239",80,10,1542,5,1126,5,416,164.38721,0.08189699999999789,109991.81899215151,40636.40914807729
"244.3.48.41",5538,"244.3.160.239",80,10,1554,5,1128,5,426,164.394664,0.07813600000000065,115490.93887580532,43616.25883075627
"244.3.48.41",11441,"244.3.160.239",80,12,1793,6,1146,6,647,164.945531,0.2179710000000057,42060.64109445642,23746.27817461894
"244.3.48.41",11986,"244.3.160.239",80,10,2355,5,1357,5,998,165.007317,0.1062300000000107,102193.3540431037,75157.67673914332
"244.3.48.41",13354,"244.3.160.239",80,12,2654,6,1746,6,908,165.353404,0.09808899999998744,142401.28862565415,74055.19477210421
"244.3.48.41",6180,"244.3.160.239",80,12,4421,5,1271,7,3150,165.47544,0.14885100000000762,68309.92065891046,169296.81359210695
"244.3.48.41",12774,"244.3.160.239",80,10,1423,5,987,5,436,165.628289,0.07508699999999635,105158.01670063238,46452.7814401983
"244.3.48.41",13176,"244.3.160.239",80,10,1432,5,996,5,436,165.629146,0.07694000000000756,103561.2165323527,45334.02651416243
"244.3.48.41",2340,"244.3.160.239",80,12,3363,6,2489,6,874,165.773966,0.08267699999998968,240840.86263413628,84570.07390206313
"244.3.48.41",12410,"244.3.160.239",80,13,4485,6,1335,7,3150,165.881627,0.08193399999998974,130348.81734080281,307564.62518616393
"244.3.48.41",3040,"244.3.160.239",80,10,1423,5,987,5,436,165.967769,0.07541399999999499,104702.04471319019,46251.35916408402
"244.3.48.41",3512,"244.3.160.239",80,10,1432,5,996,5,436,165.970581,0.07616299999997977,104617.72776810415,45796.515368366876
"244.3.48.41",11728,"244.3.160.239",80,11,4086,5,1000,6,3086,177.088334,0.07698899999999753,103910.9483172954,320669.18650717364
"244.3.48.41",15042,"244.3.160.239",80,13,4165,7,1129,6,3036,177.4711,0.2556889999999896,35324.163339057865,94990.39849192178
"244.3.48.41",7462,"244.3.160.239",80,10,2340,5,1342,5,998,180.33702,0.11338000000000648,94690.42159110414,70418.06315046344
"244.3.48.41",10340,"244.3.160.239",80,12,1778,6,1131,6,647,181.043564,0.252837999999997,35785.76005189136,20471.60632499886
"244.3.48.41",14032,"244.3.160.239",80,10,2340,5,1342,5,998,181.636702,0.1178859999999986,91071.03472846757,67726.44758495576
"244.3.48.41",8270,"244.3.160.239",80,12,2639,6,1731,6,908,181.821419,0.13419300000001044,103194.65247813912,54130.99043913941
"244.3.48.41",6147,"244.3.160.239",80,12,4406,5,1256,7,3150,181.992489,0.1109739999999988,90543.73096401057,227080.21698776537
"244.3.48.41",10227,"244.3.160.239",80,10,1423,5,987,5,436,182.10886,0.07543900000001713,104667.3471281195,46236.03176074985
"244.3.48.41",5893,"244.3.160.239",80,10,1432,5,996,5,436,182.113923,0.07420700000000124,107375.31499723566,47003.65194658107
"244.3.48.41",7960,"244.3.160.239",80,21,11372,12,10306,9,1066,182.300489,0.23877100000001406,345301.5650979187,35716.230195457145
"244.3.48.41",15091,"244.3.160.239",80,12,4406,5,1256,7,3150,182.572361,0.10152600000000689,98969.7220416378,248212.28059805656
"244.3.48.41",3236,"244.3.160.239",80,10,1423,5,987,5,436,182.677567,0.07529699999997774,104864.73564686952,46323.22668899201
"244.3.48.41",5200,"244.3.160.239",80,10,1432,5,996,5,436,182.679346,0.07604599999999095,104778.6865844482,45866.97525182672
"244.3.48.41",10184,"244.3.160.239",80,107,72898,37,3161,70,69737,187.81244,0.8751460000000009,28895.74996629131,637489.0589684458
"244.3.48.41",4380,"244.3.160.239",80,10,1505,5,1069,5,436,188.490406,0.07644399999998086,111872.74344621084,45628.172256826874
"244.3.48.41",13545,"244.3.160.239",80,10,1498,5,1062,5,436,188.601943,0.07658899999998425,110929.76798237015,45541.78798522917
"244.3.48.41",9896,"244.3.160.239",80,10,1501,5,1065,5,436,188.679581,0.07533999999998287,113087.3374037953,46296.787894887086
"244.3.48.41",12126,"244.3.160.239",80,10,1500,5,1064,5,436,188.710141,0.07481100000001106,113780.0590822037,46624.15954872257
"244.3.48.41",16002,"244.3.160.239",80,10,1502,5,1066,5,436,188.795232,0.07562699999999722,112763.95996139359,46121.094318168485
"244.3.48.41",7618,"244.3.160.239",80,10,1509,5,1073,5,436,188.981948,0.07524500000002377,114080.6698119116,46355.23955078608
"244.3.48.41",15062,"244.3.160.239",80,10,1506,5,1070,5,436,189.064149,0.07881700000001501,108606.01139346042,44254.41211920443
"244.3.48.41",2190,"244.3.160.239",80,10,1507,5,1071,5,436,189.152806,0.0746690000000001,114746.41417455689,46712.82593847508
"244.3.48.41",8608,"244.3.160.239",80,24,11467,10,1392,14,10075,189.232346,0.1902379999999937,58537.20076956428,423679.81160442537
"244.3.48.41",12297,"244.3.160.239",80,10,1512,5,1076,5,436,189.433814,0.07631299999999896,112798.60574214245,45706.498237522406
"244.3.48.41",5515,"244.3.160.239",80,10,1507,5,1071,5,436,189.513341,0.07412899999999922,115582.2957277191,47053.11011884737
"244.3.48.41",10332,"244.3.160.239",80,10,1507,5,1071,5,436,189.592674,0.07368000000002439,116286.64495110157,47339.84799129812
"244.3.48.41",8988,"244.3.160.239",80,12,4165,6,1079,6,3086,189.67782,0.08129500000001144,106181.19195520986,303684.1134140664
"244.3.48.41",2697,"244.3.160.239",80,10,1492,5,1056,5,436,189.67990700000001,0.078251999999992,107958.90200890538,44573.940602161696
"244.3.48.41",10696,"244.3.160.239",80,10,1493,5,1057,5,436,189.760194,0.07556099999999333,111909.58298594177,46161.37954765432
"244.3.48.41",3431,"244.3.160.239",80,10,1503,5,1067,5,436,189.760199,0.07758000000001175,110028.35782416482,44960.041247737456
"244.3.48.41",11840,"244.3.160.239",80,10,1496,5,1060,5,436,189.837527,0.07579400000000192,111882.20703485481,46019.47383697802
"244.3.48.41",3038,"244.3.160.239",80,10,1506,5,1070,5,436,189.924731,0.07682900000000359,111416.26208852907,45399.52361738194
"244.3.48.41",9027,"244.3.160.239",80,10,1496,5,1060,5,436,190.012797,0.07439700000000471,113983.09071601628,46883.610898285944
"244.3.48.41",12560,"244.3.160.239",80,10,1495,5,1059,5,436,190.118745,0.07723400000000424,109692.62242017161,45161.45738923024
"244.3.48.41",6541,"244.3.160.239",80,10,1513,5,1077,5,436,190.126642,0.07434200000000146,115896.80126980483,46918.29652148088
"244.3.48.41",15148,"244.3.160.239",80,10,1520,5,1084,5,436,190.198554,0.07761299999998528,111733.8590184846,44940.92484507314
"244.3.48.41",12579,"244.3.160.239",80,10,1518,5,1082,5,436,190.20224,0.07655200000002083,113073.46640189212,45563.79977007852
"244.3.48.41",11880,"244.3.160.239",80,10,1518,5,1082,5,436,190.278462,0.08078299999999672,107151.25707141789,43177.40118589483
"244.3.48.41",12852,"244.3.160.239",80,10,1503,5,1067,5,436,190.280793,0.07721600000002127,110547.03688351701,45171.98508079982
"244.3.48.41",3260,"244.3.160.239",80,10,1526,5,1090,5,436,190.359842,0.0776130000000137,112352.31211264171,44940.92484505668
"244.3.48.41",7243,"244.3.160.239",80,182,128723,62,4760,120,123963,190.360967,0.6656480000000045,57207.412926952,1489832.4640049897
"244.3.48.41",8507,"244.3.160.239",80,10,1506,5,1070,5,436,190.438448,0.0765750000000196,111785.8308847249,45550.11426704678
"244.3.48.41",4940,"244.3.160.239",80,10,1504,5,1068,5,436,190.517241,0.07572599999997465,112827.82663818056,46060.798140680454
"244.3.48.41",16041,"244.3.160.239",80,10,1511,5,1075,5,436,190.594001,0.0752339999999947,114310.01940612764,46362.01717308991
"244.3.48.41",4651,"244.3.160.239",80,10,1504,5,1068,5,436,190.670135,0.07529900000000112,113467.64233256581,46321.99630805122
"244.3.48.41",2587,"244.3.160.239",80,14,5562,6,1210,8,4352,190.72239,0.10905999999999949,88758.48156977852,319237.1171832034
"244.3.48.41",8842,"244.3.160.239",80,10,1495,5,1059,5,436,190.745794,0.08024900000000912,105571.40898950813,43464.71607122336
"244.3.48.41",9024,"244.3.160.239",80,10,1498,5,1062,5,436,190.828429,0.07684900000000994,110554.46394876839,45387.708363147845
"244.3.48.41",2966,"244.3.160.239",80,10,1503,5,1067,5,436,190.906393,0.07883400000000051,108278.15409594774,44244.86896516702
"244.3.48.41",4575,"244.3.160.239",80,10,1520,5,1084,5,436,190.929018,0.07532599999998979,115126.25122801126,46305.39256034401
"244.3.48.41",3392,"244.3.160.239",80,10,1520,5,1084,5,436,190.986122,0.07639800000001173,113510.8248906865,45655.64543573738
"244.3.48.41",3890,"244.3.160.239",80,10,1506,5,1070,5,436,191.005903,0.0761240000000214,112448.11097679568,45819.97793073169
"244.3.48.41",6584,"244.3.160.239",80,10,1506,5,1070,5,436,191.063661,0.07526200000000927,113736.01551910587,46344.76894049548
"244.3.48.41",4976,"244.3.160.239",80,10,1519,5,1083,5,436,191.106244,0.0750759999999957,115403.05823432916,46459.587617883204
"244.3.48.41",13944,"244.3.160.239",80,10,1507,5,1071,5,436,191.140998,0.07486399999999094,114447.53152384373,46591.15195555169
"244.3.48.41",7339,"244.3.160.239",80,10,3988,5,1016,5,2972,191.183475,0.09144100000000321,88887.91679880704,260014.65425792767
"244.3.48.41",12903,"244.3.160.239",80,10,1512,5,1076,5,436,191.217062,0.07492999999999483,114880.55518484711,46550.113439213135
"244.3.48.41",7095,"244.3.160.239",80,10,1509,5,1073,5,436,191.276195,0.07477099999999837,114803.86780971484,46649.10192454396
"244.3.48.41",10372,"244.3.160.239",80,10,1516,5,1080,5,436,191.29416,0.07418400000000247,116467.16273050405,47018.22495416645
"244.3.48.41",13900,"244.3.160.239",80,10,1505,5,1069,5,436,191.35328,0.07529299999998784,113582.93599672454,46325.68764693349
"244.3.48.41",13309,"244.3.160.239",80,10,1501,5,1065,5,436,191.370741,0.0806699999999978,105615.47043510887,43237.88273211969
"244.3.48.41",16173,"244.3.160.239",80,10,1504,5,1068,5,436,191.430102,0.07655099999999493,111611.86659874549,45564.39497851408
"244.3.48.41",16324,"244.3.160.239",80,10,1506,5,1070,5,436,191.452391,0.07779999999999632,110025.70694087924,44832.90488432089
"244.3.48.41",11153,"244.3.160.239",80,10,1505,5,1069,5,436,191.5086,0.08197499999999991,104324.48917352864,42549.55779200981
"244.3.48.41",2825,"244.3.160.239",80,10,1546,5,1130,5,416,191.940169,0.07533100000000559,120003.71692927652,44178.35950670711
"244.3.48.41",13463,"244.3.160.239",80,10,1507,5,1071,5,436,192.011579,0.07455999999999108,114914.16309014251,46781.115879833924
"244.3.48.41",12720,"244.3.160.239",80,10,1541,5,1125,5,416,192.058869,0.07390000000000896,121786.19756426128,45033.82949931795
"244.3.48.41",10581,"244.3.160.239",80,10,1554,5,1128,5,426,192.066746,0.07463500000000067,120908.42098211186,45662.222817712456
"244.3.48.41",7714,"244.3.160.239",80,107,72933,37,3161,70,69772,192.24654,1.0538609999999835,23995.5743689162,529648.5969212342
"244.3.48.41",4001,"244.3.160.239",80,48,29690,17,1895,31,27795,192.861862,0.18642399999998815,81320.00171652235,1192764.8800584374
"244.3.48.41",5273,"244.3.160.239",80,10,2355,5,1357,5,998,193.068997,0.1068779999999947,101573.75699396076,74701.99666910306
"244.3.48.41",7591,"244.3.160.239",80,10,1505,5,1069,5,436,193.106734,0.07473699999999894,114427.92726494401,46670.32393593601
"244.3.48.41",3797,"244.3.160.239",80,10,1549,5,1133,5,416,193.193445,0.07559399999999528,119903.69606054139,44024.65804164627
"244.3.48.41",3046,"244.3.160.239",80,10,1539,5,1123,5,416,193.204698,0.07595699999998828,118277.44644998336,43814.26333320844
"244.3.48.41",7482,"244.3.160.239",80,10,1498,5,1062,5,436,193.247734,0.07622699999998872,111456.57050652993,45758.06472772792
"244.3.48.41",3979,"244.3.160.239",80,10,1542,5,1126,5,416,193.270216,0.07490799999999354,120254.17845891997,44427.831473277714
"244.3.48.41",11585,"244.3.160.239",80,10,1538,5,1122,5,416,193.281486,0.07467099999999505,120207.30939723046,44568.841986851934
"244.3.48.41",9995,"244.3.160.239",80,10,1501,5,1065,5,436,193.30137,0.07570700000002262,112539.13112390472,46072.35790612437
"244.3.48.41",5378,"244.3.160.239",80,10,1500,5,1064,5,436,193.324831,0.07466600000000767,114001.01786621923,46714.702809841714
"244.3.48.41",14230,"244.3.160.239",80,10,1544,5,1128,5,416,193.346816,0.07390000000000896,122110.96075776598,45033.82949931795
"244.3.48.41",6451,"244.3.160.239",80,10,1552,5,1136,5,416,193.357033,0.07429899999999634,122316.58568756575,44791.989125024076
"244.3.48.41",12932,"244.3.160.239",80,10,1502,5,1066,5,436,193.408507,0.07572400000000812,112619.51296813542,46062.01468490341
"244.3.48.41",7622,"244.3.160.239",80,10,1542,5,1126,5,416,193.422056,0.07443599999999151,121016.71234350352,44709.54914289295
"244.3.48.41",13041,"244.3.160.239",80,10,1544,5,1128,5,416,193.432545,0.07407599999999093,121820.8326583658,44926.83190237604
"244.3.48.41",14435,"244.3.160.239",80,10,1509,5,1073,5,436,193.592948,0.07656000000000063,112121.2121212112,45559.038662486564
"244.3.48.41",12039,"244.3.160.239",80,10,1506,5,1070,5,436,193.675226,0.07469299999999635,114602.43931828174,46697.81639511294
"244.3.48.41",8753,"244.3.160.239",80,10,1507,5,1071,5,436,193.75955,0.07461399999999685,114830.99686386417,46747.259227492796
"244.3.48.41",10530,"244.3.160.239",80,12,1793,6,1146,6,647,193.821992,0.22429700000000707,40874.37638488125,23076.545829858787
"244.3.48.41",11039,"244.3.160.239",80,23,11403,9,1328,14,10075,193.855572,0.18835699999999633,56403.5315916064,427910.82890469464
"244.3.48.41",4350,"244.3.160.239",80,10,2355,5,1357,5,998,193.909954,0.10792399999999702,100589.30358400634,73977.98450761852
"244.3.48.41",16106,"244.3.160.239",80,10,1512,5,1076,5,436,194.055104,0.07477099999999837,115124.84786882867,46649.10192454396
"244.3.48.41",15422,"244.3.160.239",80,10,1507,5,1071,5,436,194.134013,0.07551300000000083,113463.90687696033,46190.72212731532
"244.3.48.41",14593,"244.3.160.239",80,10,1507,5,1071,5,436,194.236922,0.07529999999999859,113784.86055777106,46321.38114209914
"244.3.48.41",3419,"244.3.160.239",80,11,4101,5,1015,6,3086,194.31815,0.07807399999998665,104003.89374185244,316212.82373138587
"244.3.48.41",10404,"244.3.160.239",80,10,1493,5,1057,5,436,194.323476,0.07684199999999919,110043.98636162632,45391.843002525144
"244.3.48.41",14417,"244.3.160.239",80,10,1492,5,1056,5,436,194.399733,0.07934800000001019,106467.7118515768,43958.25981750708
"244.3.48.41",5571,"244.3.160.239",80,10,1496,5,1060,5,436,194.404449,0.07833600000000729,108251.63398691804,44526.143790845534
"244.3.48.41",5183,"244.3.160.239",80,12,2654,6,1746,6,908,194.414253,0.11201900000000364,124693.13241503268,64846.14217230795
"244.3.48.41",7383,"244.3.160.239",80,10,1503,5,1067,5,436,194.479936,0.07474499999997875,114201.6188374129,46665.32878454735
"244.3.48.41",11023,"244.3.160.239",80,10,1506,5,1070,5,436,194.57497,0.0757199999999898,113048.07184364968,46064.44796619744
"244.3.48.41",5753,"244.3.160.239",80,12,4421,5,1271,7,3150,194.577087,0.09223499999998808,110240.14744946403,273215.1569361225
"244.3.48.41",3856,"244.3.160.239",80,10,1496,5,1060,5,436,194.671359,0.07397000000000276,114641.07070433533,47154.25172367
"244.3.48.41",11124,"244.3.160.239",80,10,1423,5,987,5,436,194.677591,0.07473999999999137,105646.24029971784,46668.45062885206
"244.3.48.41",8672,"244.3.160.239",80,10,1432,5,996,5,436,194.746296,0.07640900000001238,104280.90931694838,45649.0727532023
"244.3.48.41",11706,"244.3.160.239",80,10,1495,5,1059,5,436,194.796346,0.07478499999999144,113284.74961557759,46640.369057971504
"244.3.48.41",5990,"244.3.160.239",80,10,1513,5,1077,5,436,194.823759,0.07893300000000636,109155.86636767013,44189.37579972533
"244.3.48.41",12446,"244.3.160.239",80,10,1520,5,1084,5,436,194.872047,0.08066800000000285,107502.3553329659,43238.9547280195
"244.3.48.41",3208,"244.3.160.239",80,10,1518,5,1082,5,436,194.904375,0.08093500000001086,106950.02162227515,43096.31185518666
"244.3.48.41",12386,"244.3.160.239",80,10,1518,5,1082,5,436,194.964453,0.07702500000002033,112379.09769552373,45283.99870170827
"244.3.48.41",3420,"244.3.160.239",80,10,1520,5,1084,5,436,194.990047,0.07842199999998911,110581.21445514275,44477.315039153356
"244.3.48.41",15597,"244.3.160.239",80,10,1526,5,1090,5,436,195.042547,0.07786999999999011,111981.50764095424,44792.6030563817
"244.3.48.41",15772,"244.3.160.239",80,10,1520,5,1084,5,436,195.069647,0.07853699999998298,110419.2928174221,44412.1878859742
"244.3.48.41",4396,"244.3.160.239",80,210,143188,69,5208,141,137980,195.125917,0.6602980000000116,63098.782670853565,1671730.0370438509
"244.3.48.41",12477,"244.3.160.239",80,10,1506,5,1070,5,436,195.149248,0.08602899999999636,99501.3309465455,40544.467563265265
"244.3.48.41",13907,"244.3.160.239",80,10,1506,5,1070,5,436,195.236385,0.07446600000000103,114951.79007869204,46840.168667579186
"244.3.48.41",4753,"244.3.160.239",80,28,15560,11,2492,17,13068,195.301117,0.7573549999999898,26323.190577734706,138038.30436189292
"244.3.48.41",14060,"244.3.160.239",80,10,1495,5,1059,5,436,195.311946,0.07489400000000046,113119.87609154201,46572.48911795309
"244.3.48.41",6435,"244.3.160.239",80,10,1506,5,1070,5,436,195.388978,0.0795519999999783,107602.57441676305,43845.53499598943
"244.3.48.41",11626,"244.3.160.239",80,10,1519,5,1083,5,436,195.47049,0.07641299999997386,113383.84829810324,45646.6831560231
"244.3.48.41",11213,"244.3.160.239",80,10,1504,5,1068,5,436,195.548218,0.0762459999999976,112058.33748656021,45746.662119981505
"244.3.48.41",11292,"244.3.160.239",80,14,5401,6,1210,8,4191,195.580069,0.11065899999999829,87475.93959822653,302984.8453356755
"244.3.48.41",12734,"244.3.160.239",80,10,1511,5,1075,5,436,195.626067,0.0782299999999907,109932.25105459572,44586.47577656161
"244.3.48.41",14305,"244.3.160.239",80,10,1504,5,1068,5,436,195.693919,0.07700300000001903,110956.71597207757,45296.93648298298
"244.3.48.41",6968,"244.3.160.239",80,10,1498,5,1062,5,436,195.705156,0.07605700000002003,111705.69441337106,45860.34158590375
"244.3.48.41",3935,"244.3.160.239",80,10,1503,5,1067,5,436,195.771412,0.0744410000000073,114667.99210111581,46855.89930279896
"244.3.48.41",5784,"244.3.160.239",80,10,1503,5,1067,5,436,195.783602,0.07418599999999742,115062.14110479466,47016.95737740438
"244.3.48.41",7308,"244.3.160.239",80,10,1507,5,1071,5,436,195.846636,0.07431600000001026,115291.4580978365,46934.71123310617
"244.3.48.41",14546,"244.3.160.239",80,10,3988,5,1016,5,2972,195.859221,0.15861200000000508,51244.54644036857,149900.38584721988
"244.3.48.41",3261,"244.3.160.239",80,10,1512,5,1076,5,436,195.921893,0.07698499999997921,111813.9897382909,45307.5274404227
"244.3.48.41",3063,"244.3.160.239",80,10,1509,5,1073,5,436,195.999934,0.07564700000000357,113474.42727404385,46108.90055124242
"244.3.48.41",14366,"244.3.160.239",80,10,1516,5,1080,5,436,196.020547,0.07634100000001354,113176.40586314652,45689.73421882581
"244.3.48.41",2602,"244.3.160.239",80,10,1505,5,1069,5,436,196.080978,0.07676600000002054,111403.48591821524,45436.781908645324
"244.3.48.41",3829,"244.3.160.239",80,10,1501,5,1065,5,436,196.121757,0.08558999999999628,99544.33929197768,40752.424348640634
"244.3.48.41",8395,"244.3.160.239",80,10,1504,5,1068,5,436,196.158237,0.07704099999997993,110901.98725356921,45274.59404733725
"244.3.48.41",6927,"244.3.160.239",80,12,4421,5,1271,7,3150,196.216446,0.08744200000001001,116282.79316574227,288191.02948236675
"244.3.48.41",10182,"244.3.160.239",80,10,1506,5,1070,5,436,196.23632,0.07651099999998223,111879.33761161125,45588.216073516356
"244.3.48.41",16088,"244.3.160.239",80,10,1505,5,1069,5,436,196.305015,0.07590100000001598,112673.0873110789,45954.59875362993
"244.3.48.41",10150,"244.3.160.239",80,10,1423,5,987,5,436,196.31401,0.07430600000000709,106263.28964012659,46941.02764244701
"244.3.48.41",6372,"244.3.160.239",80,10,1432,5,996,5,436,196.381953,0.08252399999997806,96553.72982407686,42266.492171985454
"244.3.48.41",4083,"244.3.160.239",80,10,1544,5,1128,5,416,196.551229,0.07492999999999483,120432.40357667986,44414.787134662074
"244.3.48.41",15275,"244.3.160.239",80,10,1547,5,1131,5,416,196.717177,0.07365000000001487,122851.32382889577,45186.69382212258
"244.3.48.41",13177,"244.3.160.239",80,10,1546,5,1130,5,416,197.255176,0.07425799999998617,121737.7252282809,44816.7200840397
"244.3.48.41",10580,"244.3.160.239",80,10,1507,5,1071,5,436,197.298136,0.07725899999999797,110899.70100571099,45146.84373341736
"244.3.48.41",2289,"244.3.160.239",80,10,1541,5,1125,5,416,197.372506,0.07314800000000332,123038.22387487821,45496.801006177186
"244.3.48.41",13786,"244.3.160.239",80,10,1554,5,1128,5,426,197.379191,0.07732000000001449,116709.77754783121,44076.56492497881
"244.3.48.41",14877,"244.3.160.239",80,47,29465,16,1831,31,27634,198.012172,0.1870270000000005,78320.24253182675,1182032.5407561443
"244.3.48.41",5093,"244.3.160.239",80,10,2355,5,1357,5,998,198.215647,0.10873800000001665,99836.30377603356,73424.19393403205
"244.3.48.41",12976,"244.3.160.239",80,10,1549,5,1133,5,416,198.333832,0.07381399999999871,122795.13371447365,45086.29799225158
"244.3.48.41",11224,"244.3.160.239",80,10,1539,5,1123,5,416,198.338925,0.07331800000000044,122534.71180337634,45391.30909190076
"244.3.48.41",11381,"244.3.160.239",80,10,1542,5,1126,5,416,198.409117,0.07395800000000463,121798.8588117504,44998.51266935006
"244.3.48.41",6889,"244.3.160.239",80,10,1538,5,1122,5,416,198.413628,0.07361600000001545,121930.01521405831,45207.56357312679
"244.3.48.41",12318,"244.3.160.239",80,10,1544,5,1128,5,416,198.484379,0.07339000000001761,122959.53127126087,45346.77749011039
"244.3.48.41",14514,"244.3.160.239",80,10,1562,5,1136,5,426,198.488532,0.07448700000000485,122007.86714459446,45752.95017922292
"244.3.48.41",7057,"244.3.160.239",80,10,1552,5,1126,5,426,198.559017,0.07341299999998796,122703.06349013768,46422.29577868441
"244.3.48.41",4460,"244.3.160.239",80,10,1544,5,1128,5,416,198.564446,0.07489599999999541,120487.0754112443,44434.949797054636
"244.3.48.41",4138,"244.3.160.239",80,12,1793,6,1146,6,647,198.633021,0.21322699999998918,42996.43103359549,24274.599370625026
"244.3.48.41",5595,"244.3.160.239",80,10,2355,5,1357,5,998,199.319984,0.11322099999998159,95883.27253779568,70516.95356869572
"244.3.48.41",9460,"244.3.160.239",80,12,2815,6,1746,6,1069,199.457404,0.09660600000000841,144587.29271472563,88524.52228639273
"244.3.48.41",8825,"244.3.160.239",80,12,4421,5,1271,7,3150,199.580616,0.0822080000000085,123686.25924482956,306539.50953675306
"244.3.48.41",11001,"244.3.160.239",80,10,1423,5,987,5,436,199.666762,0.07521800000000667,104974.87303570024,46371.87907149473
"244.3.48.41",11639,"244.3.160.239",80,10,1432,5,996,5,436,199.670533,0.07520199999999022,105954.62886626733,46381.74516635799
"244.3.48.41",12210,"244.3.160.239",80,12,3087,6,2213,6,874,199.814042,0.0842969999999923,210019.33639395967,82944.8260317762
"244.3.48.41",14236,"244.3.160.239",80,12,4421,5,1271,7,3150,199.923279,0.07955899999998906,127804.52242991238,316746.06267051457
"244.3.48.41",13369,"244.3.160.239",80,10,1423,5,987,5,436,200.007101,0.0750579999999843,105198.64638015469,46470.72930268232
"244.3.48.41",15600,"244.3.160.239",80,10,1432,5,996,5,436,200.010498,0.07437799999999584,107128.45196160754,46895.58740488041
"244.3.56.84",1137,"41.177.98.176",80,50,33847,20,3818,30,30029,98.187497,2.0060000000000002,15226.32103688933,119756.72981056829
"244.3.56.84",1138,"41.177.98.176",80,194,161493,77,18929,117,142564,100.09227,8.304935999999998,18233.97555381523,137329.41469988454
"244.3.56.84",1143,"41.177.98.176",80,66,48875,27,5028,39,43847,100.561149,23.979794,1677.4122413228406,14627.982208687865
"244.3.56.84",1145,"41.177.98.176",80,43,29867,17,3860,26,26007,108.397301,16.144002999999998,1912.7845801317062,12887.509993649037
"244.3.56.84",1146,"41.177.98.176",80,16,4383,8,2060,8,2323,109.409423,15.550930999999991,1059.7436256388771,1195.040991436462
"244.3.56.84",1147,"41.177.98.176",80,16,5812,8,2290,8,3522,109.410178,15.888998,1152.9990752091478,1773.3025078107505
"244.3.57.219",32801,"253.37.253.139",22,2,186,1,64,1,122,153.687536,0.0528500000000065,9687.795648059357,18467.36045411315
"244.3.61.41",55940,"46.242.152.255",80,1,64,0,0,1,64,33.318894,0,0,0
"244.3.61.92",50241,"181.51.224.13",1723,2,132,0,0,2,132,52.752101,2.432772,0,434.07273677927896
"244.3.64.176",49496,"41.177.26.214",22,3,306,2,204,1,102,153.248717,0.0008660000000020318,0,0
"244.3.64.188",49647,"41.177.241.46",443,42,3255,21,1722,21,1533,12.048014,191.24288,72.03405428740666,64.12787759732545
"244.3.64.197",1115,"244.3.41.13",923,4,325,2,151,2,174,27.538471,0.12943599999999833,9332.797676071692,10754.349639976652
"244.3.66.203",53660,"244.3.41.84",23,8,2244,4,404,4,1840,134.286195,0.8675170000000207,3725.5754065913666,16967.96719833692
"244.3.67.108",57946,"41.177.98.176",80,13,6019,7,1243,6,4776,207.561573,3.1546459999999854,3152.1761871221197,12111.660072160292
"244.3.67.108",57947,"41.177.98.176",80,98,74603,44,6864,54,67739,210.069718,2.54765900000001,21553.904977078873,212709.78572877997
"244.3.67.108",57948,"41.177.98.176",80,15,8774,8,3581,7,5193,212.565083,0.05730000000002633,499965.09598580864,725026.1780101381
"244.3.67.108",57949,"41.177.98.176",80,11,5067,6,1935,5,3132,212.571792,0.04760699999999929,325162.26605331636,526309.1562165306
"244.3.67.210",2880,"244.3.41.84",23,4,256,2,128,2,128,18.494996,0.17195900000000108,5954.907855942367,5954.907855942367
"244.3.67.220",1726,"244.3.41.84",23,4,256,2,128,2,128,18.469536,0.11558399999999835,8859.357696567125,8859.357696567125
"244.3.77.18",2493,"244.3.41.84",23,43,12044,22,1493,21,10551,65.144103,14.836291000000003,805.0529610129646,5689.292559710509
"244.3.77.41",1426,"244.3.41.84",23,4,256,2,128,2,128,139.536509,0.1939440000000161,5279.874602977741,5279.874602977741
"244.3.77.123",51576,"244.3.41.13",923,8,571,5,376,3,195,72.422805,0.14610400000000823,20588.074248479374,10677.325740567761
"244.3.77.123",51577,"244.3.41.13",923,8,571,5,376,3,195,105.115994,0.041296000000002664,72839.98450212626,37776.055792326115
"244.3.77.135",1094,"244.3.41.84",23,12,3281,7,481,5,2800,200.747868,10.808201999999994,356.02591439353205,2072.500125367754
"244.3.77.154",1226,"244.3.41.84",23,2,128,2,128,0,0,139.5306,0.21592000000001121,4742.497221192788,0
"244.3.77.177",2323,"244.3.31.168",443,17,6797,8,1441,9,5356,45.114115,0.01124200000000286,1025440.313111285,3811421.4552561017
"244.3.77.177",2324,"244.3.31.168",443,14,2098,7,1242,7,856,45.126791,0.006108000000004665,1626719.0569732173,1121152.5867705909
"244.3.77.177",2325,"244.3.31.168",443,14,2099,7,1243,7,856,45.140517,0.006405000000000882,1552537.080405719,1069164.715066207
"244.3.77.177",2326,"244.3.31.168",443,17,6797,8,1441,9,5356,165.478669,0.010989999999992506,1048953.5941772393,3898817.106463077
"244.3.77.177",2327,"244.3.31.168",443,14,2098,7,1242,7,856,165.491043,0.006053000000008524,1641500.082601356,1131339.831486925
"244.3.77.177",2328,"244.3.31.168",443,14,2099,7,1243,7,856,165.504593,0.006229999999987967,1596147.6725552497,1099197.4317838245
"244.3.77.194",4527,"244.3.41.84",23,4,256,2,128,2,128,139.52056,0.13300700000002053,7698.842918040719,7698.842918040719
"244.3.77.211",2826,"41.177.26.176",80,144,74430,66,6976,78,67454,51.458487,23.722766,2352.5081350125865,22747.431728660984
"244.3.77.211",2827,"41.177.26.176",80,69,17380,32,4163,37,13217,51.573306,23.60775199999999,1410.7230540205612,4478.867788851731
"244.3.77.211",2828,"41.177.26.176",80,18,5619,9,1978,9,3641,51.574586,23.606777000000008,670.3159859560666,1233.8829650485532
"244.3.77.211",2829,"41.177.26.176",80,13,3141,7,1152,6,1989,51.58121,23.600009,390.50832565360463,674.2370310113017
"244.3.77.211",2830,"41.177.26.176",80,15,3575,8,1219,7,2356,51.587313,23.593796000000005,413.328995469826,798.8540716381542
"244.3.77.211",2831,"41.177.26.176",80,11,1855,6,1084,5,771,51.588258,23.59315,367.56431421832184,261.4318138951348
"244.3.77.239",51805,"41.177.241.46",443,49,3703,21,1722,28,1981,0.907776,204.30289199999999,67.42929512715855,77.57109967880436
"244.3.79.15",1858,"244.3.41.84",23,68,17457,35,2776,33,14681,77.064825,125.981937,176.2792391420367,932.2606303473489
"244.3.79.141",2586,"41.177.98.176",80,4,256,2,128,2,128,6.823663,8.752025,117.0014939399739,117.0014939399739
"244.3.79.141",8725,"244.3.160.239",80,69,46246,25,2797,44,43449,23.804328,0.32701299999999733,68425.41428016679,1062930.2198995233
"244.3.79.141",12242,"244.3.160.239",80,11,2679,5,1350,6,1329,24.36935,0.2478990000000003,43566.1297544564,42888.434402720406
"244.3.79.141",5893,"244.3.160.239",80,12,2743,6,1414,6,1329,24.432623,0.2754800000000017,41062.87207782753,38594.45331784497
"244.3.79.141",9895,"244.3.160.239",80,11,2680,5,1351,6,1329,24.432864,0.3077330000000025,35121.355200774415,34549.430837771426
"244.3.79.141",2651,"244.3.160.239",80,138,94231,48,4385,90,89846,39.576436,1.6118719999999982,21763.5147207719,445921.26421949186
"244.3.79.141",10562,"244.3.160.239",80,10,2614,5,1379,5,1235,41.158201,0.111850000000004,98632.0965578865,88332.5882878824
"244.3.79.141",2838,"244.3.160.239",80,13,5004,6,1715,7,3289,41.351743,0.2663039999999981,51520.06729151683,98804.37394857076
"244.3.79.141",8233,"244.3.160.239",80,13,3583,6,1478,7,2105,41.396294,0.36182700000000523,32678.600546669622,46541.57926301729
"244.3.79.141",8201,"244.3.160.239",80,10,2181,5,1662,5,519,41.437617,0.23028499999999497,57737.15179017431,18029.832598736743
"244.3.79.141",11544,"244.3.160.239",80,25,13328,10,1780,15,11548,41.932815,0.17427700000000357,81709.00348295936,530098.6360793341
"244.3.79.141",11910,"244.3.160.239",80,12,2182,6,1497,6,685,41.93303,0.3701939999999979,32350.60535827179,14803.049212034854
"244.3.79.141",15510,"244.3.160.239",80,10,1978,5,1446,5,532,42.025801,0.140825999999997,82143.92228707942,30221.69201709976
"244.3.79.141",10765,"244.3.160.239",80,10,1995,5,1490,5,505,42.026021,0.1666359999999969,71533.16210182807,24244.46098082092
"244.3.79.141",4966,"244.3.160.239",80,10,1952,5,1433,5,519,42.026079,0.14060599999999823,81532.79376413627,29529.323072984454
"244.3.79.141",5833,"244.3.160.239",80,12,2297,6,1282,6,1015,42.026299,0.2806149999999974,36548.29570764248,28936.443169467333
"244.3.79.141",11197,"244.3.160.239",80,132,92772,46,4251,86,88521,52.423122,0.7735850000000042,43961.5556144442,915436.571288218
"244.3.79.141",5108,"244.3.160.239",80,10,2614,5,1379,5,1235,53.177794,0.09731899999999882,113359.15905424565,101521.7994430699
"244.3.79.141",2424,"244.3.160.239",80,13,5018,6,1715,7,3303,53.330057,0.1963620000000006,69870.95262830873,134567.78806490015
"244.3.79.141",15445,"244.3.160.239",80,13,3583,6,1478,7,2105,53.364536,0.3337900000000005,35423.4698463105,50450.8822912609
"244.3.79.141",11941,"244.3.160.239",80,10,2181,5,1662,5,519,53.432551,0.9426440000000014,14105.006768196668,4404.632077433256
"244.3.79.141",12258,"244.3.160.239",80,12,2182,6,1497,6,685,53.640078,0.9128509999999963,13119.337109780292,6003.170287374415
"244.3.79.141",11428,"244.3.160.239",80,10,1978,5,1446,5,532,53.69894,0.11753399999999914,98422.58410332401,36210.798577433176
"244.3.79.141",2269,"244.3.160.239",80,10,1995,5,1490,5,505,53.699245,0.22372299999999967,53280.17235599388,18058.044993138865
"244.3.79.141",2539,"244.3.160.239",80,10,1952,5,1433,5,519,53.699371,0.14026299999999736,81732.17455779653,29601.5342606395
"244.3.79.141",4581,"244.3.160.239",80,12,2297,6,1282,6,1015,53.699702,0.3630950000000013,28246.051308886006,22363.29335297917
"244.3.79.141",11271,"244.3.160.239",80,135,94045,47,4315,88,89730,65.03956,0.7449680000000001,46337.56080798101,963585.0130475402
"244.3.79.141",5342,"244.3.160.239",80,10,2614,5,1379,5,1235,65.770099,0.09511600000000442,115984.69237562016,103873.16539803546
"244.3.79.141",7074,"244.3.160.239",80,13,4819,6,1715,7,3104,65.920682,0.2372220000000027,57836.11975280473,104678.3181998285
"244.3.79.141",6833,"244.3.160.239",80,10,2181,5,1662,5,519,65.995836,0.2273580000000095,58480.45813210639,18261.948117065713
"244.3.79.141",2731,"244.3.160.239",80,25,13328,10,1780,15,11548,66.22582,0.163337999999996,87181.18257845909,565600.1665258682
"244.3.79.141",13073,"244.3.160.239",80,12,2182,6,1497,6,685,66.292891,0.26390100000000416,45380.654108926494,20765.36276861366
"244.3.79.141",8931,"244.3.160.239",80,10,1978,5,1446,5,532,66.293063,0.15945899999999824,72545.29377457609,26690.2463956255
"244.3.79.141",13004,"244.3.160.239",80,10,1995,5,1490,5,505,66.293348,0.1954990000000123,60972.17888582167,20665.067340496604
"244.3.79.141",16160,"244.3.160.239",80,10,1952,5,1433,5,519,66.293528,0.15973200000000531,71770.21511030738,25993.539178122493
"244.3.79.141",3318,"244.3.160.239",80,12,2297,6,1282,6,1015,66.293755,0.26479899999999645,38731.264090877,30664.768371482176
"244.3.79.141",2627,"41.177.98.176",80,38,25276,16,1949,22,23327,81.945524,23.621917999999994,660.0649447686679,7900.120557526279
"244.3.79.141",2176,"244.3.160.239",80,72,47555,26,2894,46,44661,134.852111,0.7079319999999996,32703.70600566158,504692.5410915176
"244.3.79.141",7136,"244.3.160.239",80,12,2776,6,1447,6,1329,135.804109,0.3229350000000011,35846.222924117734,32923.03404709915
"244.3.79.141",9263,"244.3.160.239",80,12,2777,6,1448,6,1329,135.823951,0.412982999999997,28049.580733347582,25744.40110125617
"244.3.79.141",11673,"244.3.160.239",80,12,2777,6,1448,6,1329,135.824169,0.5227429999999913,22160.028924347516,20338.866326283045
"244.3.79.141",9005,"244.3.160.239",80,140,95301,49,4454,91,90847,139.060018,4.625051999999982,7704.129596813211,157138.99000486973
"244.3.79.141",6679,"244.3.160.239",80,10,2628,5,1393,5,1235,143.612533,0.13783099999997717,80852.63837599558,71681.98736134569
"244.3.79.141",11161,"244.3.160.239",80,13,4715,6,1729,7,2986,143.768103,0.16537199999999075,83641.72895049206,144450.0882858122
"244.3.79.141",9722,"244.3.160.239",80,13,3597,6,1492,7,2105,143.805895,0.45106400000000235,26461.8768068388,37333.94817586842
"244.3.79.141",13056,"244.3.160.239",80,10,2195,5,1676,5,519,143.848888,0.5069830000000195,26446.646140007622,8189.623715193291
"244.3.79.141",15112,"244.3.160.239",80,29,16821,11,1858,18,14963,144.10363,0.11927099999999768,124623.75598427354,1003630.3879400888
"244.3.79.141",6579,"244.3.160.239",80,12,2196,6,1511,6,685,144.121098,1.2558130000000176,9625.636937983467,4363.707016888599
"244.3.79.141",12379,"244.3.160.239",80,10,1992,5,1460,5,532,144.172004,0.08752400000000193,133449.11110095223,48626.66240116889
"244.3.79.141",13042,"244.3.160.239",80,10,2009,5,1504,5,505,144.172205,1.0424399999999991,11542.151107018159,3875.522811864475
"244.3.79.141",7133,"244.3.160.239",80,10,1966,5,1447,5,519,144.172478,0.08776100000000042,131903.6929843546,47310.308679253656
"244.3.79.141",8608,"244.3.160.239",80,12,2311,6,1296,6,1015,144.172707,0.304427000000004,34057.42591819997,26673.061193651985
"244.3.79.141",2652,"41.177.98.176",80,38,25368,16,2006,22,23362,166.737818,28.863227999999992,556.0015671150851,6475.228619612472
"244.3.79.141",5735,"244.3.160.239",80,64,41358,24,2776,40,38582,199.073402,0.5460980000000006,40666.69352387296,565202.5826866233
"244.3.79.161",15807,"244.3.160.239",80,82,59691,29,3795,53,55896,38.400173,0.0757899999999978,400580.5515239594,5900092.36046989
"244.3.79.161",6765,"244.3.160.239",80,12,2415,6,1885,6,530,38.415524,0.008903000000003658,1693811.0749178708,476243.9627090035
"244.3.79.161",15875,"244.3.160.239",80,12,2425,6,1895,6,530,38.425067,0.0075360000000017635,2011677.2823774486,562632.6963905265
"244.3.79.161",12552,"244.3.160.239",80,12,2413,6,1883,6,530,38.432855,0.00748999999999711,2011214.9532718041,566088.1174902051
"244.3.79.161",12132,"244.3.160.239",80,12,2417,6,1887,6,530,38.440456,0.006922000000002981,2180872.5801782,612539.728401932
"244.3.79.161",9214,"244.3.160.239",80,12,2415,6,1885,6,530,38.447632,0.008071999999998525,1868186.3230925119,525272.5470764092
"244.3.79.161",12425,"244.3.160.239",80,12,2432,6,1902,6,530,38.472622,0.007162999999998476,2124249.616083099,591930.7552702641
"244.3.79.161",10073,"244.3.160.239",80,12,2421,6,1891,6,530,38.481545,0.00674200000000269,2243844.5565105258,628893.5034111997
"244.3.79.161",2532,"244.3.160.239",80,10,1948,5,1531,5,417,38.489708,0.01436999999999955,852331.2456506878,232150.3131524081
"244.3.79.161",14759,"244.3.160.239",80,12,2422,6,1892,6,530,38.505082,0.007004999999999484,2160742.3269095095,605281.9414704229
"244.3.79.161",7075,"244.3.160.239",80,12,2421,6,1891,6,530,38.514157,0.006885000000004027,2197240.3776312494,615831.5177919419
"244.3.79.161",11767,"244.3.160.239",80,12,2425,6,1895,6,530,38.522413,0.008459999999999468,1791962.174941011,501182.03309695824
"244.3.79.161",15134,"244.3.160.239",80,12,2418,6,1888,6,530,38.522875,0.00799400000000361,1889417.0627962446,530397.798348522
"244.3.79.161",13116,"244.3.160.239",80,12,2428,6,1898,6,530,38.531196,0.009219000000001643,1647033.3007915495,459919.7309902641
"244.3.79.161",9071,"244.3.160.239",80,12,2429,6,1899,6,530,38.5312,0.009015000000005102,1685191.34775279,470327.23239019414
"244.3.79.161",7591,"244.3.160.239",80,12,2424,6,1894,6,530,38.540501,0.031041999999999348,488112.879324796,136589.13729785738
"244.3.79.161",14017,"244.3.160.239",80,12,2417,6,1887,6,530,38.54072,0.030844999999999345,489414.81601557205,137461.50105365828
"244.3.79.161",5780,"244.3.160.239",80,12,2419,6,1889,6,530,38.571808,0.008057000000000869,1875636.0928383232,526250.4654337275
"244.3.79.161",7027,"244.3.160.239",80,12,2415,6,1885,6,530,38.571925,0.008094999999997299,1862878.3199512083,523780.1111799154
"244.3.79.161",8194,"244.3.160.239",80,12,2426,6,1896,6,530,38.58018,0.008928000000004488,1698924.7311819417,474910.39426499425
"244.3.79.161",4275,"244.3.160.239",80,12,2421,6,1891,6,530,38.580302,0.009566999999996995,1581268.945333412,443190.1327481271
"244.3.79.161",7690,"244.3.160.239",80,12,2427,6,1897,6,530,38.58929,0.007183000000004824,2112766.253653043,590282.6117217252
"244.3.79.161",2232,"244.3.160.239",80,12,2428,6,1898,6,530,38.590124,0.007255999999998153,2092613.0099233552,584343.9911798621
"244.3.79.161",12249,"244.3.160.239",80,12,2420,6,1890,6,530,38.596679,0.007708999999998412,1961343.8837726184,550006.4859256549
"244.3.79.161",11476,"244.3.160.239",80,12,2428,6,1898,6,530,38.597573,0.008380999999999972,1811716.978880808,505906.21644195373
"244.3.79.161",10113,"244.3.160.239",80,12,2419,6,1889,6,530,38.604551,0.010044000000000608,1504579.848665779,422142.57268018153
"244.3.79.161",4337,"244.3.160.239",80,12,2428,6,1898,6,530,38.605944,0.008656000000001995,1754158.9648794478,489833.641404693
"244.3.79.161",11181,"244.3.160.239",80,12,2418,6,1888,6,530,38.615062,0.008580999999999506,1760167.8126093545,494114.9050227531
"244.3.79.161",3481,"244.3.160.239",80,12,2428,6,1898,6,530,38.615067,0.008598999999996693,1765786.7193866542,493080.59076655784
"244.3.79.161",7730,"244.3.160.239",80,12,2419,6,1889,6,530,38.623967,0.007311999999998875,2066739.6061272325,579868.7089716428
"244.3.79.161",5487,"244.3.160.239",80,12,2427,6,1897,6,530,38.624049,0.009337999999999624,1625187.406296917,454058.6849432609
"244.3.79.161",15360,"244.3.160.239",80,12,2988,6,1851,6,1137,39.254198,0.008347000000000548,1774050.5570862617,1089732.83814537
"244.3.79.161",5291,"244.3.160.239",80,12,2431,6,1901,6,530,39.263081,0.006937000000000637,2192302.1479023504,611215.2227186983
"244.3.79.161",7549,"244.3.160.239",80,23,11439,9,2348,14,9091,42.775213,0.06072999999999951,309303.47439486504,1197562.9836983467
"244.3.79.161",3150,"244.3.160.239",80,12,2423,6,1893,6,530,42.821701,0.007519999999999527,2013829.7872341692,563829.787234078
"244.3.79.161",14886,"244.3.160.239",80,12,2423,6,1893,6,530,42.829475,0.0072149999999950865,2098960.4989619283,587664.5876649879
"244.3.79.161",2385,"244.3.160.239",80,12,2422,6,1892,6,530,42.856468,0.00683000000000078,2216105.417276467,620790.6295753317
"244.3.79.161",15143,"244.3.160.239",80,37,21820,14,2352,23,19468,42.867657,0.018290999999997837,1028702.6406430608,8514788.693894178
"244.3.79.161",5471,"244.3.160.239",80,12,2420,6,1890,6,530,42.891247,0.006855999999999085,2205367.561260504,618436.4060677604
"244.3.79.161",12330,"244.3.160.239",80,12,2434,6,1904,6,530,42.899164999999996,0.015318000000000609,994385.6900378244,276798.5376680919
"244.3.79.161",4207,"244.3.160.239",80,12,2423,6,1893,6,530,42.899816,0.014670999999999879,1032240.4744052979,289005.5210960422
"244.3.79.161",9257,"244.3.160.239",80,12,2430,6,1900,6,530,42.914929,0.01595400000000069,952739.1249842887,265764.07170614373
"244.3.79.161",7170,"244.3.160.239",80,12,2430,6,1900,6,530,42.914933,0.016161000000003867,940535.8579293585,262360.0024750316
"244.3.79.161",14663,"244.3.160.239",80,12,2439,6,1909,6,530,42.931169,0.007343000000005873,2079803.8948641953,577420.6727490956
"244.3.79.161",13749,"244.3.160.239",80,21,10063,9,2377,12,7686,47.71302,0.03307000000000215,575022.6791653692,1859328.6967038403
"244.3.79.161",5901,"244.3.160.239",80,14,3068,7,1930,7,1138,47.782758,0.09464299999999781,163139.3763933979,96193.06235009679
"244.3.79.161",2797,"244.3.160.239",80,7,2450,4,1608,3,842,115.843778,0.05889299999999764,218430.03412970158,114376.9208564731
"244.3.79.161",9175,"244.3.160.239",80,15,5036,7,2775,8,2261,116.127658,0.3759990000000073,59042.71021997284,48106.51092157067
"244.3.79.161",7330,"244.3.160.239",80,12,2694,6,1636,6,1058,116.558386,0.259169,50499.86688222743,32658.22687126933
"244.3.79.161",13325,"244.3.160.239",80,7,2359,4,1519,3,840,119.484725,0.05784200000000794,210089.5543030727,116178.55537497108
"244.3.79.161",7013,"244.3.160.239",80,15,5074,7,2794,8,2280,119.77176,0.36985500000000116,60434.49459923465,49316.62408241052
"244.3.79.161",14282,"244.3.160.239",80,12,2694,6,1636,6,1058,120.194442,0.06316100000000802,207216.47852311298,134006.74466837014
"244.3.79.161",13240,"244.3.160.239",80,7,2357,4,1518,3,839,120.636438,0.058301999999997633,208294.7411752683,115124.69555075765
"244.3.79.161",9123,"244.3.160.239",80,15,4423,7,2483,8,1940,120.890507,0.43363100000000543,45808.533061519476,35790.79908954804
"244.3.79.161",10641,"244.3.160.239",80,7,452,4,258,3,194,121.06037,0.002230999999994765,0,0
"244.3.79.161",9016,"244.3.160.239",80,7,452,4,258,3,194,121.07003,0.00223199999999224,0,0
"244.3.79.161",8157,"244.3.160.239",80,7,452,4,258,3,194,121.100435,0.002696999999997729,0,0
"244.3.79.161",14136,"244.3.160.239",80,7,452,4,258,3,194,121.138516,0.002212999999997578,0,0
"244.3.79.161",2838,"244.3.160.239",80,7,452,4,258,3,194,121.151663,0.0021969999999953416,0,0
"244.3.79.161",7938,"244.3.160.239",80,12,2723,6,1665,6,1058,121.374781,0.26276199999999506,50692.26143810844,32211.659220131372
"244.3.79.161",2191,"244.3.160.239",80,7,2388,4,1548,3,840,121.884996,0.05902100000000132,209823.62210060356,113857.77943443604
"244.3.79.161",5796,"244.3.160.239",80,15,4974,7,2744,8,2230,122.179437,0.4048750000000041,54219.20345785681,44062.982401975474
"244.3.79.161",5742,"244.3.160.239",80,12,2694,6,1636,6,1058,122.636791,0.16067199999999104,81457.87691695336,52678.74925313976
"244.3.79.161",12241,"244.3.160.239",80,7,2357,4,1518,3,839,123.116126,0.05791700000000333,209679.36875182248,115889.98048931427
"244.3.79.161",12448,"244.3.160.239",80,15,4395,7,2470,8,1925,123.363879,0.15869100000000458,124518.71876791645,97043.9407401778
"244.3.79.161",14642,"244.3.160.239",80,12,2730,6,1672,6,1058,123.668667,0.20879000000000758,64064.37089898709,40538.339958808814
"244.3.79.161",7923,"244.3.160.239",80,13,3751,6,1784,7,1967,125.084097,0.536241000000004,26614.89889806989,29345.014648264278
"244.3.79.161",14346,"244.3.160.239",80,7,2395,4,1555,3,840,125.625308,0.05877999999999872,211636.61109221284,114324.60020415355
"244.3.79.161",10975,"244.3.160.239",80,12,2733,6,1819,6,914,126.639133,0.014999000000003093,970198.01320068,487499.1666110069
"244.3.79.161",7341,"244.3.160.239",80,12,2870,6,1848,6,1022,126.899027,0.010104999999995812,1463038.099951126,809104.40376085
"244.3.79.161",5931,"244.3.160.239",80,84,55432,29,3303,55,52129,126.909623,0.3931490000000082,67211.1591279628,1060747.960696813
"244.3.79.161",6311,"244.3.160.239",80,10,2028,5,1611,5,417,127.170718,0.05590100000000575,230550.43738034513,59676.928856364946
"244.3.79.161",13950,"244.3.160.239",80,10,2005,5,1588,5,417,127.229585,0.05529799999999341,229737.0610148923,60327.679120409375
"244.3.79.161",9412,"244.3.160.239",80,10,2017,5,1600,5,417,127.297586,0.05789000000000044,221108.99982725692,57626.533079978835
"244.3.79.161",7296,"244.3.160.239",80,10,2012,5,1595,5,417,127.302997,0.05511500000000069,231515.92125555367,60527.98693640494
"244.3.79.161",15835,"244.3.160.239",80,10,2014,5,1597,5,417,127.35583,0.05502599999999802,232181.15072875476,60625.88594482826
"244.3.79.161",12633,"244.3.160.239",80,16,7484,6,1620,10,5864,127.421288,0.0856330000000014,151343.52410869393,547826.1885020871
"244.3.79.161",11190,"244.3.160.239",80,10,1996,5,1579,5,417,127.510076,0.05622499999999775,224668.7416629703,59333.036905293615
"244.3.79.161",10446,"244.3.160.239",80,33,19910,12,2046,21,17864,127.571828,0.11870600000000309,137886.88019139366,1203915.556079695
"244.3.79.161",10411,"244.3.160.239",80,12,3949,6,1620,6,2329,127.572338,0.06255199999999661,207187.6199002542,297864.1770047482
"244.3.79.161",12176,"244.3.160.239",80,39,24037,14,2142,25,21895,127.635446,0.1363719999999944,125656.29308069622,1284427.8884228962
"244.3.79.161",9165,"244.3.160.239",80,13,3644,6,1610,7,2034,127.778028,0.1900579999999934,67768.78637047873,85615.96986183463
"244.3.79.161",15346,"244.3.160.239",80,12,2303,6,1610,6,693,127.782003,0.1863349999999997,69122.81643276905,29752.86446453972
"244.3.79.161",11945,"244.3.160.239",80,12,3554,6,1617,6,1937,127.790938,0.015973000000002457,809866.6499717028,970137.1063668451
"244.3.79.161",2778,"244.3.160.239",80,10,2012,5,1595,5,417,127.968553,0.05548599999998771,229967.91983568514,60123.274339486336
"244.3.79.161",7272,"244.3.160.239",80,11,2328,5,1546,6,782,127.968558,0.12302099999999427,100535.68090001363,50853.106380213874
"244.3.79.161",2809,"244.3.160.239",80,12,4378,5,1546,7,2832,128.024324,0.06727499999999509,183842.43775549464,336767.0011148518
"244.3.79.161",10522,"244.3.160.239",80,38,25209,12,1994,26,23215,128.093187,0.13269900000000234,120211.90815303595,1399558.3990836157
"244.3.79.161",12406,"244.3.160.239",80,13,5993,5,1546,8,4447,128.093295,0.06254999999998745,197729.816147122,568760.9912071485
"244.3.79.161",11068,"244.3.160.239",80,14,5151,6,1616,8,3535,128.155981,0.07006300000000465,184519.64660375865,403636.72694572207
"244.3.79.161",3612,"244.3.160.239",80,12,2295,6,1610,6,685,128.22796,0.18725700000001666,68782.47542147346,29264.593579943674
"244.3.79.161",13904,"244.3.160.239",80,10,2012,5,1595,5,417,128.227965,0.05628600000000006,226699.35685605634,59268.734676473665
"244.3.79.161",3958,"244.3.160.239",80,77,52181,26,2955,51,49226,128.284476,0.18054899999998497,130933.98468007005,2181169.6547753396
"244.3.79.161",15484,"244.3.160.239",80,12,2472,6,1610,6,862,128.415503,0.21297799999999256,60475.729887596135,32378.931157209856
"244.3.79.161",15125,"244.3.160.239",80,12,4883,5,1546,7,3337,128.465404,0.16320400000000745,75782.45631234182,163574.42219552695
"244.3.79.161",2189,"244.3.160.239",80,15,4395,7,2470,8,1925,128.628612,0.2188289999999995,90298.81779837246,70374.58472140363
"244.3.79.161",14106,"244.3.160.239",80,12,2627,6,1610,6,1017,128.629959,0.21929799999998068,58732.86578081485,37100.20155222901
"244.3.79.161",12577,"244.3.160.239",80,10,2023,5,1606,5,417,128.84769,0.055241999999992686,232576.66268422036,60388.83458239096
"244.3.79.161",4292,"244.3.160.239",80,10,2024,5,1607,5,417,128.849636,0.05521899999999391,232818.4139517452,60413.98793894072
"244.3.79.161",8061,"244.3.160.239",80,10,2026,5,1609,5,417,128.903148,0.055883000000022776,230338.38555544178,59696.150886649615
"244.3.79.161",14658,"244.3.160.239",80,12,2732,6,1673,6,1059,129.105544,0.08221499999999082,162792.67773522463,103046.8892537973
"244.3.79.161",9378,"244.3.160.239",80,83,59608,30,3712,53,55896,132.511844,0.07190199999999436,413006.59230622696,6219131.595783637
"244.3.79.161",7822,"244.3.160.239",80,12,2988,6,1851,6,1137,132.818029,0.007912000000004582,1871587.4620818282,1149646.107178303
"244.3.79.161",12710,"244.3.160.239",80,14,4727,6,1879,8,2848,137.85238,0.29410899999999174,51110.302642899136,77467.87755560232
"244.3.79.161",6024,"244.3.160.239",80,10,2130,5,1572,5,558,138.147386,0.010739000000000942,1171058.7577985749,415681.1621193415
"244.3.79.161",10643,"244.3.160.239",80,13,3906,6,1977,7,1929,138.173365,0.27427800000000957,57664.12180342371,56264.0824273163
"244.3.79.161",11566,"244.3.160.239",443,20,5971,9,2257,11,3714,138.4489,0.1083759999999927,166605.15243228406,274156.63984647894
"244.3.79.161",5564,"244.3.160.239",80,12,3199,6,1947,6,1252,138.524194,0.05552299999999377,280532.39198173274,180393.7107144989
"244.3.79.161",9178,"244.3.160.239",80,36,20855,14,2400,22,18455,138.580023,0.16183699999999135,118637.8887399113,912275.9319562763
"244.3.79.161",7751,"244.3.160.239",80,12,2523,6,1993,6,530,138.748369,0.0075270000000102755,2118240.999067123,563305.433770986
"244.3.79.161",6437,"244.3.160.239",80,15,8664,8,4136,7,4528,138.75698,0.013262999999994918,2494759.858253237,2731207.117546097
"244.3.79.161",3271,"244.3.160.239",80,11,4334,6,1971,5,2363,138.800669,0.01151899999999273,1368868.8254197373,1641114.680094794
"244.3.79.161",14969,"244.3.160.239",80,10,2193,5,1637,5,556,138.81677,0.011442000000016606,1144555.1476997896,388743.2267080532
"244.3.79.161",8469,"244.3.160.239",80,12,2527,6,1997,6,530,138.833393,0.01459800000000655,1094396.4926697377,290450.74667749676
"244.3.79.161",14532,"244.3.160.239",80,12,2534,6,2004,6,530,138.834143,0.014022999999980357,1143264.6366699322,302360.4079017285
"244.3.79.161",9926,"244.3.160.239",80,29,16498,11,2355,18,14143,138.836183,0.1032600000000059,182452.06275420223,1095719.5429013513
"244.3.79.161",11080,"244.3.160.239",80,24,12425,10,2291,14,10134,138.837748,0.5646969999999953,32456.343844575324,143567.2581933332
"244.3.79.161",5274,"244.3.160.239",80,12,2526,6,1996,6,530,138.853766,0.010156999999992422,1572117.751305692,417446.09628858557
"244.3.79.161",13049,"244.3.160.239",80,12,2533,6,2003,6,530,138.854633,0.015079999999983329,1062599.469497196,281167.10875362647
"244.3.79.161",16037,"244.3.160.239",80,10,2204,5,1646,5,558,138.939761,0.01842800000000011,714564.7927067463,242240.06945951667
"244.3.79.161",8186,"244.3.160.239",80,10,2206,5,1648,5,558,138.958443,0.009593000000023721,1374335.452931033,465339.3099123279
"244.3.79.161",16245,"244.3.160.239",80,11,4312,6,1949,5,2363,138.970473,0.012100000000003774,1288595.041321912,1562314.0495862896
"244.3.79.161",10846,"244.3.160.239",80,12,3905,6,1636,6,2269,138.984247,0.02008299999999963,651695.4638251378,903849.0265398762
"244.3.79.161",14760,"244.3.160.239",80,11,4312,6,1949,5,2363,139.471481,0.011780999999984942,1323486.9705474856,1604617.6046196555
"244.3.79.161",4923,"244.3.160.239",80,22,10831,9,2246,13,8585,142.217868,0.41083799999998405,43735.00017038516,167170.51489882305
"244.3.79.161",14351,"244.3.160.239",80,15,8661,8,4133,7,4528,142.69991,0.013515000000012378,2446466.888640009,2680281.1690689474
"244.3.79.161",15425,"244.3.160.239",80,80,54701,29,3555,51,51146,147.031642,0.21695299999998952,131088.30023093193,1885975.3034068197
"244.3.79.161",14803,"244.3.160.239",80,15,8690,8,4162,7,4528,147.235286,0.031141999999988457,1069167.041295111,1163187.977651192
"244.3.79.161",2604,"244.3.160.239",80,11,4360,6,1997,5,2363,147.296242,0.011322000000006938,1411058.1169396052,1669669.6696686465
"244.3.79.161",7374,"244.3.160.239",80,10,2226,5,1670,5,556,147.312147,0.01597699999999236,836202.0404335225,278400.200288047
"244.3.79.161",11888,"244.3.160.239",80,10,2221,5,1665,5,556,147.330684,0.007087000000012722,1879497.6717900506,627628.0513605215
"244.3.79.161",12225,"244.3.160.239",80,10,2231,5,1673,5,558,147.33948,0.006479999999982056,2065432.0987711516,688888.8888907966
"244.3.79.161",9697,"244.3.160.239",80,10,2235,5,1677,5,558,147.340116,0.012157999999999447,1103470.9656193955,367165.6522454518
"244.3.79.161",10288,"244.3.160.239",80,10,2248,5,1690,5,558,147.346156,0.0211879999999951,638097.0360582937,210685.29356244253
"244.3.79.161",9109,"244.3.160.239",80,10,2227,5,1669,5,558,147.352153,0.015431000000006634,865271.2073095884,289287.79729104275
"244.3.79.161",8551,"244.3.160.239",80,10,2235,5,1677,5,558,147.367669,0.006720999999998867,1996131.5280467581,664186.8769529464
"244.3.79.161",6242,"244.3.160.239",80,10,2231,5,1673,5,558,147.36787,0.0156859999999881,853244.9317869537,284584.98023737007
"244.3.79.161",6454,"244.3.160.239",80,10,2238,5,1680,5,558,147.374597,0.014330000000001064,937892.5331471739,311514.3056524542
"244.3.79.161",9980,"244.3.160.239",80,10,2235,5,1677,5,558,147.383405,0.011172999999985223,1200751.812406493,399534.5923213017
"244.3.79.161",6451,"244.3.160.239",80,10,2239,5,1681,5,558,147.389096,0.008612999999996873,1561360.7337750937,518286.31138994783
"244.3.79.161",9305,"244.3.160.239",80,10,2234,5,1676,5,558,147.394667,0.008420999999998457,1592209.9513124872,530103.3131458042
"244.3.79.161",15978,"244.3.160.239",80,10,2227,5,1669,5,558,147.397832,0.010131000000001222,1317935.0508339147,440627.77613260894
"244.3.79.161",9885,"244.3.160.239",80,10,2235,5,1677,5,558,147.403332,0.010382999999990261,1292112.106328863,429933.54521854833
"244.3.79.161",4780,"244.3.160.239",80,10,2234,5,1676,5,558,147.408196,0.009323999999992338,1438009.4380106197,478764.4787648722
"244.3.79.161",6525,"244.3.160.239",80,10,2239,5,1681,5,558,147.46424,0.01345600000001923,999405.4696775253,331747.91914340225
"244.3.79.161",15234,"244.3.160.239",80,11,3586,5,1687,6,1899,196.813628,0.04452100000000314,303137.8450618595,341232.2274881276
"244.3.79.161",6235,"244.3.160.239",80,12,2727,6,1817,6,910,197.87296,0.01332099999999059,1091209.368666787,546505.5176041696
"244.3.79.161",6152,"244.3.160.239",80,12,2888,6,1854,6,1034,198.170241,0.00956899999999905,1550005.2252065495,864458.1460968566
"244.3.79.161",2861,"244.3.160.239",80,12,2795,6,1837,6,958,198.183238,0.09743100000000027,150834.94986195318,78660.79584526464
"244.3.79.161",12865,"244.3.160.239",80,12,2879,6,1840,6,1039,198.284276,0.8801229999999975,16724.935037489126,9444.134513016957
"244.3.79.161",4957,"244.3.160.239",80,70,45043,24,3037,46,42006,199.164731,0.2940240000000074,82632.7102549431,1142927.1079911557
"244.3.79.161",7859,"244.3.160.239",80,177,122448,58,4978,119,117470,199.291311,0.3725210000000061,106904.04030913519,2522703.418062296
"244.3.79.161",2153,"244.3.160.239",80,15,6951,6,1643,9,5308,199.291536,0.12279699999999139,107038.44556463856,345806.4936440058
"244.3.79.161",7186,"244.3.160.239",80,11,3704,5,1586,6,2118,199.414387,0.08565199999998185,148134.3109326424,197823.75192644176
"244.3.79.161",10931,"244.3.160.239",80,136,94412,45,4151,91,90261,199.500559,0.32817399999999,101190.22226014557,2200320.5616533365
"244.3.79.161",6471,"244.3.160.239",80,33,19287,12,2032,21,17255,199.664416,0.1740620000000206,93392.00974364352,793050.7520307917
"244.3.79.161",6478,"244.3.160.239",80,193,136844,61,5184,132,131660,199.844377,0.39712299999999345,104431.1208366191,2652276.498717066
"244.3.79.161",10695,"244.3.160.239",80,20,10222,8,1783,12,8439,200.31999,0.12499400000001515,114117.47763891284,540121.9258523755
"244.3.79.161",3369,"244.3.160.239",80,11,3492,5,1591,6,1901,200.449153,0.09090700000001561,140011.2202580419,167291.84771246865
"244.3.79.161",6466,"244.3.160.239",80,47,29041,16,2305,31,26736,200.542813,0.20674600000000964,89191.5683979334,1034544.8037688276
"244.3.79.161",12325,"244.3.160.239",80,17,8360,7,1722,10,6638,200.759568,0.12454199999999105,110613.28708388328,426394.30874728056
"244.3.79.161",9455,"244.3.160.239",80,12,2315,6,1641,6,674,200.888214,0.19546399999998698,67163.26280031553,27585.642368929108
"244.3.79.161",3449,"244.3.160.239",80,12,2316,6,1659,6,657,200.889288,0.19481300000001056,68126.87038338961,26979.7190125901
"244.3.79.161",12550,"244.3.160.239",80,15,5471,7,1994,8,3477,200.889658,0.1369359999999915,116492.3760004746,203131.38984636418
"244.3.79.161",14215,"244.3.160.239",80,16,7893,7,1713,9,6180,201.027379,0.26903899999999226,50936.85302131064,183765.17902609444
"244.3.79.161",2187,"244.3.160.239",80,12,3324,6,1656,6,1668,201.028531,0.26820200000000227,49395.60480533288,49753.54397058891
"244.3.79.161",6440,"244.3.160.239",80,12,2854,6,1651,6,1203,201.188801,0.21774099999998953,60659.223572963456,44199.30100440644
"244.3.79.161",15061,"244.3.160.239",80,12,2820,6,1647,6,1173,201.190053,0.21684600000000387,60762.01543952743,43274.95088680369
"244.3.79.161",12652,"244.3.160.239",80,12,2322,6,1648,6,674,201.299123,0.21730099999999197,60671.60298388174,24813.507531029307
"244.3.79.161",5409,"244.3.160.239",80,12,2828,6,1655,6,1173,201.299347,0.21759799999998108,60846.14748297848,43125.39637313218
"244.3.79.161",6301,"244.3.160.239",80,12,2365,6,1647,6,718,201.407612,0.21878799999998932,60222.681317077004,26253.72506718961
"244.3.79.161",13710,"244.3.160.239",80,12,3090,6,1651,6,1439,201.409106,0.2177769999999839,60649.19619611335,52861.413280561545
"244.3.79.161",5779,"244.3.160.239",80,12,2323,6,1649,6,674,201.517542,0.21906400000000303,60219.84442902447,24613.811488879623
"244.3.79.161",10026,"244.3.160.239",80,12,2846,6,1654,6,1192,201.51896,0.21781400000000417,60749.07948983879,43780.47324781611
"244.3.79.161",13457,"244.3.160.239",80,12,2321,6,1647,6,674,201.62766,0.1098350000000039,119961.7608230485,49091.81954750133
"244.3.79.161",12366,"244.3.160.239",80,11,3034,5,1586,6,1448,201.628651,0.10898600000001579,116418.62257535978,106288.88114068157
"244.3.79.161",3595,"244.3.160.239",80,12,2412,6,1648,6,764,201.737503,0.1586369999999988,83107.97607115678,38528.21220774502
"244.3.79.161",5454,"244.3.160.239",80,12,3248,6,1482,6,1766,201.853007,0.2633650000000216,45017.37132876057,53644.18202873898
"244.3.79.161",2048,"244.3.160.239",80,18,8078,10,6698,8,1380,211.492119,0.15712199999998688,341034.35546902707,70263.87138657171
"244.3.79.161",9751,"244.3.160.239",80,294,215962,88,7418,206,208544,211.64995,1.2146880000000237,48855.343923706205,1373481.9146974098
"244.3.79.161",4522,"244.3.160.239",80,41,25042,14,2306,27,22736,212.516553,0.36204500000002326,50954.99178278616,502390.5868054753
"244.3.79.161",16197,"244.3.160.239",80,34,19955,13,2235,21,17720,212.901456,0.17195200000000455,103982.50674606592,824416.1161254086
"244.3.79.176",1686,"41.177.98.167",1521,4573,802607,2302,265032,2271,537575,4.950563,206.59178,10263.022081517474,20816.897942406034
"244.3.79.176",1684,"41.177.98.167",1521,254,42679,128,15000,126,27679,37.577823,148.0829,810.356901438316,1495.3245783274099
"244.3.79.229",65209,"41.177.26.23",25,1,78,1,78,0,0,187.496714,0,0,0
"244.3.81.142",2935,"244.3.41.84",23,4,256,2,128,2,128,18.48542,0.14792599999999823,6922.380108973489,6922.380108973489
"244.3.84.219",2687,"41.177.98.176",80,36,24750,14,2085,22,22665,144.057017,23.035174000000012,724.1100067227619,7871.440432792038
"244.3.84.219",2689,"41.177.98.176",80,101,78522,37,7415,64,71107,167.09527,27.910156,2125.3912016830004,20381.684717204735
"244.3.90.94",4574,"244.3.41.84",23,93,29182,46,3215,47,25967,132.785034,79.40228300000001,323.9201573083232,2616.2471927916727
"244.3.90.209",2229,"41.177.98.197",1521,28,4308,14,2410,14,1898,27.205558,68.20336300000001,282.6840078252446,222.628318195981
"244.3.91.203",22391,"244.3.41.84",23,4,256,2,128,2,128,18.475594,0.5439599999999984,1882.4913596588037,1882.4913596588037
"244.3.92.253",24266,"244.3.41.84",23,23,8782,12,1100,11,7682,145.486671,31.499540999999994,279.3691501726962,1951.0125560242295
"244.3.93.198",4112,"41.177.241.108",3389,410,36317,206,13338,204,22979,0.636808,212.197039,502.85338807201737,866.3268859279418
"244.3.93.229",1487,"41.177.98.176",80,69,55454,23,3620,46,51834,21.659427,22.468825000000002,1288.8969494399462,18455.43770090336
"244.3.93.229",1488,"41.177.98.176",80,35,25255,14,1965,21,23290,44.12893,20.22263600000001,777.3467316525894,9213.437852513387
"244.3.93.229",1489,"41.177.98.176",80,53,40511,21,5129,32,35382,64.365382,22.855676000000003,1795.265211144925,12384.494774952182
"244.3.108.48",14773,"244.3.160.239",80,98,60959,38,3887,60,57072,85.98126,0.4077249999999992,76267.09178980945,1119813.5998528441
"244.3.108.48",4717,"244.3.160.239",80,303,204067,114,9710,189,194357,92.859013,1.2938529999999986,60037.73226170213,1201725.3892057303
"244.3.108.48",10301,"244.3.160.239",80,140,97353,50,4742,90,92611,110.36988,0.6244760000000014,60748.531568867205,1186415.4907474401
"244.3.108.48",15201,"244.3.160.239",80,96,60743,36,3671,60,57072,125.247063,0.2998320000000092,97948.1843165476,1522772.7527414886
"244.3.108.48",6454,"244.3.160.239",80,305,204080,115,9792,190,194288,133.204914,0.942104999999998,83149.96736032626,1649820.349111833
"244.3.108.48",10916,"244.3.160.239",80,288,201275,104,8986,184,192289,149.067398,0.7920689999999979,90759.76966653182,1942143.929379895
"244.3.108.48",15903,"244.3.160.239",80,281,193176,103,8432,178,184744,162.700995,1.158629999999988,58220.48453777366,1275603.08295143
"244.3.108.48",2073,"244.3.160.239",80,47,29644,18,2327,29,27317,188.815405,0.1805880000000002,103085.47633286807,1210135.7786785378
"244.3.108.48",4525,"244.3.160.239",80,86,59609,31,3231,55,56378,190.986477,0.2731780000000015,94619.62529925491,1651026.0709134615
"244.3.108.48",2608,"244.3.160.239",80,12,3456,6,1501,6,1955,194.739215,0.040434000000004744,296977.7909679624,386803.18543795234
"244.3.108.48",7987,"244.3.160.239",80,11,2262,6,1372,5,890,195.8442,0.013909000000012384,789129.3407139427,511898.77057974413
"244.3.108.48",7559,"244.3.160.239",80,11,2261,6,1355,5,906,196.263954,0.011453999999986308,946394.2727442777,632792.0377168382
"244.3.108.48",2381,"244.3.160.239",80,11,1843,6,1338,5,505,196.328463,0.09860699999998701,108552.13118745535,40970.7221596898
"244.3.108.48",11984,"244.3.160.239",80,11,1980,6,1342,5,638,196.480256,0.1375280000000032,78064.10330986962,37112.44255715113
"244.3.108.48",15427,"244.3.160.239",80,11,2098,6,1414,5,684,196.670911,0.10506600000002209,107665.65777699371,52081.548740780556
"244.3.108.48",7709,"244.3.160.239",80,11,2232,6,1421,5,811,196.829307,0.14130800000000932,80448.38225719174,45913.89022560345
"244.3.108.48",16324,"244.3.160.239",80,108,73089,39,3756,69,69333,197.023608,0.2715910000000008,110636.95041440957,2042276.8059324438
"244.3.108.48",4129,"244.3.160.239",80,11,1908,6,1353,5,555,197.403531,0.12575500000002648,86072.12436879425,35306.747246622916
"244.3.108.48",12129,"244.3.160.239",80,11,2038,6,1318,5,720,197.404086,0.13527299999998377,77946.0794097955,42580.55931339359
"244.3.108.48",4351,"244.3.160.239",80,15,4101,8,3276,7,825,203.547312,0.14420999999998685,181734.9698356729,45766.590389020195
"244.3.108.48",13244,"244.3.160.239",80,15,4131,8,3208,7,923,205.296178,0.8538959999999918,30055.18236412894,8647.423105389968
"244.3.108.48",5571,"244.3.160.239",80,146,99362,54,4854,92,94508,206.203529,0.7724460000000022,50271.47528759277,978792.0450102633
"244.3.108.48",8147,"244.3.160.239",80,11,1946,6,1357,5,589,206.632169,0.05520799999999326,196638.16838141799,85349.94928272307
"244.3.108.48",13605,"244.3.160.239",80,11,1947,6,1344,5,603,206.63242,0.05968000000001439,180160.85790880374,80831.09919569097
"244.3.108.48",7831,"244.3.160.239",80,11,1946,6,1357,5,589,206.6326,0.05784900000000448,187660.97944647545,81453.43912599415
"244.3.108.48",5601,"244.3.160.239",80,11,1952,6,1349,5,603,206.632832,0.05647500000000605,191093.4041611128,85418.32669321794
"244.3.108.48",8652,"244.3.160.239",80,11,1950,6,1347,5,603,206.633042,0.0588950000000068,182969.69182441218,81908.48119533819
"244.3.108.48",7097,"244.3.160.239",80,11,1953,6,1350,5,603,206.63327,0.059297999999984086,182130.9319033171,81351.81625014832
"244.3.108.48",6232,"244.3.160.239",80,11,1950,6,1347,5,603,206.761332,0.05334299999998393,202013.3850740162,90433.6089084126
"244.3.108.48",2451,"244.3.160.239",80,11,1950,6,1347,5,603,206.761886,0.05368899999999144,200711.50515006273,89850.80742797909
"244.3.108.48",5933,"244.3.160.239",80,11,1946,6,1343,5,603,206.762356,0.055456999999989876,193735.6871089666,86986.31372055612
"244.3.108.48",10508,"244.3.160.239",80,11,1947,6,1344,5,603,206.762514,0.05542399999998793,193995.3810623979,87038.10623558478
"244.3.108.48",11348,"244.3.160.239",80,11,1945,6,1355,5,590,206.971707,0.05461800000000494,198469.369072449,86418.3968654944
"244.3.108.48",6028,"244.3.160.239",80,11,1935,6,1345,5,590,206.972439,0.056394999999980655,190797.05647670344,83695.36306413014
"244.3.108.48",2079,"244.3.160.239",80,11,1930,6,1340,5,590,206.972685,0.05654599999999732,189580.1648215702,83471.86361546748
"244.3.108.48",15016,"244.3.160.239",80,11,1931,6,1341,5,590,206.973054,0.05785800000001018,185419.47526700047,81579.03833522019
"244.3.108.48",13477,"244.3.160.239",80,11,1932,6,1342,5,590,206.973377,0.05703700000000822,188228.69365496875,82753.30048914424
"244.3.108.48",12655,"244.3.160.239",80,11,1941,6,1351,5,590,206.973656,0.05704499999998802,189464.45788416636,82741.6951529668
"244.3.108.48",15921,"244.3.160.239",80,11,1929,6,1339,5,590,207.121053,0.05350400000000377,200209.33014352655,88217.70334927608
"244.3.108.48",11217,"244.3.160.239",80,11,1931,6,1341,5,590,207.121697,0.054985999999985324,195104.20834399416,85840.03200817044
"244.3.108.48",15271,"244.3.160.239",80,11,1937,6,1347,5,590,207.121889,0.055191999999976815,195245.68778091983,85519.64052764862
"244.3.108.48",13490,"244.3.160.239",80,11,1934,6,1344,5,590,207.122419,0.057786999999990485,186062.60923740236,81679.2704241573
"244.3.108.48",3286,"244.3.160.239",80,11,1939,6,1349,5,590,207.122498,0.05690300000000548,189656.08140166532,82948.17496440515
"244.3.108.48",3235,"244.3.160.239",80,11,1936,6,1346,5,590,207.122685,0.05765600000000859,186762.86943246837,81864.85361452922
"244.3.108.48",10028,"244.3.160.239",80,13,2422,7,1632,6,790,207.128515,0.14499900000001276,90042.00028964925,43586.50749315129
"244.3.108.48",10325,"244.3.160.239",80,11,1934,6,1344,5,590,207.345998,0.0579089999999951,185670.6211469877,81507.19231899013
"244.3.108.48",16119,"244.3.160.239",80,11,1935,6,1345,5,590,207.346316,0.05727999999999156,187849.16201120085,82402.23463688364
"244.3.108.48",4243,"244.3.160.239",80,11,1941,6,1351,5,590,207.346585,0.053696000000002186,201281.28724671408,87902.26460071155
"244.3.108.48",11454,"244.3.160.239",80,11,1934,6,1344,5,590,207.346861,0.0584050000000218,184093.82758318615,80814.99871583321
"244.3.108.48",2983,"244.3.160.239",80,11,1941,6,1351,5,590,207.347441,0.057546000000002095,187814.96541896233,82021.339450176
"244.3.108.48",15124,"244.3.160.239",80,11,1942,6,1352,5,590,207.347745,0.0570199999999943,189687.82883200774,82777.97264118682
"244.3.108.48",11412,"244.3.160.239",80,11,1934,6,1343,5,591,207.462107,0.05471399999998994,196366.5606609273,86412.98387982727
"244.3.108.48",5772,"244.3.160.239",80,11,1933,6,1343,5,590,207.462612,0.05451499999998077,197083.37154918443,86581.6747684429
"244.3.108.48",4706,"244.3.160.239",80,11,1938,6,1348,5,590,207.463102,0.057798000000019556,186580.85054839877,81663.72538839412
"244.3.108.48",14650,"244.3.160.239",80,11,1932,6,1342,5,590,207.463293,0.05717400000000339,187777.66117464867,82555.00752089622
"244.3.108.48",14939,"244.3.160.239",80,11,1934,6,1344,5,590,207.463442,0.05781900000002338,185959.63264663264,81634.06492672117
"244.3.108.48",6118,"244.3.160.239",80,11,1933,6,1343,5,590,207.463919,0.05675500000000966,189304.9070566148,83164.47890052325
"244.3.108.48",13181,"244.3.160.239",80,11,1937,6,1347,5,590,207.575273,0.05505399999998417,195735.09645081373,85734.00661171498
"244.3.108.48",13683,"244.3.160.239",80,11,1930,6,1340,5,590,207.575522,0.05325899999999706,201280.53474531238,88623.51902965247
"244.3.108.48",6838,"244.3.160.239",80,14,2371,8,1486,6,885,207.575906,0.2605780000000095,45621.65647138118,27170.3674139787
"244.3.108.48",4171,"244.3.160.239",80,11,1932,6,1342,5,590,207.579884,0.055756999999999834,192549.81437308376,84653.04804777901
"244.3.108.48",12393,"244.3.160.239",80,14,2377,8,1487,6,890,207.580028,0.25651200000001495,46375.99800398931,27756.986027942494
"244.3.108.48",15689,"244.3.160.239",80,11,1937,6,1347,5,590,207.580207,0.05591699999999378,192714.20140567626,84410.82318437193
"244.3.108.48",5410,"244.3.160.239",80,11,1944,6,1354,5,590,207.689001,0.053603000000009615,202078.24188941024,88054.7730537312
"244.3.108.48",9478,"244.3.160.239",80,11,1934,6,1344,5,590,207.68993,0.05710500000000707,188284.73863932528,82654.75877767999
"244.3.108.48",13374,"244.3.160.239",80,11,1937,6,1347,5,590,207.690468,0.0564109999999971,191026.57283154977,83671.62432859269
"244.3.108.48",10746,"244.3.160.239",80,11,1936,6,1346,5,590,207.690472,0.05672899999999004,189814.7332052723,83202.59479280136
"244.3.108.48",15185,"244.3.160.239",80,11,1937,6,1347,5,590,207.797113,0.05636799999999198,191172.2963383752,83735.45273915469
"244.3.108.48",5395,"244.3.160.239",80,11,1934,6,1344,5,590,207.797426,0.05570199999999659,193027.1803526024,84736.6342321692
"244.3.108.48",5196,"244.3.160.239",80,11,1936,6,1346,5,590,207.79743,0.055868000000003804,192740.03007086823,84484.85716330777
"244.3.108.48",15133,"244.3.160.239",80,11,1934,6,1344,5,590,207.803244,0.05311499999999114,202428.69245979088,88863.78612446178
"244.3.108.48",6159,"244.3.160.239",80,11,1936,6,1346,5,590,207.805075,0.05328099999999836,202098.3089656788,88586.92592106276
"244.3.108.48",13764,"244.3.160.239",80,11,1936,6,1346,5,590,207.805894,0.054766999999998234,196614.74975807234,86183.28555517286
"244.3.108.48",11017,"244.3.160.239",80,11,1932,6,1342,5,590,207.917881,0.053934999999995625,199054.41735423883,87512.7468248889
"244.3.108.48",5025,"244.3.160.239",80,11,1938,6,1348,5,590,207.918303,0.05474099999997861,197000.42016046864,86224.21950643657
"244.3.108.48",10822,"244.3.160.239",80,11,1933,6,1343,5,590,207.9186,0.060202000000003864,178465.83169993208,78402.71087338788
"244.3.108.48",3360,"244.3.160.239",80,11,1937,6,1347,5,590,207.91896500000001,0.05561599999998634,193757.19217496127,84867.66398160887
"244.3.108.48",8531,"244.3.160.239",80,11,1938,6,1348,5,590,207.919096,0.059965000000005375,179838.23897271798,78712.5823396911
"244.3.108.48",6879,"244.3.160.239",80,11,1935,6,1345,5,590,207.919373,0.059180999999995265,181815.10957910243,79755.32687856538
"244.3.108.48",14141,"244.3.160.239",80,11,1934,6,1344,5,590,208.027056,0.05307900000002519,202565.98654825633,88924.05659484466
"244.3.108.48",14128,"244.3.160.239",80,11,1934,6,1344,5,590,208.031107,0.05277900000001523,203717.38759728108,89429.50794821118
"244.3.108.48",12417,"244.3.160.239",80,11,1881,6,1326,5,555,208.14463,0.15616399999998976,67928.58789478174,28431.648779490097
"244.3.110.215",1115,"244.3.41.84",23,4,256,2,128,2,128,18.477795,0.1450409999999991,7060.0726691074005,7060.0726691074005
"244.3.111.39",1450,"244.3.41.84",23,4,256,2,128,2,128,139.532127,0.17377199999998538,5892.7790438050215,5892.7790438050215
"244.3.139.251",58262,"244.3.31.244",443,22,4430,14,1809,8,2621,121.949037,0.010795000000001664,1340620.657711697,1942380.7318199878
"244.3.139.251",58263,"244.3.31.244",443,22,4244,14,1852,8,2392,121.960788,0.012097000000011349,1224766.4710247251,1581879.8049088244
"244.3.139.251",58264,"244.3.31.244",443,24,5264,15,2263,9,3001,121.977017,0.013339999999999463,1357121.4392804145,1799700.14992511
"244.3.139.251",58265,"244.3.31.244",443,22,4430,14,1809,8,2621,121.991524,0.01049199999999928,1379336.6374381427,1998475.0285933511
"244.3.139.251",58266,"244.3.31.244",443,22,4244,14,1852,8,2392,122.00302,0.012049999999987904,1229543.5684659646,1588049.7925327145
"244.3.139.251",58267,"244.3.31.244",443,24,5264,15,2263,9,3001,122.018623,0.013402999999996723,1350742.3711112756,1791240.7669929024
"244.3.139.251",58268,"244.3.31.244",443,24,4655,15,2034,9,2621,122.033098,0.010767000000001303,1511284.4803564623,1947431.968050289
"244.3.139.251",58269,"244.3.31.244",443,24,4678,15,2041,9,2637,122.044845,0.011097000000006574,1471388.663601904,1901054.3390094172
"244.3.139.251",58270,"244.3.31.244",443,24,4687,15,2087,9,2600,122.056968,0.012377999999998224,1348844.7245114231,1680400.7109390034
"244.3.139.251",58271,"244.3.31.244",443,22,4430,14,1809,8,2621,122.071158,0.010153000000002521,1425391.5098981983,2065202.4032300594
"244.3.139.251",58272,"244.3.31.244",443,22,4244,14,1852,8,2392,122.082348,0.012073000000000889,1227201.1927440495,1585024.4346888587
"244.3.139.251",58273,"244.3.31.244",443,24,5264,15,2263,9,3001,122.098979,0.013249999999999318,1366339.6226415797,1811924.52830198
"244.3.139.251",58274,"244.3.31.244",443,22,4430,14,1809,8,2621,122.113325,0.01127999999999929,1282978.723404336,1858865.2482270673
"244.3.139.251",58275,"244.3.31.244",443,22,4244,14,1852,8,2392,122.125567,0.012039000000001465,1230666.9989200262,1589500.7891018915
"244.3.139.251",58276,"244.3.31.244",443,22,4430,14,1809,8,2621,122.141301,0.0108589999999964,1332719.4032604105,1930932.8667471178
"244.3.139.251",58277,"244.3.31.244",443,22,4244,14,1852,8,2392,122.153111,0.012475000000009118,1187655.3106203745,1533947.8957904621
"244.3.139.251",58278,"244.3.31.244",443,22,4430,14,1809,8,2621,122.169369,0.020436000000003673,708162.0669405656,1026032.4916811623
"244.3.139.251",58279,"244.3.31.244",443,22,4244,14,1852,8,2392,122.190789,0.012304000000000315,1204161.2483744815,1555266.5799739524
"244.3.139.251",58280,"244.3.31.244",443,22,4430,14,1809,8,2621,122.20725,0.010580000000004475,1367863.894139308,1981852.551984039
"244.3.139.251",58281,"244.3.31.244",443,22,4244,14,1852,8,2392,122.218838,0.012082999999989852,1226185.5499472353,1583712.6541435134
"244.3.139.251",58282,"244.3.31.244",443,24,4506,15,2102,9,2404,122.234536,0.012969999999995707,1296530.4548963427,1482806.476484685
"244.3.139.251",58283,"244.3.31.244",443,24,5264,15,2263,9,3001,122.248534,0.012940999999997871,1398964.5313347483,1855188.934394865
"244.3.139.251",58284,"244.3.31.244",443,24,4898,15,2331,9,2567,122.262462,0.015741000000005556,1184676.9582614459,1304618.5121652214
"244.3.139.251",58285,"244.3.31.244",443,22,4390,14,1769,8,2621,172.383009,0.010530000000017026,1343969.6106341043,1991263.0579265049
"244.3.139.251",58286,"244.3.31.244",443,22,4204,14,1812,8,2392,172.394618,0.011438999999995758,1267243.640178807,1672873.502929198
"244.3.139.251",58287,"244.3.31.244",443,24,5144,15,2223,9,2921,172.40973,0.012283999999993966,1447736.893520737,1902311.950505656
"244.3.139.251",58288,"244.3.31.244",443,22,4390,14,1769,8,2621,172.42307,0.010449999999991633,1354258.373206826,2006507.1770350994
"244.3.139.251",58289,"244.3.31.244",443,22,4204,14,1812,8,2392,172.43451,0.011471999999997706,1263598.3263600853,1668061.36680647
"244.3.139.251",58290,"244.3.31.244",443,24,5144,15,2223,9,2921,172.450273,0.012249999999994543,1451755.1020414631,1907591.8367355436
"244.3.139.251",58291,"244.3.31.244",443,24,4655,15,2034,9,2621,172.463679,0.011180999999993446,1455325.9994642285,1875324.2107157044
"244.3.139.251",58292,"244.3.31.244",443,24,4678,15,2041,9,2637,172.47592,0.010980999999986807,1486931.9734104013,1921136.5085170153
"244.3.139.251",58293,"244.3.31.244",443,24,4607,15,2047,9,2560,172.488007,0.01183799999998314,1383341.7807081705,1730021.9631719182
"244.3.139.251",58294,"244.3.31.244",443,22,4390,14,1769,8,2621,172.501418,0.01040699999998651,1359853.944462222,2014797.7322981819
"244.3.139.251",58295,"244.3.31.244",443,22,4204,14,1812,8,2392,172.512786,0.011387999999982412,1272918.8619619238,1680365.2968062481
"244.3.139.251",58296,"244.3.31.244",443,24,5144,15,2223,9,2921,172.528798,0.012477000000018279,1425342.6304379215,1872886.1104404717
"244.3.139.251",58297,"244.3.31.244",443,22,4390,14,1769,8,2621,172.542602,0.010496000000017602,1348323.170729446,1997713.414630796
"244.3.139.251",58298,"244.3.31.244",443,22,4204,14,1812,8,2392,172.55409,0.011942000000004782,1213867.0239486012,1602411.6563383301
"244.3.139.251",58299,"244.3.31.244",443,22,4390,14,1769,8,2621,172.571208,0.010726999999974396,1319287.7785059924,1954693.7634054301
"244.3.139.251",58300,"244.3.31.244",443,22,4204,14,1812,8,2392,172.582958,0.011527999999998428,1257460.097154925,1659958.362248665
"244.3.139.251",58301,"244.3.31.244",443,22,4390,14,1769,8,2621,172.599638,0.010934999999989259,1294192.9583917605,1917512.5743045814
"244.3.139.251",58302,"244.3.31.244",443,22,4204,14,1812,8,2392,172.611614,0.011481000000003405,1262607.7867777806,1666753.7670929644
"244.3.139.251",58303,"244.3.31.244",443,22,4390,14,1769,8,2621,172.62788,0.010208000000005768,1386363.636362853,2054075.2351085572
"244.3.139.251",58304,"244.3.31.244",443,22,4204,14,1812,8,2392,172.639063,0.011466000000012855,1264259.5499724182,1668934.2403609408
"244.3.139.251",58305,"244.3.31.244",443,24,4466,15,2062,9,2404,172.65526,0.01249200000000883,1320525.1360861624,1539545.3089966704
"244.3.139.251",58306,"244.3.31.244",443,24,5144,15,2223,9,2921,172.668758,0.02690100000000939,661090.6657742758,868666.5923196849
"244.3.139.251",58307,"244.3.31.244",443,25,4935,16,2368,9,2567,172.696675,0.014217000000002145,1332489.2734048774,1444467.8905533447
"244.3.139.251",58308,"244.3.31.244",443,22,4430,14,1809,8,2621,172.712459,0.010615000000001373,1363353.7447007187,1975317.9463021467
"244.3.139.251",58309,"244.3.31.244",443,22,4244,14,1852,8,2392,172.72405,0.012225000000000819,1211942.7402862175,1565316.973415028
"244.3.139.251",58310,"244.3.31.244",443,24,5264,15,2263,9,3001,172.740924,0.013392999999979338,1351750.9146589958,1792578.212501832
"244.3.139.251",58311,"244.3.31.244",443,22,4430,14,1809,8,2621,172.755407,0.011047000000019125,1310038.9245926447,1898071.8747138318
"244.3.139.251",58312,"244.3.31.244",443,22,4244,14,1852,8,2392,172.767446,0.012146000000001322,1219825.4569404237,1575498.1063722968
"244.3.139.251",58313,"244.3.31.244",443,24,5264,15,2263,9,3001,172.783964,0.013079000000004726,1384203.6852965408,1835614.343603588
"244.3.139.251",58314,"244.3.31.244",443,24,4655,15,2034,9,2621,172.79806,0.010816000000005488,1504437.869821722,1938609.4674546376
"244.3.139.251",58315,"244.3.31.244",443,24,4678,15,2041,9,2637,172.809836,0.011330000000015161,1441129.744040437,1861959.399820986
"244.3.139.251",58316,"244.3.31.244",443,24,4687,15,2087,9,2600,172.822173,0.012614000000013448,1323608.688757111,1648961.4713792473
"244.3.139.251",58317,"244.3.31.244",443,22,4430,14,1809,8,2621,172.83672,0.010327999999987014,1401239.3493433574,2030209.140203947
"244.3.139.251",58318,"244.3.31.244",443,22,4244,14,1852,8,2392,172.848037,0.012095999999985452,1224867.7248691982,1582010.5820124848
"244.3.139.251",58319,"244.3.31.244",443,24,5264,15,2263,9,3001,172.864896,0.012993000000022903,1393365.658429007,1847764.1807094344
"244.3.139.251",58320,"244.3.31.244",443,22,4430,14,1809,8,2621,172.878965,0.010507000000018252,1377367.4693037842,1995621.966304709
"244.3.139.251",58321,"244.3.31.244",443,22,4244,14,1852,8,2392,172.890478,0.012067999999999302,1227709.645343127,1585681.140205594
"244.3.139.251",58322,"244.3.31.244",443,22,4430,14,1809,8,2621,172.90719,0.010295999999982541,1405594.405596789,2036519.0365224897
"244.3.139.251",58323,"244.3.31.244",443,22,4244,14,1852,8,2392,172.91844,0.01269600000000537,1166981.7265275468,1507246.3768109567
"244.3.139.251",58324,"244.3.31.244",443,22,4430,14,1809,8,2621,172.93482,0.010536999999999352,1373445.9523584407,1989940.2106862757
"244.3.139.251",58325,"244.3.31.244",443,22,4244,14,1852,8,2392,172.946292,0.012181999999995696,1216220.6534235128,1570842.2262359844
"244.3.139.251",58326,"244.3.31.244",443,22,4430,14,1809,8,2621,172.963182,0.01077000000000794,1343732.5905282572,1946889.5078908582
"244.3.139.251",58327,"244.3.31.244",443,22,4244,14,1852,8,2392,172.974938,0.012159999999994398,1218421.0526321402,1573684.2105270408
"244.3.139.251",58328,"244.3.31.244",443,24,4506,15,2102,9,2404,172.992313,0.013002999999997655,1293240.0215337256,1479043.2977007974
"244.3.139.251",58329,"244.3.31.244",443,24,5264,15,2263,9,3001,173.006427,0.013405000000005884,1350540.8429684485,1790973.5173434883
"244.3.139.251",58330,"244.3.31.244",443,24,4922,15,2355,9,2567,173.020807,0.0170930000000169,1102205.5812309936,1201427.4849341658
"244.3.139.251",58331,"244.3.31.244",443,22,4434,14,1813,8,2621,173.039349,0.010080000000016298,1438888.8888865623,2080158.7301553667
"244.3.139.251",58332,"244.3.31.244",443,22,4248,14,1856,8,2392,173.05039,0.01247900000001323,1189838.929400133,1533456.2064251713
"244.3.139.251",58333,"244.3.31.244",443,24,5276,15,2267,9,3009,173.067363,0.013090000000005375,1385485.103131593,1838961.0389602839
"244.3.139.251",58334,"244.3.31.244",443,22,4434,14,1813,8,2621,173.081549,0.010496000000017602,1381859.7560952436,1997713.414630796
"244.3.139.251",58335,"244.3.31.244",443,22,4248,14,1856,8,2392,173.093009,0.012243000000012216,1212774.6467357008,1563015.60074989
"244.3.139.251",58336,"244.3.31.244",443,24,5276,15,2267,9,3009,173.109784,0.013321000000019012,1361459.3498967132,1807071.5411730083
"244.3.139.251",58337,"244.3.31.244",443,24,4655,15,2034,9,2621,173.126681,0.011362000000019634,1432142.2284784263,1845449.744760057
"244.3.139.251",58338,"244.3.31.244",443,24,4678,15,2041,9,2637,173.139031,0.011012000000022226,1482746.095165914,1915728.2964000565
"244.3.139.251",58339,"244.3.31.244",443,24,4695,15,2091,9,2604,173.151013,0.012394999999997935,1349576.4421139804,1680677.692618271
"244.3.139.251",58340,"244.3.31.244",443,22,4434,14,1813,8,2621,173.165193,0.010287000000005264,1409934.869251733,2038300.7679585177
"244.3.139.251",58341,"244.3.31.244",443,22,4248,14,1856,8,2392,173.176556,0.012105999999988626,1226499.2565681438,1580703.7832494613
"244.3.139.251",58342,"244.3.31.244",443,24,5276,15,2267,9,3009,173.193942,0.012945000000001983,1401004.2487444745,1859559.6755501206
"244.3.139.251",58343,"244.3.31.244",443,22,4434,14,1813,8,2621,173.20798,0.010552000000018324,1374526.1561765363,1987111.4480632665
"244.3.139.251",58344,"244.3.31.244",443,22,4248,14,1856,8,2392,173.21955,0.012150999999988699,1221957.040573929,1574849.8066017446
"244.3.139.251",58345,"244.3.31.244",443,22,4434,14,1813,8,2621,173.236652,0.011133000000000948,1302793.4968111708,1883409.682924478
"244.3.139.251",58346,"244.3.31.244",443,22,4248,14,1856,8,2392,173.248783,0.012073999999984153,1229749.875767723,1584893.1588558154
"244.3.139.251",58347,"244.3.31.244",443,22,4434,14,1813,8,2621,173.266295,0.010400999999973237,1394481.2998786,2015960.0038509713
"244.3.139.251",58348,"244.3.31.244",443,22,4248,14,1856,8,2392,173.277917,0.011861000000010335,1251833.740830205,1613354.6918458245
"244.3.139.251",58349,"244.3.31.244",443,22,4434,14,1813,8,2621,173.294653,0.01080899999999474,1341844.7589977852,1939864.9273762794
"244.3.139.251",58350,"244.3.31.244",443,22,4248,14,1856,8,2392,173.306549,0.012206000000020367,1216450.9257721796,1567753.5638184557
"244.3.139.251",58351,"244.3.31.244",443,24,4510,15,2106,9,2404,173.323714,0.01377500000000964,1223085.2994546795,1396152.4500897669
"244.3.139.251",58352,"244.3.31.244",443,24,5276,15,2267,9,3009,173.338951,0.013373999999998887,1356064.0047855175,1799910.2736654705
"244.3.139.251",58353,"244.3.31.244",443,24,4909,15,2342,9,2567,173.353306,0.014981000000005906,1250650.8243770518,1370803.0171545227
"244.3.139.251",58354,"244.3.31.244",443,22,4430,14,1809,8,2621,193.371594,0.0110610000000122,1308380.797394814,1895669.4693044818
"244.3.139.251",58355,"244.3.31.244",443,22,4244,14,1852,8,2392,193.383653,0.01211799999998675,1222644.0006615117,1579138.4716967258
"244.3.139.251",58356,"244.3.31.244",443,24,5264,15,2263,9,3001,193.400674,0.01297800000000393,1394976.1134222928,1849899.8304817944
"244.3.139.251",58357,"244.3.31.244",443,22,4430,14,1809,8,2621,193.415506,0.01094800000001328,1321885.2758478667,1915235.6594788604
"244.3.139.251",58358,"244.3.31.244",443,22,4244,14,1852,8,2392,193.42744,0.012127000000020871,1221736.6207614827,1577966.5209835132
"244.3.139.251",58359,"244.3.31.244",443,24,5264,15,2263,9,3001,193.443624,0.013021000000009053,1390369.4032706714,1843790.7994764848
"244.3.139.251",58360,"244.3.31.244",443,24,4655,15,2034,9,2621,193.45765,0.011018000000007078,1476856.0537293109,1903067.707386688
"244.3.139.251",58361,"244.3.31.244",443,24,4678,15,2041,9,2637,193.469734,0.01105900000001725,1476444.5248191096,1907586.5810622203
"244.3.139.251",58362,"244.3.31.244",443,24,4687,15,2087,9,2600,193.482476,0.012426000000004933,1343634.3151451289,1673909.544502796
"244.3.139.251",58363,"244.3.31.244",443,22,4430,14,1809,8,2621,193.49671,0.010536000000001877,1373576.3097947438,1990129.0812449
"244.3.139.251",58364,"244.3.31.244",443,22,4244,14,1852,8,2392,193.508409,0.012431999999989785,1191763.191764171,1539253.5392548041
"244.3.139.251",58365,"244.3.31.244",443,24,5264,15,2263,9,3001,193.525366,0.012934999999998809,1399613.4518748873,1856049.4781602018
"244.3.139.251",58366,"244.3.31.244",443,22,4430,14,1809,8,2621,193.539365,0.011094999999983202,1304371.338442714,1889860.2974341367
"244.3.139.251",58367,"244.3.31.244",443,22,4244,14,1852,8,2392,193.551425,0.012265000000013515,1207990.2160606338,1560211.9853223737
"244.3.139.251",58368,"244.3.31.244",443,22,4430,14,1809,8,2621,193.56923,0.010359999999991487,1396911.1969123448,2023938.223939887
"244.3.139.251",58369,"244.3.31.244",443,22,4244,14,1852,8,2392,193.580649,0.012371000000001686,1197639.6410959486,1546843.424136884
"244.3.139.251",58370,"244.3.31.244",443,22,4430,14,1809,8,2621,193.597497,0.010601000000008298,1365154.2307318812,1977926.6106955558
"244.3.139.251",58371,"244.3.31.244",443,22,4244,14,1852,8,2392,193.609043,0.012341999999989639,1200453.7352141014,1550478.0424579538
"244.3.139.251",58372,"244.3.31.244",443,22,4430,14,1809,8,2621,193.626427,0.010707999999993945,1351512.8875614665,1958162.1217792172
"244.3.139.251",58373,"244.3.31.244",443,22,4244,14,1852,8,2392,193.638069,0.01199900000000298,1234769.5641300376,1594799.5666301565
"244.3.139.251",58374,"244.3.31.244",443,24,4506,15,2102,9,2404,193.654359,0.012788999999997941,1314879.974978709,1503792.3215265537
"244.3.139.251",58375,"244.3.31.244",443,24,5264,15,2263,9,3001,193.668143,0.012836000000021386,1410408.226859601,1870364.5995606107
"244.3.139.251",58376,"244.3.31.244",443,24,4921,15,2354,9,2567,193.68265,0.018223000000006095,1033419.3052732097,1126927.509191304
"244.3.141.84",47736,"244.3.41.84",31100,12,1128,8,800,4,328,1.253116,180.236075,35.50898453597594,14.558683659750136
"244.3.141.84",31100,"244.3.41.84",2594,12,1132,4,328,8,804,1.275835,180.345051,14.549886373094873,35.664965377952065
"244.3.142.38",2448,"41.177.98.176",80,111,99031,36,4656,75,94375,13.369495,25.993173,1432.9916551549902,29046.08837097341
"244.3.142.38",2449,"41.177.98.176",80,45,35533,18,5887,27,29646,15.971151,23.391544000000003,2013.377141756867,10139.048538223897
"244.3.142.38",2450,"41.177.98.176",80,43,28125,18,5881,25,22244,15.971657,23.390983,2011.3733569897427,7607.717897105907
"244.3.142.38",2454,"41.177.98.176",80,26,13198,13,4025,13,9173,15.987718,23.374854,1377.548711106388,3139.4420688146333
"244.3.142.38",2455,"41.177.98.176",80,45,33223,17,3450,28,29773,15.98797,23.374753000000002,1180.761140021458,10189.797513582282
"244.3.142.38",2456,"41.177.98.176",80,22,9746,11,3014,11,6732,15.988183,23.374426999999997,1031.5546986456611,2304.056480186659
"244.3.144.127",3269,"244.3.41.84",23,4,257,2,129,2,128,139.527682,0.2716800000000035,3798.5865724381138,3769.140164899834
"244.3.150.203",4700,"244.3.160.239",80,11,1943,6,1010,5,933,79.906273,0.005176000000005843,1561051.0046350232,1442040.1854697787
"244.3.150.203",8675,"244.3.160.239",80,11,2086,6,1027,5,1059,79.912481,0.024773999999993634,331638.0075886862,341971.42165181955
"244.3.150.203",10388,"244.3.160.239",80,11,2057,6,1079,5,978,79.988302,0.009532999999990466,905486.2058122976,820727.9974832503
"244.3.150.203",13444,"244.3.160.239",80,19,7358,9,1245,10,6113,79.998497,0.5178470000000033,19233.48015919748,94437.16001058168
"244.3.151.202",55530,"244.3.41.84",23,4,256,2,128,2,128,18.487119,0.2040299999999995,5018.869774052848,5018.869774052848
"244.3.153.0",3057,"41.177.3.117",445,4,256,2,128,2,128,26.947041,119.98453099999999,8.534433492930852,8.534433492930852
"244.3.153.13",1251,"41.177.202.249",445,21,2002,14,1225,7,777,8.416559,182.482039,53.70391548507413,34.063626393389875
"244.3.153.22",1801,"244.3.176.224",445,4,256,2,128,2,128,86.88258,120.098779,8.526314826231499,8.526314826231499
"244.3.153.22",1975,"41.177.24.241",443,21,6251,10,2215,11,4036,88.199546,0.2664890000000071,66494.30182859153,121160.72333191667
"244.3.153.24",3362,"41.177.3.117",445,4,256,2,128,2,128,83.274281,120.030746,8.531147511155185,8.531147511155185
"244.3.153.25",49421,"41.177.24.241",5222,8,784,4,528,4,256,32.610196,165.091669,25.585785313006923,12.405229242670023
"244.3.153.25",50637,"244.3.160.80",443,2,895,1,831,1,64,53.978951,0.0007990000000006603,0,0
"244.3.153.25",50654,"244.3.160.80",443,15,3685,7,1476,8,2209,54.061104,15.152902999999995,779.2566216519701,1166.2451742745272
"244.3.153.25",50670,"41.177.24.241",993,13,1865,6,652,7,1213,212.56835,0.19995799999998098,26085.477950372057,48530.19134018605
"244.3.153.30",1150,"41.177.24.241",993,8,895,4,368,4,527,71.357704,0.32190200000000857,9145.640598691283,13097.153792147572
"244.3.153.30",1715,"244.3.160.80",443,2,984,1,920,1,64,147.506418,0.0008600000000171804,0,0
"244.3.153.30",1720,"244.3.160.80",443,15,3708,7,1554,8,2154,147.538662,15.159088000000025,820.1021064063998,1136.7438463316507
"244.3.153.33",1803,"244.3.176.224",445,153793,112409250,61129,4463509,92664,107945741,0.000962,206.883383,172600.00045532896,4174167.666235427
"244.3.153.33",1712,"41.177.24.241",993,7,806,4,362,3,444,139.244995,0.37421299999999746,7738.908055038226,9491.920376897713
"244.3.153.33",1709,"41.177.24.241",993,9,948,4,368,5,580,139.245324,0.48277299999998036,6098.104077900213,9611.142296690554
"244.3.153.33",1711,"41.177.24.241",993,7,865,4,365,3,500,139.245753,0.37317999999999074,7824.6422637871065,10718.688032585078
"244.3.153.34",56793,"41.177.3.145",443,3,241,2,177,1,64,16.776158,0.00036700000000067234,0,0
"244.3.153.34",56833,"41.177.3.145",443,30,6523,18,3889,12,2634,16.784185,43.145775,721.09030374353,488.39080999240366
"244.3.153.34",52684,"41.177.24.241",993,103,50198,47,4842,56,45356,16.864784,192.05510600000002,201.69211226282104,1889.2910871112167
"244.3.153.34",52687,"41.177.24.241",993,667,506484,428,469662,239,36822,17.006559,194.85623099999998,19282.401084725898,1511.7607401530825
"244.3.153.34",52693,"41.177.24.241",5222,21,4375,14,1687,7,2688,23.056424,180.005986,74.97528443304101,119.46269386841391
"244.3.153.34",52694,"41.177.24.241",5222,21,4487,14,1687,7,2800,23.093795,180.005479,74.9754956069976,124.44065660912466
"244.3.153.34",56846,"41.177.3.145",443,44,21450,22,3779,22,17671,59.932244,0.07596400000000614,397977.9895739766,1860986.7832129507
"244.3.153.34",56847,"41.177.3.145",443,19,2835,11,1831,8,1004,60.003722,0.015352999999997508,954080.6357065315,523155.08369708224
"244.3.153.34",56848,"41.177.3.145",443,19,2867,11,1863,8,1004,60.004567,0.012568000000001689,1185868.8733289305,639083.3863780173
"244.3.153.34",56849,"41.177.3.145",443,18,2781,11,1847,7,934,60.005638,0.014631000000001393,1009910.4640830151,510696.46640689555
"244.3.153.34",56850,"41.177.3.145",443,22,4143,13,2808,9,1335,60.010323,0.0305930000000032,734285.6208935917,349099.4671983422
"244.3.153.34",56851,"41.177.3.145",443,19,2851,11,1847,8,1004,60.035404,0.011516999999997779,1282972.9964402926,697403.8378051184
"244.3.153.34",56852,"41.177.3.145",443,19,2867,11,1863,8,1004,60.036479,0.012309999999999377,1210722.9894395415,652477.6604387008
"244.3.153.34",56853,"41.177.3.145",443,19,2867,11,1863,8,1004,60.037613,0.013423000000003071,1110333.0105041042,598375.9219249171
"244.3.153.34",56854,"41.177.3.145",443,19,2851,11,1847,8,1004,60.043177,0.013536000000001991,1091607.5650116599,593380.6146571231
"244.3.153.34",56855,"41.177.3.145",443,19,2851,11,1847,8,1004,60.050667,0.012904000000006022,1145071.2957217223,622442.653440503
"244.3.153.34",56856,"41.177.3.145",443,19,2851,11,1847,8,1004,60.065271,0.009764999999994473,1513159.2421923568,822529.4418847462
"244.3.153.34",56857,"41.177.3.145",443,19,2851,11,1847,8,1004,60.066372,0.009875999999998442,1496152.2883760969,813284.7306603147
"244.3.153.34",56858,"41.177.3.145",443,19,2851,11,1847,8,1004,60.08063,0.012874000000003605,1147739.6302622233,623893.1179118962
"244.3.153.34",56859,"41.177.3.145",443,18,2781,11,1847,7,934,60.084665,0.010686999999997226,1382614.3913169117,699167.2125013511
"244.3.153.34",56860,"41.177.3.145",443,19,2851,11,1847,8,1004,60.086279,0.012177000000001215,1213435.1646545557,659604.171799228
"244.3.153.34",56861,"41.177.3.145",443,19,2851,11,1847,8,1004,60.087196,0.012390000000003454,1192574.6569811043,648264.7296204811
"244.3.153.34",56862,"41.177.3.145",443,19,2851,11,1847,8,1004,60.117686,0.012487999999997612,1183215.887251988,643177.4503524612
"244.3.153.34",56863,"41.177.3.145",443,19,2851,11,1847,8,1004,60.118557,0.012650000000000716,1168063.2411066531,634940.7114624146
"244.3.153.34",56864,"41.177.3.145",443,19,2851,11,1847,8,1004,60.119714,0.013487999999995282,1095492.2894428505,595492.2894426757
"244.3.153.34",56865,"41.177.3.145",443,19,2851,11,1847,8,1004,60.120535,0.01316500000000076,1122369.920243004,610102.5446258668
"244.3.153.34",56866,"41.177.3.145",443,19,2851,11,1847,8,1004,60.147995,0.013683999999997809,1079801.2277113684,586962.8763520379
"244.3.153.34",56867,"41.177.3.145",443,19,2851,11,1847,8,1004,60.148896,0.011071999999998638,1334537.5722544994,725433.5260116499
"244.3.153.34",56868,"41.177.3.145",443,19,2851,11,1847,8,1004,60.149971,0.017701999999999884,834707.9426053608,453734.0413512627
"244.3.153.34",56869,"41.177.3.145",443,19,2851,11,1847,8,1004,60.150785,0.014668999999997823,1007294.2940897262,547549.2535279291
"244.3.153.34",56870,"41.177.3.145",443,19,2851,11,1847,8,1004,60.162134,0.01410200000000117,1047794.6390582027,569564.6007658016
"244.3.153.34",56871,"41.177.3.145",443,19,2851,11,1847,8,1004,60.163044,0.018281999999999243,808226.671042589,439339.2407833023
"244.3.153.34",56872,"41.177.3.145",443,19,2851,11,1847,8,1004,60.168468,0.01445900000000222,1021924.0611382345,555501.7636073565
"244.3.153.34",56873,"41.177.3.145",443,19,2867,11,1863,8,1004,60.173327,0.010809000000001845,1378850.9575351519,743084.4666480367
"244.3.153.34",56874,"41.177.3.145",443,22,4143,13,2808,9,1335,60.186986,0.022327000000004205,1006136.0684371286,478344.60518645536
"244.3.153.34",56875,"41.177.3.145",443,19,2867,11,1863,8,1004,60.20476,0.013570000000001414,1098305.0847456483,591893.8835666295
"244.3.153.34",56876,"41.177.3.145",443,19,2867,11,1863,8,1004,60.205792,0.013041999999998666,1142769.5138783564,615856.4637326193
"244.3.153.34",56877,"41.177.3.145",443,19,2867,11,1863,8,1004,60.207053,0.015126999999999668,985258.1476829726,530971.1112580271
"244.3.153.34",56878,"41.177.3.145",443,25,5435,15,3769,10,1666,60.215312,0.07084400000000102,425611.20207779866,188131.66958387173
"244.3.153.34",56879,"41.177.3.145",443,19,2851,11,1847,8,1004,60.281244,0.014659000000001754,1007981.444846049,547922.7778156109
"244.3.153.34",56880,"41.177.3.145",443,19,2851,11,1847,8,1004,60.282129,0.015486000000002775,954152.1374142679,518662.0173058608
"244.3.153.34",56881,"41.177.3.145",443,19,2851,11,1847,8,1004,60.283188,0.013273999999995567,1113153.5332232134,605092.6623476482
"244.3.153.34",56882,"41.177.3.145",443,19,2851,11,1847,8,1004,60.292142,0.013668000000002678,1081065.261925454,587649.9853671661
"244.3.153.34",56883,"41.177.3.145",443,19,2851,11,1847,8,1004,60.300476,0.011260000000000048,1312255.7726465308,713321.4920071018
"244.3.153.34",56884,"41.177.3.145",443,31,8594,18,5189,13,3405,60.310296,0.06089099999999803,681742.7862902784,447356.75222940795
"244.3.153.34",56885,"41.177.3.145",443,19,2835,11,1831,8,1004,60.367579,0.01179700000000139,1241671.6114264876,680851.063829707
"244.3.153.34",56886,"41.177.3.145",443,20,2911,12,1907,8,1004,60.368762,16.40861900000001,929.7552706903605,489.49884204149026
"244.3.153.34",56887,"244.3.31.117",443,47,23935,22,2861,25,21074,70.444402,0.447102000000001,51191.89804563601,377077.2664850518
"244.3.153.34",56888,"244.3.31.117",443,39,17038,20,2524,19,14514,70.638169,0.0607519999999937,332367.6586779381,1911245.7203057026
"244.3.153.34",56889,"244.3.31.117",443,20,3772,12,1980,8,1792,70.639695,0.09573799999999721,165451.54484113373,149742.00421985437
"244.3.153.34",56890,"41.177.3.145",443,27,5551,16,3610,11,1941,76.779657,61.243939,471.55686703952864,253.5434567655748
"244.3.153.34",56892,"244.3.31.117",443,89,38984,42,6562,47,32422,96.611498,3.7066000000000088,14162.84465547938,69976.79814385134
"244.3.153.34",56893,"244.3.31.117",443,42,17200,21,2546,21,14654,97.713691,0.10173400000000754,200208.38657674415,1152338.4512551487
"244.3.153.34",56894,"244.3.31.117",443,22,3848,13,1986,9,1862,97.714074,0.09928100000000484,160030.620158935,150038.77881970644
"244.3.153.34",56896,"41.177.3.145",443,10,1544,6,554,4,990,119.756457,0.11484199999999589,38592.15269674996,68964.31619094306
"244.3.153.34",56995,"41.177.3.145",443,27,5551,16,3610,11,1941,138.026454,58.752644000000004,491.55234613781806,264.2944886020789
"244.3.153.34",57136,"244.3.160.181",395,11,2048,6,509,5,1539,164.358097,0.008460000000013679,481323.87706777966,1455319.1489338172
"244.3.153.34",57137,"244.3.31.117",443,15,5165,8,687,7,4478,184.35655,0.018318999999991092,300016.3764399079,1955565.2601134025
"244.3.153.34",57138,"244.3.31.117",443,15,5136,8,658,7,4478,184.373685,0.016291999999992868,323103.36361418513,2198870.611343953
"244.3.153.34",57141,"41.177.3.145",443,24,5310,14,3433,10,1877,196.78151,15.021068000000014,1828.3653332772326,999.6626072127485
"244.3.153.34",57143,"244.3.40.161",80,26,16143,13,2387,13,13756,205.520033,0.13943999999997914,136947.79116467913,789213.9988526711
"244.3.153.34",57147,"41.177.24.203",587,477,472355,407,465523,70,6832,208.742287,0.7744849999999985,4808594.098013528,70570.7663802399
"244.3.153.34",56366,"41.177.24.241",993,586,478794,387,464795,199,13999,209.521387,0.5700809999999876,6522511.713247908,196449.2765063253
"244.3.153.39",52582,"145.95.55.83",139,2,146,1,82,1,64,186.457643,0.001287000000019134,0,0
"244.3.153.41",1329,"41.177.3.117",445,4,256,2,128,2,128,72.993177,120.254064,8.515304730158642,8.515304730158642
"244.3.153.41",1353,"244.3.160.80",443,805,572609,298,33511,507,539098,104.032178,39.610439,6768.114839625989,108879.98489489096
"244.3.153.41",1231,"41.177.24.241",993,3,252,2,154,1,98,119.422862,0.1565520000000049,7869.5896571104895,5007.9206908884935
"244.3.153.48",1513,"244.3.176.224",445,21,2002,14,1225,7,777,8.882627,182.52207399999998,53.692135889273324,34.05615476405337
"244.3.153.48",1519,"41.177.3.117",445,21,2002,14,1225,7,777,8.894374,182.510526,53.69553315516717,34.058309601277465
"244.3.153.48",1492,"41.177.230.119",524,2,128,1,64,1,64,19.137118,0.1969770000000004,2599.288241774415,2599.288241774415
"244.3.153.48",1491,"41.177.230.252",524,2,128,1,64,1,64,19.137122,0.19746499999999756,2592.8645582761824,2592.8645582761824
"244.3.153.48",1858,"244.3.160.80",443,3,1099,2,1035,1,64,46.777281,0.0006709999999969796,0,0
"244.3.153.48",1863,"244.3.160.80",443,17,5422,8,2514,9,2908,46.789,15.139387999999997,1328.455284982458,1536.6539255087462
"244.3.153.56",3891,"244.3.176.118",3389,774,131117,428,44628,346,86489,3.449747,203.489619,1754.5071918386166,3400.232421684371
"244.3.153.67",1359,"41.177.202.249",445,22,2066,14,1225,8,841,9.750768,182.483753,53.70341106476476,36.86903567793238
"244.3.153.89",2282,"244.3.176.224",445,21,2002,14,1225,7,777,29.564975,182.807012,53.60844692325041,34.00307204846169
"244.3.153.103",1705,"244.3.176.224",445,4,256,2,128,2,128,59.864544,120.099716,8.526248305199989,8.526248305199989
"244.3.153.108",2894,"244.3.176.224",445,4,256,2,128,2,128,49.798534,120.09859,8.526328244153408,8.526328244153408
"244.3.153.111",2769,"41.177.24.241",993,6,504,4,308,2,196,7.215746,121.64487300000002,20.255683114569074,12.889980163816684
"244.3.153.111",2450,"41.177.3.117",445,69,14861,36,7480,33,7381,16.75038,180.71067299999999,331.13705464424896,326.75435833278095
"244.3.153.117",49381,"41.177.3.18",5730,28,13459,13,1019,15,12440,0.459967,0.476552,17106.2129631184,208833.453641995
"244.3.153.117",49379,"41.177.24.241",5222,10,1380,5,592,5,788,26.657318,167.774171,28.228421405819375,37.57431768207039
"244.3.153.117",49380,"41.177.24.241",993,8,864,4,368,4,496,111.510254,0.31174799999999436,9443.524898315476,12728.229210773034
"244.3.153.117",49376,"41.177.24.241",993,9,949,4,364,5,585,111.510532,0.34269700000000114,8497.302281607339,13656.378666868937
"244.3.153.142",50867,"244.3.124.145",22,44,4268,22,2860,22,1408,1.992996,210.015725,108.94422310519843,53.63407906717461
"244.3.153.142",58179,"244.3.40.127",443,49,33595,23,10141,26,23454,2.17417,188.234062,430.9953211337489,996.8015246889801
"244.3.153.142",55544,"244.3.124.153",22,44,4268,22,2860,22,1408,2.231141,210.020456,108.941768986541,53.632870885681726
"244.3.153.142",51016,"41.177.24.241",5222,29,6153,16,2009,13,4144,3.755398,204.035946,78.77043391167946,162.48117378297647
"244.3.153.142",58148,"244.3.40.127",443,61,40369,27,10394,34,29975,6.822128,183.59496000000001,452.9100363103649,1306.1360725806414
"244.3.153.142",49633,"41.177.31.98",22,336,55508,182,37178,154,18330,9.425115,199.227946,1492.8829311927957,736.0413182194831
"244.3.153.142",58178,"244.3.40.127",443,63,43843,28,10457,35,33386,16.734095,173.67694500000002,481.67590695471984,1537.843724738479
"244.3.153.142",50774,"41.177.46.23",445,18,1716,12,1050,6,666,24.597268,180.28215,46.59363114983929,29.553674615040922
"244.3.153.142",55497,"244.3.176.68",445,20,2035,13,1279,7,756,24.597304,180.282041,56.75551454401385,33.54743471092609
"244.3.153.142",55633,"244.3.176.68",3389,30,2652,20,1612,10,1040,29.897075,164.328247,78.477073999335,50.63037032215161
"244.3.153.142",58177,"244.3.40.127",443,43,28296,21,10039,22,18257,70.420192,120.00507699999999,669.2383523073779,1217.0818406291262
"244.3.153.142",58180,"244.3.40.127",443,30,17493,16,9695,14,7798,70.610161,119.826933,647.266837748405,520.617514261172
"244.3.153.142",58184,"244.3.40.127",443,23,12206,14,9570,9,2636,70.614185,119.87296299999998,638.6761291618362,175.91956911918498
"244.3.153.142",58181,"244.3.40.127",443,48,29756,24,10223,24,19533,70.618204,119.86497999999999,682.3010357153524,1303.6668424755921
"244.3.153.142",51985,"41.177.24.241",993,8,853,4,372,4,481,89.471255,0.6299800000000033,4723.95949077746,6108.130416838598
"244.3.153.142",57171,"244.3.31.24",1522,2,132,1,64,1,68,175.546886,0.2794659999999851,1832.0654390875,1946.5695290304686
"244.3.153.142",58200,"41.177.4.167",1526,92,22091,47,12018,45,10073,204.659313,3.9379100000000165,24414.98155112727,20463.646959935515
"244.3.153.142",58204,"41.177.4.167",1526,46,15561,24,7611,22,7950,209.397291,1.4958129999999983,40705.62296222861,42518.6838194347
"244.3.153.156",1543,"41.177.202.249",445,22,2066,14,1225,8,841,21.151957,182.52588699999998,53.69101425048821,36.860524885437215
"244.3.153.156",2788,"41.177.202.0",445,21,2002,14,1225,7,777,21.152039,182.525124,53.69123869215944,34.05558568474113
"244.3.153.156",1946,"41.177.202.202",1521,2,132,1,64,1,68,114.065596,0.17264799999999525,2965.5715675826773,3150.9197905565948
"244.3.153.177",1559,"41.177.3.117",445,4,256,2,128,2,128,21.259621,120.034534,8.53087828874314,8.53087828874314
"244.3.153.177",1890,"244.3.160.80",443,1,64,1,64,0,0,45.241027,0,0,0
"244.3.153.177",1894,"244.3.160.80",443,15,2726,8,1480,7,1246,45.241426,135.258916,87.53581908049595,73.69569633398511
"244.3.153.177",1895,"244.3.160.80",443,14,2662,7,1416,7,1246,180.500754,15.199653000000012,745.2801718565543,655.8044450093691
"244.3.153.197",50485,"41.177.3.145",443,7,558,4,317,3,241,3.642311,6.883482000000001,368.4181930017395,280.0908028814486
"244.3.153.197",49699,"41.177.24.241",5222,21,4562,13,1628,8,2934,27.307559,179.998525,72.35614847399444,130.40106856431186
"244.3.153.197",50488,"244.3.41.152",5401,21,3050,13,1910,8,1140,32.03977,0.2302490000000006,66362.93751547221,39609.29254850174
"244.3.153.197",49684,"41.177.24.241",993,45,12671,26,3166,19,9505,40.077586,135.929653,186.33167554690954,559.4070044451596
"244.3.153.197",50489,"41.177.3.145",443,24,5481,14,3610,10,1871,48.702491,22.638213999999998,1275.7190121093477,661.1829007358973
"244.3.153.197",49700,"41.177.4.31",5222,15,3205,10,1205,5,2000,56.775553,150.479358,64.06194263534803,106.32687574331624
"244.3.153.197",50490,"41.177.3.145",443,24,5481,14,3610,10,1871,108.627936,22.44686199999998,1286.5940905236564,666.8192640913466
"244.3.153.197",49682,"41.177.24.241",993,7,899,4,390,3,509,164.464404,0.32114400000000387,9715.267917195908,12679.67017910953
"244.3.153.197",49685,"41.177.24.241",993,105,51662,54,26373,51,25289,164.72489,12.16144300000002,17348.59917527876,16635.525899352542
"244.3.153.197",50491,"41.177.3.145",443,24,5481,14,3610,10,1871,168.866074,22.2945,1295.3867545807261,671.3763484267421
"244.3.153.197",49683,"41.177.24.241",993,3,284,2,173,1,111,176.006575,0.026174999999994952,52874.880611280496,33925.5014326713
"244.3.153.209",4182,"244.3.160.80",443,18,4183,8,2091,10,2092,162.140334,0.11652100000000587,143562.10468498518,143630.76183691487
"244.3.153.209",4183,"244.3.160.80",443,24,7438,12,3898,12,3540,162.257798,1.9312989999999957,16146.645340778445,14663.705619896278
"244.3.153.209",4184,"244.3.160.128",443,21,6605,11,3014,10,3591,163.889814,8.395250000000004,2872.1002948095634,3421.935022780737
"244.3.153.209",4185,"244.3.160.80",443,17,3916,8,2241,9,1675,164.187954,0.0337910000000079,530555.4733507682,396555.2957887268
"244.3.153.209",4186,"244.3.160.80",443,188,121724,74,18318,114,103406,164.220945,18.064767999999987,8112.144036391727,45793.44722279304
"244.3.153.209",4187,"244.3.160.80",443,83,34306,40,17517,43,16789,164.935668,17.348844000000014,8077.541074206436,7741.841473702795
"244.3.153.209",4188,"244.3.160.80",443,872,627639,334,42273,538,585366,164.936059,37.345652,9055.512004449674,125394.1958223142
"244.3.153.209",4189,"244.3.160.80",443,219,144063,89,24272,130,119791,164.936394,17.34833599999999,11192.773762278994,55240.3412062114
"244.3.153.239",2323,"41.177.3.117",445,4,256,2,128,2,128,15.244092,120.072937,8.528149852784896,8.528149852784896
"244.3.153.239",1492,"41.177.24.241",993,9,756,6,462,3,294,31.415143,123.58200099999999,29.907267806741537,19.03189769519916
"244.3.153.239",2330,"41.177.24.241",993,32,3980,16,1562,16,2418,91.811936,42.81307100000001,291.8734794801335,451.8246308469672
"244.3.153.239",2331,"41.177.24.241",993,33,3993,16,1544,17,2449,91.817312,42.812459000000004,288.5141449128161,457.62379591417533
"244.3.153.239",2332,"41.177.24.241",993,32,6146,16,1474,16,4672,91.817535,42.83948499999998,275.2600784066383,872.4661372563189
"244.3.153.247",4507,"244.3.160.80",443,1,64,1,64,0,0,23.905153,0,0,0
"244.3.153.247",4528,"244.3.160.80",443,14,2649,7,1408,7,1241,23.905888,15.113294999999997,745.3040518298625,656.9050627278831
"244.3.153.247",4174,"244.3.176.224",445,11,704,0,0,11,704,97.098952,20.003043000000005,0,281.55716107794194
"244.3.153.248",49376,"41.177.24.241",993,6,504,4,308,2,196,2.056289,121.123314,20.342904422182507,12.945484632297958
"244.3.157.0",1738,"244.3.41.84",23,4,256,2,128,2,128,18.480418,0.1469699999999996,6967.408314622051,6967.408314622051
"244.3.157.106",2098,"244.3.41.84",23,4,256,2,128,2,128,18.475185,0.1415399999999991,7234.703970609061,7234.703970609061
"244.3.160.89",2784,"244.3.160.204",1085,2,128,1,64,1,64,171.113468,8.199999999192187e-5,0,0
"244.3.160.89",2785,"244.3.160.204",1086,2,128,1,64,1,64,171.113724,7.400000001211993e-5,0,0
"244.3.160.89",4000,"244.3.160.204",1087,2,128,1,64,1,64,171.11397,7.200000001716944e-5,0,0
"244.3.160.89",4001,"244.3.160.204",1088,2,128,1,64,1,64,171.114245,6.999999999379725e-5,0,0
"244.3.160.89",4002,"244.3.160.204",1089,2,128,1,64,1,64,171.114507,7.299999998622297e-5,0,0
"244.3.160.89",2048,"244.3.160.204",1418,2,128,1,64,1,64,173.112822,7.899999999949614e-5,0,0
"244.3.160.89",2784,"244.3.160.204",1421,2,128,1,64,1,64,173.113591,7.199999998874773e-5,0,0
"244.3.160.89",2785,"244.3.160.204",1422,2,128,1,64,1,64,173.113805,7.399999998369822e-5,0,0
"244.3.160.89",4000,"244.3.160.204",1423,2,128,1,64,1,64,173.114072,6.600000000389628e-5,0,0
"244.3.160.89",4001,"244.3.160.204",1754,2,128,1,64,1,64,175.112628,9.499999998752173e-5,0,0
"244.3.160.89",4002,"244.3.160.204",1755,2,128,1,64,1,64,175.112872,7.399999998369822e-5,0,0
"244.3.160.89",2048,"244.3.160.204",1756,2,128,1,64,1,64,175.113119,7.199999998874773e-5,0,0
"244.3.160.89",2784,"244.3.160.204",1759,2,128,1,64,1,64,175.113921,7.299999998622297e-5,0,0
"244.3.160.89",2785,"244.3.160.204",2085,2,128,1,64,1,64,177.113107,0.00010299999999574538,0,0
"244.3.160.89",4000,"244.3.160.204",2086,2,128,1,64,1,64,177.113355,7.399999998369822e-5,0,0
"244.3.160.89",4001,"244.3.160.204",2087,2,128,1,64,1,64,177.113631,6.700000000137152e-5,0,0
"244.3.160.89",4002,"244.3.160.204",2088,2,128,1,64,1,64,177.113903,7.10000000196942e-5,0,0
"244.3.160.89",2784,"244.3.160.204",2425,2,128,1,64,1,64,179.113244,8.199999999192187e-5,0,0
"244.3.160.89",2785,"244.3.160.204",2426,2,128,1,64,1,64,179.113487,7.300000001464468e-5,0,0
"244.3.160.89",4000,"244.3.160.204",2427,2,128,1,64,1,64,179.113761,7.099999999127249e-5,0,0
"244.3.160.89",4001,"244.3.160.204",2428,2,128,1,64,1,64,179.11401,6.799999999884676e-5,0,0
"244.3.160.89",4002,"244.3.160.204",2429,2,128,1,64,1,64,179.114255,6.999999999379725e-5,0,0
"244.3.160.89",2784,"244.3.160.204",2758,2,128,1,64,1,64,181.114423,7.10000000196942e-5,0,0
"244.3.160.89",2785,"244.3.160.204",2759,2,128,1,64,1,64,181.114724,6.8999999996322e-5,0,0
"244.3.160.89",4000,"244.3.160.204",2760,2,128,1,64,1,64,181.114995,8.400000001529406e-5,0,0
"244.3.160.89",4001,"244.3.160.204",3089,2,128,1,64,1,64,183.113456,8.699999997929808e-5,0,0
"244.3.160.89",4002,"244.3.160.204",3090,2,128,1,64,1,64,183.11379,0.0002020000000015898,0,0
"244.3.160.89",4000,"244.3.160.204",3426,2,128,1,64,1,64,185.113468,6.700000000137152e-5,0,0
"244.3.160.89",4001,"244.3.160.204",3427,2,128,1,64,1,64,185.113704,6.799999999884676e-5,0,0
"244.3.160.89",4002,"244.3.160.204",3428,2,128,1,64,1,64,185.114035,6.8999999996322e-5,0,0
"244.3.160.89",4000,"244.3.160.204",3759,2,128,1,64,1,64,187.11439,6.600000000389628e-5,0,0
"244.3.160.89",4001,"244.3.160.204",3760,2,128,1,64,1,64,187.114625,6.8999999996322e-5,0,0
"244.3.160.89",4002,"244.3.160.204",3761,2,128,1,64,1,64,187.114919,7.000000002221896e-5,0,0
"244.3.160.105",37536,"41.177.26.15",80,53,48296,15,1373,38,46923,134.842276,0.21584400000000414,50888.60473304697,1739144.9380107522
"244.3.160.105",37633,"41.177.26.15",80,126,111796,45,3293,81,108503,143.407815,0.15071700000001442,174791.16489843535,5759297.225926186
"244.3.160.105",37768,"41.177.26.15",80,88,75903,32,2460,56,73443,154.651716,0.1466400000000192,134206.21931258473,4006710.3109651054
"244.3.160.105",37816,"41.177.26.15",80,96,83167,35,2652,61,80515,166.330711,0.1779589999999871,119218.47167044958,3619485.3870838042
"244.3.160.105",37910,"41.177.26.15",80,93,79969,34,2588,59,77381,175.574138,0.1446589999999901,143122.7922217174,4279360.426935361
"244.3.160.105",38083,"41.177.26.15",80,219,202971,76,5277,143,197694,183.677984,0.22109899999998106,190937.09152915038,7153139.543824872
"244.3.160.105",38204,"41.177.26.15",80,105,91530,38,2844,67,88686,194.684426,0.15666699999999878,145225.22292505874,4528637.1731124325
"244.3.160.105",38318,"41.177.26.15",80,135,120431,48,3484,87,116947,201.808191,0.13106200000001422,212662.7092520866,7138423.036424734
"244.3.160.204",37189,"244.3.160.89",2785,2,128,1,64,1,64,1.098931,0.00026199999999998447,0,0
"244.3.160.204",37190,"244.3.160.89",4000,2,128,1,64,1,64,1.099184,5.900000000003125e-5,0,0
"244.3.160.204",37191,"244.3.160.89",4001,2,128,1,64,1,64,1.099453,7.00000000000145e-5,0,0
"244.3.160.204",37192,"244.3.160.89",4002,2,128,1,64,1,64,1.099689,7.00000000000145e-5,0,0
"244.3.160.204",37193,"244.3.160.89",2048,2,128,1,64,1,64,1.099939,6.799999999995698e-5,0,0
"244.3.160.204",37194,"244.3.160.89",80,7,448,4,256,3,192,1.10019,0.15361700000000011,13331.857802196362,9998.893351647272
"244.3.160.204",37195,"244.3.160.254",2784,2,128,1,64,1,64,1.100497,0.00026999999999999247,0,0
"244.3.160.204",37196,"244.3.160.254",2785,2,128,1,64,1,64,1.100771,6.20000000000065e-5,0,0
"244.3.160.204",37197,"244.3.160.254",4000,7,448,4,256,3,192,1.101014,0.15480300000000002,13229.717770327446,9922.288327745584
"244.3.160.204",37198,"244.3.160.254",4001,2,128,1,64,1,64,1.101289,7.400000000012952e-5,0,0
"244.3.160.204",37199,"244.3.160.254",4002,2,128,1,64,1,64,1.101572,6.499999999998174e-5,0,0
"244.3.160.204",37200,"244.3.160.254",2048,2,128,1,64,1,64,1.101813,6.20000000000065e-5,0,0
"244.3.160.204",37201,"244.3.160.239",443,7,448,4,256,3,192,1.102088,0.19733200000000006,10378.448503030422,7783.836377272817
"244.3.160.204",37202,"244.3.160.239",8080,2,128,1,64,1,64,1.102376,6.499999999998174e-5,0,0
"244.3.160.204",37203,"244.3.160.239",80,7,448,4,256,3,192,1.102635,0.15602000000000005,13126.522240738363,9844.891680553772
"244.3.160.204",37523,"244.3.160.89",443,13,3841,5,362,8,3479,3.098639,0.20843699999999998,13893.886402126303,133527.15688673317
"244.3.160.204",37524,"244.3.160.89",2784,2,128,1,64,1,64,3.098875,8.199999999991547e-5,0,0
"244.3.160.204",37525,"244.3.160.89",2785,2,128,1,64,1,64,3.09911,7.00000000000145e-5,0,0
"244.3.160.204",37526,"244.3.160.89",4000,2,128,1,64,1,64,3.099375,8.799999999986596e-5,0,0
"244.3.160.204",37527,"244.3.160.89",4001,2,128,1,64,1,64,3.099627,6.899999999987472e-5,0,0
"244.3.160.204",37528,"244.3.160.89",4002,2,128,1,64,1,64,3.099878,6.4000000000064e-5,0,0
"244.3.160.204",37529,"244.3.160.254",443,7,448,4,256,3,192,3.100146,0.1614279999999999,12686.770572639203,9515.077929479403
"244.3.160.204",37530,"244.3.160.254",80,7,448,4,256,3,192,3.10042,0.16274199999999972,12584.335942780619,9438.251957085464
"244.3.160.204",37531,"244.3.160.254",2784,2,128,1,64,1,64,3.100717,7.50000000002693e-5,0,0
"244.3.160.204",37532,"244.3.160.254",2785,2,128,1,64,1,64,3.100931,7.199999999984996e-5,0,0
"244.3.160.204",37533,"244.3.160.254",4000,7,448,4,256,3,192,3.101185,0.1638639999999998,12498.169213494133,9373.6269101206
"244.3.160.204",37534,"244.3.160.254",4001,2,128,1,64,1,64,3.101479,7.00000000000145e-5,0,0
"244.3.160.204",37535,"244.3.160.239",443,7,448,4,256,3,192,3.101756,0.19525499999999996,10488.847916826717,7866.635937620037
"244.3.160.204",37536,"244.3.160.239",8080,2,128,1,64,1,64,3.101991,7.100000000015427e-5,0,0
"244.3.160.204",37537,"244.3.160.239",80,7,448,4,256,3,192,3.102262,0.16666500000000006,12288.122881228808,9216.092160921606
"244.3.160.204",37859,"244.3.160.89",2048,2,128,1,64,1,64,5.098479,8.900000000000574e-5,0,0
"244.3.160.204",37860,"244.3.160.89",80,7,448,4,256,3,192,5.098768,0.15224500000000063,13452.0017077736,10089.001280830198
"244.3.160.204",37861,"244.3.160.89",443,13,3841,5,362,8,3479,5.098988,0.1953459999999998,14824.977219907258,142475.40261894296
"244.3.160.204",37862,"244.3.160.89",2784,2,128,1,64,1,64,5.099257,7.200000000029405e-5,0,0
"244.3.160.204",37863,"244.3.160.89",2785,2,128,1,64,1,64,5.09948,6.700000000048334e-5,0,0
"244.3.160.204",37864,"244.3.160.89",4000,2,128,1,64,1,64,5.099814,5.599999999983396e-5,0,0
"244.3.160.204",37865,"244.3.160.254",4002,2,128,1,64,1,64,5.100011,7.100000000015427e-5,0,0
"244.3.160.204",37866,"244.3.160.254",2048,2,128,1,64,1,64,5.100263,6.299999999992423e-5,0,0
"244.3.160.204",37867,"244.3.160.254",443,7,448,4,256,3,192,5.100508,0.15324600000000022,13364.133484723889,10023.100113542916
"244.3.160.204",37868,"244.3.160.254",80,7,448,4,256,3,192,5.100791,0.15450699999999973,13255.062877410108,9941.297158057581
"244.3.160.204",37869,"244.3.160.254",2784,2,128,1,64,1,64,5.101032,7.300000000043383e-5,0,0
"244.3.160.204",37870,"244.3.160.254",2785,2,128,1,64,1,64,5.101288,7.599999999996498e-5,0,0
"244.3.160.204",37871,"244.3.160.239",443,7,448,4,256,3,192,5.101586,0.15663699999999992,13074.81629500055,9806.112221250412
"244.3.160.204",37872,"244.3.160.239",8080,2,128,1,64,1,64,5.101843,6.90000000007629e-5,0,0
"244.3.160.204",37873,"244.3.160.239",80,7,448,4,256,3,192,5.102092,0.1569180000000001,13051.402643418847,9788.551982564135
"244.3.160.204",38190,"244.3.160.89",4001,2,128,1,64,1,64,7.098985,9.300000000056485e-5,0,0
"244.3.160.204",38191,"244.3.160.89",4002,2,128,1,64,1,64,7.099217,7.00000000000145e-5,0,0
"244.3.160.204",38192,"244.3.160.89",2048,2,128,1,64,1,64,7.099454,6.899999999987472e-5,0,0
"244.3.160.204",38193,"244.3.160.89",80,7,448,4,256,3,192,7.099713,0.15886899999999926,12891.124133720296,9668.343100290222
"244.3.160.204",38194,"244.3.160.89",443,13,3841,5,362,8,3479,7.10002,0.20863500000000013,13880.700745320768,133400.43616842804
"244.3.160.204",38195,"244.3.160.89",2784,2,128,1,64,1,64,7.100219,7.00000000000145e-5,0,0
"244.3.160.204",38196,"244.3.160.254",4000,7,448,4,256,3,192,7.100475,0.1599149999999998,12806.803614420176,9605.102710815132
"244.3.160.204",38197,"244.3.160.254",4001,2,128,1,64,1,64,7.100748,7.799999999935636e-5,0,0
"244.3.160.204",38198,"244.3.160.254",4002,2,128,1,64,1,64,7.101003,7.00000000000145e-5,0,0
"244.3.160.204",38199,"244.3.160.254",2048,2,128,1,64,1,64,7.10128,5.100000000002325e-5,0,0
"244.3.160.204",38200,"244.3.160.254",443,7,448,4,256,3,192,7.101592,0.1611589999999996,12707.946810292971,9530.96010771973
"244.3.160.204",38201,"244.3.160.254",80,7,448,4,256,3,192,7.101799,0.16195100000000018,12645.800272922042,9484.350204691533
"244.3.160.204",38202,"244.3.160.239",443,7,448,4,256,3,192,7.102078,0.20628700000000055,9927.915961742594,7445.936971306945
"244.3.160.204",38203,"244.3.160.239",8080,2,128,1,64,1,64,7.102332,7.200000000029405e-5,0,0
"244.3.160.204",38204,"244.3.160.239",80,7,448,4,256,3,192,7.102594,0.16320599999999974,12548.558263789342,9411.418697842006
"244.3.160.204",38529,"244.3.160.89",2785,2,128,1,64,1,64,9.099245,0.0001010000000007949,0,0
"244.3.160.204",38530,"244.3.160.89",4000,2,128,1,64,1,64,9.099485,8.300000000005525e-5,0,0
"244.3.160.204",38531,"244.3.160.89",4001,2,128,1,64,1,64,9.09975,7.100000000015427e-5,0,0
"244.3.160.204",38532,"244.3.160.89",4002,2,128,1,64,1,64,9.100013,6.899999999987472e-5,0,0
"244.3.160.204",38533,"244.3.160.89",2048,2,128,1,64,1,64,9.100249,7.700000000099294e-5,0,0
"244.3.160.204",38534,"244.3.160.89",80,7,448,4,256,3,192,9.1005,0.1528659999999995,13397.354545811408,10048.015909358555
"244.3.160.204",38535,"244.3.160.254",2784,2,128,1,64,1,64,9.100766,7.399999999968543e-5,0,0
"244.3.160.204",38536,"244.3.160.254",2785,2,128,1,64,1,64,9.10105,6.999999999912632e-5,0,0
"244.3.160.204",38537,"244.3.160.254",4000,7,448,4,256,3,192,9.101315,0.15360700000000094,13332.725722134977,9999.544291601233
"244.3.160.204",38538,"244.3.160.254",4001,2,128,1,64,1,64,9.10157,7.499999999893703e-5,0,0
"244.3.160.204",38539,"244.3.160.254",4002,2,128,1,64,1,64,9.101846,6.299999999903605e-5,0,0
"244.3.160.204",38540,"244.3.160.254",2048,2,128,1,64,1,64,9.102118,6.699999999959516e-5,0,0
"244.3.160.204",38541,"244.3.160.239",443,7,448,4,256,3,192,9.102391,0.18129299999999837,11296.630316669802,8472.472737502352
"244.3.160.204",38542,"244.3.160.239",8080,2,128,1,64,1,64,9.10265,7.199999999940587e-5,0,0
"244.3.160.204",38543,"244.3.160.239",80,7,448,4,256,3,192,9.102939,0.15574400000000033,13149.784261351935,9862.33819601395
"244.3.160.204",38860,"244.3.160.89",443,13,3841,5,362,8,3479,11.09983,0.19948699999999953,14517.236712166743,139517.86331941464
"244.3.160.204",38861,"244.3.160.89",2784,2,128,1,64,1,64,11.100092,7.699999999921658e-5,0,0
"244.3.160.204",38862,"244.3.160.89",2785,2,128,1,64,1,64,11.100345,6.999999999912632e-5,0,0
"244.3.160.204",38863,"244.3.160.89",4000,2,128,1,64,1,64,11.100673,0.00030899999999967065,0,0
"244.3.160.204",38864,"244.3.160.89",4001,2,128,1,64,1,64,11.100833,0.00017800000000001148,0,0
"244.3.160.204",38865,"244.3.160.89",4002,2,128,1,64,1,64,11.101105,0.00028799999999939985,0,0
"244.3.160.204",38866,"244.3.160.254",443,7,448,4,256,3,192,11.101398,0.15688600000000008,13054.064734903044,9790.548551177282
"244.3.160.204",38867,"244.3.160.254",80,7,448,4,256,3,192,11.101653,0.15752799999999922,13000.86333858114,9750.647503935856
"244.3.160.204",38868,"244.3.160.254",2784,2,128,1,64,1,64,11.10189,6.900000000165107e-5,0,0
"244.3.160.204",38869,"244.3.160.254",2785,2,128,1,64,1,64,11.102171,6.999999999912632e-5,0,0
"244.3.160.204",38870,"244.3.160.254",4000,7,448,4,256,3,192,11.102429,0.1584779999999988,12922.929365590275,9692.197024192707
"244.3.160.204",38871,"244.3.160.254",4001,2,128,1,64,1,64,11.102687,6.800000000062312e-5,0,0
"244.3.160.204",38872,"244.3.160.239",443,7,448,4,256,3,192,11.102964,0.20427600000000012,10025.651569445254,7519.23867708394
"244.3.160.204",38873,"244.3.160.239",8080,2,128,1,64,1,64,11.103248,6.999999999912632e-5,0,0
"244.3.160.204",38874,"244.3.160.239",80,7,448,4,256,3,192,11.103506,0.16013300000000008,12789.368837154108,9592.026627865582
"244.3.160.204",39194,"244.3.160.89",2048,2,128,1,64,1,64,13.099584,9.200000000042508e-5,0,0
"244.3.160.204",39195,"244.3.160.89",80,7,448,4,256,3,192,13.099835,0.16038499999999978,12769.2739345949,9576.955450946174
"244.3.160.204",39196,"244.3.160.89",443,13,3841,5,362,8,3479,13.10008,0.20695599999999992,13993.312588183,134482.6919731731
"244.3.160.204",39197,"244.3.160.89",2784,2,128,1,64,1,64,13.100446,0.0007540000000005875,0,0
"244.3.160.204",39198,"244.3.160.89",2785,2,128,1,64,1,64,13.100689,0.0007250000000009749,0,0
"244.3.160.204",39199,"244.3.160.89",4000,2,128,1,64,1,64,13.100867,0.0006620000000001625,0,0
"244.3.160.204",39200,"244.3.160.254",4002,2,128,1,64,1,64,13.101131,0.00042000000000008697,0,0
"244.3.160.204",39201,"244.3.160.254",2048,2,128,1,64,1,64,13.101409,0.00016300000000057935,0,0
"244.3.160.204",39202,"244.3.160.254",443,7,448,4,256,3,192,13.101666,0.16210200000000086,12634.020554959156,9475.515416219367
"244.3.160.204",39203,"244.3.160.254",80,7,448,4,256,3,192,13.101922,0.16300999999999988,12563.646402061233,9422.734801545925
"244.3.160.204",39204,"244.3.160.254",2784,2,128,1,64,1,64,13.102191,7.399999999968543e-5,0,0
"244.3.160.204",39205,"244.3.160.254",2785,2,128,1,64,1,64,13.102463,7.399999999968543e-5,0,0
"244.3.160.204",39206,"244.3.160.239",443,7,448,4,256,3,192,13.102816,0.19885299999999972,10299.065138569711,7724.298853927284
"244.3.160.204",39207,"244.3.160.239",8080,2,128,1,64,1,64,13.102999,9.799999999948739e-5,0,0
"244.3.160.204",39208,"244.3.160.239",80,7,448,4,256,3,192,13.103286,0.1678999999999995,12197.73674806436,9148.302561048271
"244.3.160.204",39530,"244.3.160.89",4001,2,128,1,64,1,64,15.100297,0.00010900000000013677,0,0
"244.3.160.204",39531,"244.3.160.89",4002,2,128,1,64,1,64,15.100587,7.299999999865747e-5,0,0
"244.3.160.204",39532,"244.3.160.89",2048,2,128,1,64,1,64,15.100829,6.900000000165107e-5,0,0
"244.3.160.204",39533,"244.3.160.89",80,7,448,4,256,3,192,15.101093,0.16791599999999995,12196.574477715052,9147.430858286289
"244.3.160.204",39534,"244.3.160.89",443,13,3841,5,362,8,3479,15.101365,0.21306000000000047,13592.415282080136,130629.86952032262
"244.3.160.204",39535,"244.3.160.89",2784,2,128,1,64,1,64,15.101626,7.200000000118223e-5,0,0
"244.3.160.204",39536,"244.3.160.254",4000,7,448,4,256,3,192,15.101918,0.16790500000000108,12197.373514785068,9148.0301360888
"244.3.160.204",39537,"244.3.160.254",4001,2,128,1,64,1,64,15.102156,7.199999999940587e-5,0,0
"244.3.160.204",39538,"244.3.160.254",4002,2,128,1,64,1,64,15.102508,0.00024999999999941735,0,0
"244.3.160.204",39539,"244.3.160.254",2048,2,128,1,64,1,64,15.102732,0.0005300000000012517,0,0
"244.3.160.204",39540,"244.3.160.254",443,7,448,4,256,3,192,15.102967,0.16823800000000055,12173.230780204194,9129.923085153147
"244.3.160.204",39541,"244.3.160.254",80,7,448,4,256,3,192,15.103267,0.16867699999999886,12141.548640300776,9106.16148022558
"244.3.160.204",39542,"244.3.160.239",443,7,448,4,256,3,192,15.103612,0.21839800000000054,9377.375250689085,7033.031438016815
"244.3.160.204",39543,"244.3.160.239",8080,2,128,1,64,1,64,15.103789,0.000140000000000029,0,0
"244.3.160.204",39544,"244.3.160.239",80,7,448,4,256,3,192,15.104057,0.17013500000000015,12037.499632644654,9028.12472448349
"244.3.160.204",39861,"244.3.160.89",2785,2,128,1,64,1,64,17.099943,8.599999999958641e-5,0,0
"244.3.160.204",39862,"244.3.160.89",4000,2,128,1,64,1,64,17.100185,7.000000000090267e-5,0,0
"244.3.160.204",39863,"244.3.160.89",4001,2,128,1,64,1,64,17.100421,6.49999999993156e-5,0,0
"244.3.160.204",39864,"244.3.160.89",4002,2,128,1,64,1,64,17.100701,6.69999999978188e-5,0,0
"244.3.160.204",39865,"244.3.160.89",2048,2,128,1,64,1,64,17.100948,7.300000000043383e-5,0,0
"244.3.160.204",39866,"244.3.160.89",80,7,448,4,256,3,192,17.101205,0.167901999999998,12197.591452156761,9148.19358911757
"244.3.160.204",39867,"244.3.160.254",2784,2,128,1,64,1,64,17.101475,6.899999999987472e-5,0,0
"244.3.160.204",39868,"244.3.160.254",2785,2,128,1,64,1,64,17.101768,6.799999999884676e-5,0,0
"244.3.160.204",39869,"244.3.160.254",4000,7,448,4,256,3,192,17.102007,0.16808599999999885,12184.239020501493,9138.17926537612
"244.3.160.204",39870,"244.3.160.254",4001,2,128,1,64,1,64,17.102266,6.700000000137152e-5,0,0
"244.3.160.204",39871,"244.3.160.254",4002,2,128,1,64,1,64,17.102541,6.700000000137152e-5,0,0
"244.3.160.204",39872,"244.3.160.254",2048,2,128,1,64,1,64,17.102801,6.799999999884676e-5,0,0
"244.3.160.204",39873,"244.3.160.239",443,7,448,4,256,3,192,17.103083,0.19726099999999747,10382.18401001732,7786.638007512989
"244.3.160.204",39874,"244.3.160.239",8080,2,128,1,64,1,64,17.103347,9.000000000014552e-5,0,0
"244.3.160.204",39875,"244.3.160.239",80,7,448,4,256,3,192,17.10362,0.16892599999999902,12123.6517765176,9092.738832388199
"244.3.160.204",40200,"244.3.160.89",443,13,3841,5,362,8,3479,19.099838,0.21833100000000272,13264.2638928964,127476.17150106789
"244.3.160.204",40201,"244.3.160.89",2784,2,128,1,64,1,64,19.100067,9.000000000014552e-5,0,0
"244.3.160.204",40202,"244.3.160.89",2785,2,128,1,64,1,64,19.100308,7.300000000043383e-5,0,0
"244.3.160.204",40203,"244.3.160.89",4000,2,128,1,64,1,64,19.100553,7.099999999837792e-5,0,0
"244.3.160.204",40204,"244.3.160.89",4001,2,128,1,64,1,64,19.10082,7.100000000193063e-5,0,0
"244.3.160.204",40205,"244.3.160.89",4002,2,128,1,64,1,64,19.101071,6.799999999884676e-5,0,0
"244.3.160.204",40206,"244.3.160.254",443,7,448,4,256,3,192,19.101338,0.1707780000000021,11992.176978299165,8994.132733724375
"244.3.160.204",40207,"244.3.160.254",80,7,448,4,256,3,192,19.101598,0.1710729999999998,11971.497547830471,8978.623160872854
"244.3.160.204",40208,"244.3.160.254",2784,2,128,1,64,1,64,19.101873,9.299999999967667e-5,0,0
"244.3.160.204",40209,"244.3.160.254",2785,2,128,1,64,1,64,19.102144,6.49999999993156e-5,0,0
"244.3.160.204",40210,"244.3.160.254",4000,7,448,4,256,3,192,19.10237,0.17129999999999868,11955.633391710542,8966.725043782906
"244.3.160.204",40211,"244.3.160.254",4001,2,128,1,64,1,64,19.102621,7.000000000090267e-5,0,0
"244.3.160.204",40212,"244.3.160.239",443,7,448,4,256,3,192,19.102933,0.17766299999999902,11527.442405002794,8645.581803752095
"244.3.160.204",40213,"244.3.160.239",8080,2,128,1,64,1,64,19.103194,5.200000000016303e-5,0,0
"244.3.160.204",40214,"244.3.160.239",80,7,448,4,256,3,192,19.103437,0.172346000000001,11883.072424077078,8912.304318057808
"244.3.160.204",40531,"244.3.160.89",2048,2,128,1,64,1,64,21.100817,8.899999999911756e-5,0,0
"244.3.160.204",40532,"244.3.160.89",80,7,448,4,256,3,192,21.101076,0.17157399999999967,11936.540501474605,8952.405376105953
"244.3.160.204",40533,"244.3.160.89",443,13,3841,5,362,8,3479,21.101342,0.22214600000000218,13036.47150972771,125286.97343188591
"244.3.160.204",40534,"244.3.160.89",2784,2,128,1,64,1,64,21.101571,7.599999999996498e-5,0,0
"244.3.160.204",40535,"244.3.160.89",2785,2,128,1,64,1,64,21.101823,5.7000000001750095e-5,0,0
"244.3.160.204",40536,"244.3.160.89",4000,2,128,1,64,1,64,21.102085,8.100000000155205e-5,0,0
"244.3.160.204",40537,"244.3.160.254",4002,2,128,1,64,1,64,21.102357,7.299999999688112e-5,0,0
"244.3.160.204",40538,"244.3.160.254",2048,2,128,1,64,1,64,21.102611,7.400000000146179e-5,0,0
"244.3.160.204",40539,"244.3.160.254",443,7,448,4,256,3,192,21.102881,0.17307500000000076,11833.020366892913,8874.765275169686
"244.3.160.204",40540,"244.3.160.254",80,7,448,4,256,3,192,21.103147,0.17416499999999857,11758.964200614457,8819.223150460843
"244.3.160.204",40541,"244.3.160.254",2784,2,128,1,64,1,64,21.103492,7.000000000090267e-5,0,0
"244.3.160.204",40542,"244.3.160.254",2785,2,128,1,64,1,64,21.103671,7.000000000090267e-5,0,0
"244.3.160.204",40543,"244.3.160.239",443,7,448,4,256,3,192,21.103968,0.22146700000000052,9247.427381957561,6935.570536468171
"244.3.160.204",40544,"244.3.160.239",8080,2,128,1,64,1,64,21.104233,7.000000000090267e-5,0,0
"244.3.160.204",40545,"244.3.160.239",80,7,448,4,256,3,192,21.104534,0.1751579999999997,11692.300665684716,8769.225499263537
"244.3.160.204",40865,"244.3.160.89",4001,2,128,1,64,1,64,23.099914,8.900000000267028e-5,0,0
"244.3.160.204",40866,"244.3.160.89",4002,2,128,1,64,1,64,23.100143,6.899999999987472e-5,0,0
"244.3.160.204",40867,"244.3.160.89",2048,2,128,1,64,1,64,23.100369,7.199999999940587e-5,0,0
"244.3.160.204",40868,"244.3.160.89",80,7,448,4,256,3,192,23.100612,0.17328399999999888,11818.748413009933,8864.06130975745
"244.3.160.204",40869,"244.3.160.89",443,13,3841,5,362,8,3479,23.100894,0.22453000000000145,12898.053712198733,123956.70957110329
"244.3.160.204",40870,"244.3.160.89",2784,2,128,1,64,1,64,23.101131,7.300000000043383e-5,0,0
"244.3.160.204",40871,"244.3.160.254",4000,7,448,4,256,3,192,23.101416,0.17350799999999822,11803.490328976306,8852.61774673223
"244.3.160.204",40872,"244.3.160.254",4001,2,128,1,64,1,64,23.101648,9.599999999920783e-5,0,0
"244.3.160.204",40873,"244.3.160.254",4002,2,128,1,64,1,64,23.101899,6.899999999987472e-5,0,0
"244.3.160.204",40874,"244.3.160.254",2048,2,128,1,64,1,64,23.102275,0.00011699999999947863,0,0
"244.3.160.204",40875,"244.3.160.254",443,7,448,4,256,3,192,23.10261,0.17485000000000284,11712.89676865866,8784.672576493995
"244.3.160.204",40876,"244.3.160.254",80,7,448,4,256,3,192,23.102882,0.17510700000000057,11695.706054012651,8771.77954050949
"244.3.160.204",40877,"244.3.160.239",443,7,448,4,256,3,192,23.10319,0.21292499999999848,9618.410238346905,7213.8076787601785
"244.3.160.204",40878,"244.3.160.239",8080,2,128,1,64,1,64,23.103439,7.099999999837792e-5,0,0
"244.3.160.204",40879,"244.3.160.239",80,7,448,4,256,3,192,23.103696,0.17715199999999953,11560.693641618527,8670.520231213895
"244.3.160.204",41201,"244.3.160.89",2785,2,128,1,64,1,64,25.100872,0.0003150000000005093,0,0
"244.3.160.204",41202,"244.3.160.89",4000,2,128,1,64,1,64,25.101109,0.00011800000000050659,0,0
"244.3.160.204",41203,"244.3.160.89",4001,2,128,1,64,1,64,25.101404,4.6000000001100716e-5,0,0
"244.3.160.204",41204,"244.3.160.89",4002,2,128,1,64,1,64,25.101632,6.800000000239947e-5,0,0
"244.3.160.204",41205,"244.3.160.89",2048,2,128,1,64,1,64,25.101872,7.700000000099294e-5,0,0
"244.3.160.204",41206,"244.3.160.89",80,7,448,4,256,3,192,25.102131,0.1665440000000018,12297.050629263005,9222.787971947253
"244.3.160.204",41207,"244.3.160.254",2784,2,128,1,64,1,64,25.102427,9.999999999976694e-5,0,0
"244.3.160.204",41208,"244.3.160.254",2785,2,128,1,64,1,64,25.102709,0.00010699999999985721,0,0
"244.3.160.204",41209,"244.3.160.254",4000,7,448,4,256,3,192,25.102955,0.1674049999999987,12233.804247185066,9175.3531853888
"244.3.160.204",41210,"244.3.160.254",4001,2,128,1,64,1,64,25.103235,7.099999999837792e-5,0,0
"244.3.160.204",41211,"244.3.160.254",4002,2,128,1,64,1,64,25.103503,7.400000000146179e-5,0,0
"244.3.160.204",41212,"244.3.160.254",2048,2,128,1,64,1,64,25.103757,6.899999999987472e-5,0,0
"244.3.160.204",41213,"244.3.160.239",443,7,448,4,256,3,192,25.104033,0.18970999999999805,10795.424595435248,8096.568446576437
"244.3.160.204",41214,"244.3.160.239",8080,2,128,1,64,1,64,25.104326,6.799999999884676e-5,0,0
"244.3.160.204",41215,"244.3.160.239",80,7,448,4,256,3,192,25.104626,0.16762900000000158,12217.456406707555,9163.092305030666
"244.3.160.204",41532,"244.3.160.89",443,13,3841,5,362,8,3479,27.100754,0.2162510000000033,13391.845586841013,128702.29501828697
"244.3.160.204",41533,"244.3.160.89",2784,2,128,1,64,1,64,27.101019,5.600000000072214e-5,0,0
"244.3.160.204",41534,"244.3.160.89",2785,2,128,1,64,1,64,27.101247,6.69999999978188e-5,0,0
"244.3.160.204",41535,"244.3.160.89",4000,2,128,1,64,1,64,27.101514,0.0001029999999992981,0,0
"244.3.160.204",41536,"244.3.160.89",4001,2,128,1,64,1,64,27.101774,6.000000000128125e-5,0,0
"244.3.160.204",41537,"244.3.160.89",4002,2,128,1,64,1,64,27.102004,8.099999999799934e-5,0,0
"244.3.160.204",41538,"244.3.160.254",443,7,448,4,256,3,192,27.102295,0.16927799999999849,12098.441616748889,9073.831212561667
"244.3.160.204",41539,"244.3.160.254",80,7,448,4,256,3,192,27.102554,0.16988299999999867,12055.355744836246,9041.516808627184
"244.3.160.204",41540,"244.3.160.254",2784,2,128,1,64,1,64,27.102825,5.499999999969418e-5,0,0
"244.3.160.204",41541,"244.3.160.254",2785,2,128,1,64,1,64,27.103161,4.300000000156956e-5,0,0
"244.3.160.204",41542,"244.3.160.254",4000,7,448,4,256,3,192,27.103342,0.17078300000000013,11991.825884309319,8993.869413231989
"244.3.160.204",41543,"244.3.160.254",4001,2,128,1,64,1,64,27.103646,6.600000000034356e-5,0,0
"244.3.160.204",41544,"244.3.160.239",443,7,448,4,256,3,192,27.103878,0.2172009999999993,9429.054194041493,7071.79064553112
"244.3.160.204",41545,"244.3.160.239",8080,2,128,1,64,1,64,27.104143,6.600000000034356e-5,0,0
"244.3.160.204",41546,"244.3.160.239",80,7,448,4,256,3,192,27.104419,0.17300399999999883,11837.876580888384,8878.407435666288
"244.3.160.204",41871,"244.3.160.89",2048,2,128,1,64,1,64,29.101015,0.00010199999999827014,0,0
"244.3.160.204",41872,"244.3.160.89",80,7,448,4,256,3,192,29.101247,0.16817999999999955,12177.428945177819,9133.071708883364
"244.3.160.204",41873,"244.3.160.89",443,13,3841,5,362,8,3479,29.101516,0.21869099999999975,13242.428815086141,127266.32554609029
"244.3.160.204",41874,"244.3.160.89",2784,2,128,1,64,1,64,29.101759,7.399999999790907e-5,0,0
"244.3.160.204",41875,"244.3.160.89",2785,2,128,1,64,1,64,29.102004,7.000000000090267e-5,0,0
"244.3.160.204",41876,"244.3.160.89",4000,2,128,1,64,1,64,29.102246,7.499999999893703e-5,0,0
"244.3.160.204",41877,"244.3.160.254",4002,2,128,1,64,1,64,29.102558,7.400000000146179e-5,0,0
"244.3.160.204",41878,"244.3.160.254",2048,2,128,1,64,1,64,29.102794,6.799999999884676e-5,0,0
"244.3.160.204",41879,"244.3.160.254",443,7,448,4,256,3,192,29.103048,0.1681229999999978,12181.557550127149,9136.168162595362
"244.3.160.204",41880,"244.3.160.254",80,7,448,4,256,3,192,29.103302,0.16839200000000076,12162.097961898373,9121.573471423779
"244.3.160.204",41881,"244.3.160.254",2784,2,128,1,64,1,64,29.103584,7.199999999940587e-5,0,0
"244.3.160.204",41882,"244.3.160.254",2785,2,128,1,64,1,64,29.103869,5.400000000221894e-5,0,0
"244.3.160.204",41883,"244.3.160.239",443,7,448,4,256,3,192,29.104125,0.2233389999999993,9169.916584206101,6877.437438154576
"244.3.160.204",41884,"244.3.160.239",8080,2,128,1,64,1,64,29.104388,7.300000000043383e-5,0,0
"244.3.160.204",41885,"244.3.160.239",80,7,448,4,256,3,192,29.104717,0.1707970000000003,11990.842930496416,8993.132197872312
"244.3.160.204",42202,"244.3.160.89",4001,2,128,1,64,1,64,31.101595,0.00011100000000041632,0,0
"244.3.160.204",42203,"244.3.160.89",4002,2,128,1,64,1,64,31.101842,7.599999999996498e-5,0,0
"244.3.160.204",42204,"244.3.160.89",2048,2,128,1,64,1,64,31.102085,7.100000000193063e-5,0,0
"244.3.160.204",42205,"244.3.160.89",80,7,448,4,256,3,192,31.102342,0.17076600000000042,11993.01968775983,8994.764765819871
"244.3.160.204",42206,"244.3.160.89",443,13,3841,5,362,8,3479,31.102577,0.22104399999999913,13101.463961926183,125911.5832142022
"244.3.160.204",42207,"244.3.160.89",2784,2,128,1,64,1,64,31.102852,7.300000000043383e-5,0,0
"244.3.160.204",42208,"244.3.160.254",4000,7,448,4,256,3,192,31.103134,0.1706719999999997,11999.625011718404,8999.718758788804
"244.3.160.204",42209,"244.3.160.254",4001,2,128,1,64,1,64,31.10339,6.199999999978445e-5,0,0
"244.3.160.204",42210,"244.3.160.254",4002,2,128,1,64,1,64,31.103668,6.600000000034356e-5,0,0
"244.3.160.204",42211,"244.3.160.254",2048,2,128,1,64,1,64,31.103939,7.000000000090267e-5,0,0
"244.3.160.204",42212,"244.3.160.254",443,7,448,4,256,3,192,31.104187,0.17237800000000192,11880.866467878599,8910.649850908949
"244.3.160.204",42213,"244.3.160.254",80,7,448,4,256,3,192,31.104447,0.17276899999999884,11853.978433631113,8890.483825223335
"244.3.160.204",42214,"244.3.160.239",443,7,448,4,256,3,192,31.104812,0.20489399999999947,9995.412261950107,7496.559196462581
"244.3.160.204",42215,"244.3.160.239",8080,2,128,1,64,1,64,31.105056,6.69999999978188e-5,0,0
"244.3.160.204",42216,"244.3.160.239",80,7,448,4,256,3,192,31.105313,0.175574000000001,11664.597263831707,8748.447947873781
"244.3.160.204",42536,"244.3.160.89",2785,2,128,1,64,1,64,33.100868,9.200000000220143e-5,0,0
"244.3.160.204",42537,"244.3.160.89",4000,2,128,1,64,1,64,33.101111,7.300000000043383e-5,0,0
"244.3.160.204",42538,"244.3.160.89",4001,2,128,1,64,1,64,33.101359,6.399999999473494e-5,0,0
"244.3.160.204",42539,"244.3.160.89",4002,2,128,1,64,1,64,33.101604,6.799999999884676e-5,0,0
"244.3.160.204",42540,"244.3.160.89",2048,2,128,1,64,1,64,33.101872,6.799999999884676e-5,0,0
"244.3.160.204",42541,"244.3.160.89",80,7,448,4,256,3,192,33.102126,0.1692430000000016,12100.943613620539,9075.707710215403
"244.3.160.204",42542,"244.3.160.254",2784,2,128,1,64,1,64,33.102399,8.300000000360797e-5,0,0
"244.3.160.204",42543,"244.3.160.254",2785,2,128,1,64,1,64,33.102663,5.800000000277805e-5,0,0
"244.3.160.204",42544,"244.3.160.254",4000,7,448,4,256,3,192,33.102936,0.1705520000000007,12008.067920634126,9006.050940475596
"244.3.160.204",42545,"244.3.160.254",4001,2,128,1,64,1,64,33.103195,6.799999999884676e-5,0,0
"244.3.160.204",42546,"244.3.160.254",4002,2,128,1,64,1,64,33.103465,6.799999999884676e-5,0,0
"244.3.160.204",42547,"244.3.160.254",2048,2,128,1,64,1,64,33.103714,7.000000000090267e-5,0,0
"244.3.160.204",42548,"244.3.160.239",443,7,448,4,256,3,192,33.104038,0.2140059999999977,9569.825145089493,7177.36885881712
"244.3.160.204",42549,"244.3.160.239",8080,2,128,1,64,1,64,33.104268,6.900000000342743e-5,0,0
"244.3.160.204",42550,"244.3.160.239",80,7,448,4,256,3,192,33.104565,0.17354499999999717,11800.973810827356,8850.730358120516
"244.3.160.204",42872,"244.3.160.89",443,13,3841,5,362,8,3479,35.101142,0.21493199999999746,13474.028995217252,129492.11843746083
"244.3.160.204",42873,"244.3.160.89",2784,2,128,1,64,1,64,35.101455,0.0004369999999980223,0,0
"244.3.160.204",42874,"244.3.160.89",2785,2,128,1,64,1,64,35.101632,0.0002689999999958559,0,0
"244.3.160.204",42875,"244.3.160.89",4000,2,128,1,64,1,64,35.101897,5.7999999995672624e-5,0,0
"244.3.160.204",42876,"244.3.160.89",4001,2,128,1,64,1,64,35.102139,7.099999999837792e-5,0,0
"244.3.160.204",42877,"244.3.160.89",4002,2,128,1,64,1,64,35.1024,7.499999999538431e-5,0,0
"244.3.160.204",42878,"244.3.160.254",443,7,448,4,256,3,192,35.102659,0.16825899999999905,12171.71146862879,9128.783601471592
"244.3.160.204",42879,"244.3.160.254",80,7,448,4,256,3,192,35.102934,0.16852500000000248,12152.499629134965,9114.374721851224
"244.3.160.204",42880,"244.3.160.254",2784,2,128,1,64,1,64,35.103192,6.900000000342743e-5,0,0
"244.3.160.204",42881,"244.3.160.254",2785,2,128,1,64,1,64,35.103451,7.80000000020209e-5,0,0
"244.3.160.204",42882,"244.3.160.254",4000,7,448,4,256,3,192,35.103707,0.16898100000000227,12119.705765736813,9089.77932430261
"244.3.160.204",42883,"244.3.160.254",4001,2,128,1,64,1,64,35.103981,7.80000000020209e-5,0,0
"244.3.160.204",42884,"244.3.160.239",443,7,448,4,256,3,192,35.104268,0.2012500000000017,10176.397515527864,7632.298136645898
"244.3.160.204",42885,"244.3.160.239",8080,2,128,1,64,1,64,35.104582,0.00029899999999827287,0,0
"244.3.160.204",42886,"244.3.160.239",80,7,448,4,256,3,192,35.10482,0.16931900000000155,12095.512021686764,9071.634016265074
"244.3.160.204",43203,"244.3.160.89",2048,2,128,1,64,1,64,37.101217,8.400000000108321e-5,0,0
"244.3.160.204",43204,"244.3.160.89",80,7,448,4,256,3,192,37.10146,0.17153899999999567,11938.975976308897,8954.231982231671
"244.3.160.204",43205,"244.3.160.89",443,13,3841,5,362,8,3479,37.101706,0.22100400000000064,13103.835224701777,125934.37222855659
"244.3.160.204",43206,"244.3.160.89",2784,2,128,1,64,1,64,37.101945,7.500000000248974e-5,0,0
"244.3.160.204",43207,"244.3.160.89",2785,2,128,1,64,1,64,37.102195,6.700000000137152e-5,0,0
"244.3.160.204",43208,"244.3.160.89",4000,2,128,1,64,1,64,37.102434,7.499999999538431e-5,0,0
"244.3.160.204",43209,"244.3.160.254",4002,2,128,1,64,1,64,37.102709,7.000000000090267e-5,0,0
"244.3.160.204",43210,"244.3.160.254",2048,2,128,1,64,1,64,37.102939,0.00013200000000068712,0,0
"244.3.160.204",43211,"244.3.160.254",443,7,448,4,256,3,192,37.103215,0.17266500000000207,11861.118350563087,8895.838762922316
"244.3.160.204",43212,"244.3.160.254",80,7,448,4,256,3,192,37.103461,0.17320499999999583,11824.139026009927,8868.104269507445
"244.3.160.204",43213,"244.3.160.254",2784,2,128,1,64,1,64,37.103769,5.000000000165983e-5,0,0
"244.3.160.204",43214,"244.3.160.254",2785,2,128,1,64,1,64,37.104006,6.700000000137152e-5,0,0
"244.3.160.204",43215,"244.3.160.239",443,7,448,4,256,3,192,37.10428,0.22517500000000013,9095.14821805262,6821.361163539465
"244.3.160.204",43216,"244.3.160.239",8080,2,128,1,64,1,64,37.104571,9.899999999873899e-5,0,0
"244.3.160.204",43217,"244.3.160.239",80,7,448,4,256,3,192,37.104848,0.1742010000000036,11756.53411863283,8817.400588974622
"244.3.160.204",43542,"244.3.160.89",4001,2,128,1,64,1,64,39.101409,9.200000000220143e-5,0,0
"244.3.160.204",43543,"244.3.160.89",4002,2,128,1,64,1,64,39.101639,7.099999999837792e-5,0,0
"244.3.160.204",43544,"244.3.160.89",2048,2,128,1,64,1,64,39.101888,0.00011800000000050659,0,0
"244.3.160.204",43545,"244.3.160.89",80,7,448,4,256,3,192,39.102122,0.17562300000000164,11661.342762622098,8746.007071966575
"244.3.160.204",43546,"244.3.160.89",443,13,3841,5,362,8,3479,39.10242,0.22486800000000073,12878.66659551377,123770.38973975803
"244.3.160.204",43547,"244.3.160.89",2784,2,128,1,64,1,64,39.102653,6.500000000642103e-5,0,0
"244.3.160.204",43548,"244.3.160.254",4000,7,448,4,256,3,192,39.102935,0.17606500000000125,11632.067702268965,8724.050776701724
"244.3.160.204",43549,"244.3.160.254",4001,2,128,1,64,1,64,39.103168,6.900000000342743e-5,0,0
"244.3.160.204",43550,"244.3.160.254",4002,2,128,1,64,1,64,39.103447,6.8999999996322e-5,0,0
"244.3.160.204",43551,"244.3.160.254",2048,2,128,1,64,1,64,39.103707,7.399999999790907e-5,0,0
"244.3.160.204",43552,"244.3.160.254",443,7,448,4,256,3,192,39.10396,0.17739699999999914,11544.727362920512,8658.545522190383
"244.3.160.204",43553,"244.3.160.254",80,7,448,4,256,3,192,39.10423,0.1779499999999956,11508.850800787022,8631.638100590266
"244.3.160.204",43554,"244.3.160.239",443,7,448,4,256,3,192,39.104573,0.21131899999999604,9691.509045566363,7268.631784174772
"244.3.160.204",43555,"244.3.160.239",8080,2,128,1,64,1,64,39.104844,7.300000000043383e-5,0,0
"244.3.160.204",43556,"244.3.160.239",80,7,448,4,256,3,192,39.105126,0.17819400000000485,11493.091798825686,8619.818849119265
"244.3.160.204",43873,"244.3.160.89",2785,2,128,1,64,1,64,41.102188,8.800000000519503e-5,0,0
"244.3.160.204",43874,"244.3.160.89",4000,2,128,1,64,1,64,41.102438,0.0003140000000030341,0,0
"244.3.160.204",43875,"244.3.160.89",4001,2,128,1,64,1,64,41.102757,3.300000000194814e-5,0,0
"244.3.160.204",43876,"244.3.160.89",4002,2,128,1,64,1,64,41.102965,6.700000000137152e-5,0,0
"244.3.160.204",43877,"244.3.160.89",2048,2,128,1,64,1,64,41.103225,5.9000000000253294e-5,0,0
"244.3.160.204",43878,"244.3.160.89",80,7,448,4,256,3,192,41.10352,0.16491499999999348,12418.518630810302,9313.888973107727
"244.3.160.204",43879,"244.3.160.254",2784,2,128,1,64,1,64,41.103796,7.199999999585316e-5,0,0
"244.3.160.204",43880,"244.3.160.254",2785,2,128,1,64,1,64,41.104042,6.900000000342743e-5,0,0
"244.3.160.204",43881,"244.3.160.254",4000,7,448,4,256,3,192,41.104289,0.1663909999999973,12308.358024172181,9231.268518129136
"244.3.160.204",43882,"244.3.160.254",4001,2,128,1,64,1,64,41.104604,7.799999999491547e-5,0,0
"244.3.160.204",43883,"244.3.160.254",4002,2,128,1,64,1,64,41.104891,5.7999999995672624e-5,0,0
"244.3.160.204",43884,"244.3.160.254",2048,2,128,1,64,1,64,41.105136,7.199999999585316e-5,0,0
"244.3.160.204",43885,"244.3.160.239",443,7,448,4,256,3,192,41.105408,0.16970900000000455,12067.715913710794,9050.786935283095
"244.3.160.204",43886,"244.3.160.239",8080,2,128,1,64,1,64,41.105711,7.200000000295859e-5,0,0
"244.3.160.204",43887,"244.3.160.239",80,7,448,4,256,3,192,41.105961,0.16833899999999602,12165.927087603279,9124.44531570246
"244.3.160.204",44207,"244.3.160.89",443,13,3841,5,362,8,3479,43.102126,0.22942600000000368,12622.806482264232,121311.44682816922
"244.3.160.204",44208,"244.3.160.89",2784,2,128,1,64,1,64,43.102364,8.299999999650254e-5,0,0
"244.3.160.204",44209,"244.3.160.89",2785,2,128,1,64,1,64,43.10265,7.40000000050145e-5,0,0
"244.3.160.204",44210,"244.3.160.89",4000,2,128,1,64,1,64,43.102884,7.300000000043383e-5,0,0
"244.3.160.204",44211,"244.3.160.89",4001,2,128,1,64,1,64,43.103136,6.900000000342743e-5,0,0
"244.3.160.204",44212,"244.3.160.89",4002,2,128,1,64,1,64,43.10341,6.400000000184036e-5,0,0
"244.3.160.204",44213,"244.3.160.254",443,7,448,4,256,3,192,43.103676,0.1790060000000011,11440.957286347873,8580.717964760905
"244.3.160.204",44214,"244.3.160.254",80,7,448,4,256,3,192,43.103933,0.1797159999999991,11395.757751118488,8546.818313338867
"244.3.160.204",44215,"244.3.160.254",2784,2,128,1,64,1,64,43.104224,4.0999999995960934e-5,0,0
"244.3.160.204",44216,"244.3.160.254",2785,2,128,1,64,1,64,43.104445,7.700000000454565e-5,0,0
"244.3.160.204",44217,"244.3.160.254",4000,7,448,4,256,3,192,43.104772,0.181709000000005,11270.768096241483,8453.076072181111
"244.3.160.204",44218,"244.3.160.254",4001,2,128,1,64,1,64,43.105029,8.79999999980896e-5,0,0
"244.3.160.204",44219,"244.3.160.239",443,7,448,4,256,3,192,43.105308,0.22518300000000124,9094.825097809287,6821.118823356966
"244.3.160.204",44220,"244.3.160.239",8080,2,128,1,64,1,64,43.105624,7.300000000043383e-5,0,0
"244.3.160.204",44221,"244.3.160.239",80,7,448,4,256,3,192,43.105903,0.18378300000000536,11143.57693584249,8357.682701881868
"244.3.160.204",44543,"244.3.160.89",2048,2,128,1,64,1,64,45.102182,9.299999999967667e-5,0,0
"244.3.160.204",44544,"244.3.160.89",80,7,448,4,256,3,192,45.102444,0.16701100000000224,12262.665333420988,9196.99900006574
"244.3.160.204",44545,"244.3.160.89",443,13,3841,5,362,8,3479,45.102675,0.21792900000000515,13288.73165113377,127711.31882401765
"244.3.160.204",44546,"244.3.160.89",2784,2,128,1,64,1,64,45.102947,7.300000000043383e-5,0,0
"244.3.160.204",44547,"244.3.160.89",2785,2,128,1,64,1,64,45.103204,7.000000000090267e-5,0,0
"244.3.160.204",44548,"244.3.160.89",4000,2,128,1,64,1,64,45.103451,7.500000000248974e-5,0,0
"244.3.160.204",44549,"244.3.160.254",4002,2,128,1,64,1,64,45.103721,7.099999999837792e-5,0,0
"244.3.160.204",44550,"244.3.160.254",2048,2,128,1,64,1,64,45.104003,6.799999999884676e-5,0,0
"244.3.160.204",44551,"244.3.160.254",443,7,448,4,256,3,192,45.104258,0.16717299999999824,12250.782123907698,9188.086592930773
"244.3.160.204",44552,"244.3.160.254",80,7,448,4,256,3,192,45.104554,0.16798699999999656,12191.419574133963,9143.564680600472
"244.3.160.204",44553,"244.3.160.254",2784,2,128,1,64,1,64,45.104859,6.700000000137152e-5,0,0
"244.3.160.204",44554,"244.3.160.254",2785,2,128,1,64,1,64,45.105122,6.299999999725969e-5,0,0
"244.3.160.204",44555,"244.3.160.239",443,7,448,4,256,3,192,45.105389,0.20299499999999426,10088.918446267435,7566.688834700576
"244.3.160.204",44556,"244.3.160.239",8080,2,128,1,64,1,64,45.105655,7.200000000295859e-5,0,0
"244.3.160.204",44557,"244.3.160.239",80,7,448,4,256,3,192,45.105938,0.16975300000000004,12064.587960153867,9048.4409701154
"244.3.160.204",44874,"244.3.160.89",4001,2,128,1,64,1,64,47.102656,9.099999999762076e-5,0,0
"244.3.160.204",44875,"244.3.160.89",4002,2,128,1,64,1,64,47.102903,7.200000000295859e-5,0,0
"244.3.160.204",44876,"244.3.160.89",2048,2,128,1,64,1,64,47.103188,7.300000000043383e-5,0,0
"244.3.160.204",44877,"244.3.160.89",80,7,448,4,256,3,192,47.10342,0.17420299999999855,11756.399143528051,8817.299357646038
"244.3.160.204",44878,"244.3.160.89",443,13,3841,5,362,8,3479,47.103672,0.22693799999999698,12761.194687535974,122641.42629264544
"244.3.160.204",44879,"244.3.160.89",2784,2,128,1,64,1,64,47.103921,7.399999999790907e-5,0,0
"244.3.160.204",44880,"244.3.160.254",4000,7,448,4,256,3,192,47.104253,0.18665200000000226,10972.290679981867,8229.2180099864
"244.3.160.204",44881,"244.3.160.254",4001,2,128,1,64,1,64,47.104512,7.200000000295859e-5,0,0
"244.3.160.204",44882,"244.3.160.254",4002,2,128,1,64,1,64,47.104802,8.000000000407681e-5,0,0
"244.3.160.204",44883,"244.3.160.254",2048,2,128,1,64,1,64,47.105099,7.300000000043383e-5,0,0
"244.3.160.204",44884,"244.3.160.254",443,7,448,4,256,3,192,47.105349,0.1764090000000067,11609.385008700929,8707.038756525697
"244.3.160.204",44885,"244.3.160.254",80,7,448,4,256,3,192,47.105602,0.17716100000000523,11560.10634394669,8670.079757960017
"244.3.160.204",44886,"244.3.160.239",443,7,448,4,256,3,192,47.105881,0.2297670000000025,8913.377464997053,6685.033098747789
"244.3.160.204",44887,"244.3.160.239",8080,2,128,1,64,1,64,47.106162,7.000000000090267e-5,0,0
"244.3.160.204",44888,"244.3.160.239",80,7,448,4,256,3,192,47.106426,0.18543000000000376,11044.599040068804,8283.449280051604
"244.3.160.204",45213,"244.3.160.89",2785,2,128,1,64,1,64,49.102524,9.699999999668307e-5,0,0
"244.3.160.204",45214,"244.3.160.89",4000,2,128,1,64,1,64,49.102765,7.40000000050145e-5,0,0
"244.3.160.204",45215,"244.3.160.89",4001,2,128,1,64,1,64,49.103026,7.300000000043383e-5,0,0
"244.3.160.204",45216,"244.3.160.89",4002,2,128,1,64,1,64,49.103284,9.1999999995096e-5,0,0
"244.3.160.204",45217,"244.3.160.89",2048,2,128,1,64,1,64,49.103534,7.099999999837792e-5,0,0
"244.3.160.204",45218,"244.3.160.89",80,7,448,4,256,3,192,49.103788,0.16591400000000078,12343.744349482204,9257.808262111652
"244.3.160.204",45219,"244.3.160.254",2784,2,128,1,64,1,64,49.10407,7.300000000043383e-5,0,0
"244.3.160.204",45220,"244.3.160.254",2785,2,128,1,64,1,64,49.104353,7.199999999585316e-5,0,0
"244.3.160.204",45221,"244.3.160.254",4000,7,448,4,256,3,192,49.10465,0.1677490000000006,12208.716594435691,9156.537445826769
"244.3.160.204",45222,"244.3.160.254",4001,2,128,1,64,1,64,49.104912,7.200000000295859e-5,0,0
"244.3.160.204",45223,"244.3.160.254",4002,2,128,1,64,1,64,49.105196,6.600000000389628e-5,0,0
"244.3.160.204",45224,"244.3.160.254",2048,2,128,1,64,1,64,49.105482,6.700000000137152e-5,0,0
"244.3.160.204",45225,"244.3.160.239",443,7,448,4,256,3,192,49.105749,0.21146399999999943,9684.863617447912,7263.647713085935
"244.3.160.204",45226,"244.3.160.239",8080,2,128,1,64,1,64,49.106004,6.799999999884676e-5,0,0
"244.3.160.204",45227,"244.3.160.239",80,7,448,4,256,3,192,49.106285,0.1686639999999997,12142.48446615759,9106.863349618192
"244.3.160.204",45544,"244.3.160.89",443,13,3841,5,362,8,3479,51.10299,0.21600700000000472,13406.972922173525,128847.67623271186
"244.3.160.204",45545,"244.3.160.89",2784,2,128,1,64,1,64,51.103223,7.399999999790907e-5,0,0
"244.3.160.204",45546,"244.3.160.89",2785,2,128,1,64,1,64,51.103491,7.099999999837792e-5,0,0
"244.3.160.204",45547,"244.3.160.89",4000,2,128,1,64,1,64,51.103736,7.40000000050145e-5,0,0
"244.3.160.204",45548,"244.3.160.89",4001,2,128,1,64,1,64,51.103991,6.599999999679085e-5,0,0
"244.3.160.204",45549,"244.3.160.89",4002,2,128,1,64,1,64,51.104239,7.099999999837792e-5,0,0
"244.3.160.204",45550,"244.3.160.254",443,7,448,4,256,3,192,51.104592,0.16865700000000317,12142.988432143116,9107.241324107337
"244.3.160.204",45551,"244.3.160.254",80,7,448,4,256,3,192,51.104863,0.16929400000000072,12097.298191312104,9072.973643484078
"244.3.160.204",45552,"244.3.160.254",2784,2,128,1,64,1,64,51.105109,7.300000000043383e-5,0,0
"244.3.160.204",45553,"244.3.160.254",2785,2,128,1,64,1,64,51.105394,7.000000000090267e-5,0,0
"244.3.160.204",45554,"244.3.160.254",4000,7,448,4,256,3,192,51.105652,0.17233399999999932,11883.899868859355,8912.924901644516
"244.3.160.204",45555,"244.3.160.254",4001,2,128,1,64,1,64,51.105912000000004,6.49999999993156e-5,0,0
"244.3.160.204",45556,"244.3.160.239",443,7,448,4,256,3,192,51.10619,0.19693700000000547,10399.264739484928,7799.448554613696
"244.3.160.204",45557,"244.3.160.239",8080,2,128,1,64,1,64,51.106514,3.700000000605996e-5,0,0
"244.3.160.204",45558,"244.3.160.239",80,7,448,4,256,3,192,51.106758,0.17355400000000287,11800.361847033004,8850.271385274753
"244.3.160.204",45878,"244.3.160.89",2048,2,128,1,64,1,64,53.102565,8.700000000061436e-5,0,0
"244.3.160.204",45879,"244.3.160.89",80,7,448,4,256,3,192,53.10277,0.172226000000002,11891.352060664338,8918.514045498254
"244.3.160.204",45880,"244.3.160.89",443,13,3841,5,362,8,3479,53.102976,0.225560999999999,12839.098957709944,123390.12506594723
"244.3.160.204",45881,"244.3.160.89",2784,2,128,1,64,1,64,53.103213,6.900000000342743e-5,0,0
"244.3.160.204",45882,"244.3.160.89",2785,2,128,1,64,1,64,53.103521,0.0001279999999965753,0,0
"244.3.160.204",45883,"244.3.160.89",4000,2,128,1,64,1,64,53.103717,7.29999999933284e-5,0,0
"244.3.160.204",45884,"244.3.160.254",4002,2,128,1,64,1,64,53.103986,6.600000000389628e-5,0,0
"244.3.160.204",45885,"244.3.160.254",2048,2,128,1,64,1,64,53.104234,7.000000000090267e-5,0,0
"244.3.160.204",45886,"244.3.160.254",443,7,448,4,256,3,192,53.104544,0.1731630000000024,11827.0069241118,8870.25519308385
"244.3.160.204",45887,"244.3.160.254",80,7,448,4,256,3,192,53.104808,0.17436000000000007,11745.813259921995,8809.359944941496
"244.3.160.204",45888,"244.3.160.254",2784,2,128,1,64,1,64,53.105054,7.099999999837792e-5,0,0
"244.3.160.204",45889,"244.3.160.254",2785,2,128,1,64,1,64,53.105309,6.700000000137152e-5,0,0
"244.3.160.204",45890,"244.3.160.239",443,7,448,4,256,3,192,53.105605,0.2184220000000039,9376.344873684719,7032.2586552635385
"244.3.160.204",45891,"244.3.160.239",8080,2,128,1,64,1,64,53.105861,7.300000000043383e-5,0,0
"244.3.160.204",45892,"244.3.160.239",80,7,448,4,256,3,192,53.106124,0.17637700000000223,11611.49129421622,8708.618470662164
"244.3.160.204",46214,"244.3.160.89",4001,2,128,1,64,1,64,55.103096,8.59999999960337e-5,0,0
"244.3.160.204",46215,"244.3.160.89",4002,2,128,1,64,1,64,55.103346,8.100000000155205e-5,0,0
"244.3.160.204",46216,"244.3.160.89",2048,2,128,1,64,1,64,55.103573,6.0000000004833964e-5,0,0
"244.3.160.204",46217,"244.3.160.89",80,7,448,4,256,3,192,55.103829,0.16945000000000476,12086.16110947148,9064.62083210361
"244.3.160.204",46218,"244.3.160.89",443,13,3841,5,362,8,3479,55.104113,0.21626100000000292,13391.22634224368,128696.34376979494
"244.3.160.204",46219,"244.3.160.89",2784,2,128,1,64,1,64,55.104323,7.099999999837792e-5,0,0
"244.3.160.204",46220,"244.3.160.254",4000,7,448,4,256,3,192,55.104658,0.16944699999999813,12086.37509073647,9064.781318052352
"244.3.160.204",46221,"244.3.160.254",4001,2,128,1,64,1,64,55.10492,6.400000000184036e-5,0,0
"244.3.160.204",46222,"244.3.160.254",4002,2,128,1,64,1,64,55.105171,6.700000000137152e-5,0,0
"244.3.160.204",46223,"244.3.160.254",2048,2,128,1,64,1,64,55.105426,6.700000000137152e-5,0,0
"244.3.160.204",46224,"244.3.160.254",443,7,448,4,256,3,192,55.105687,0.17141299999999404,11947.751920799888,8960.813940599915
"244.3.160.204",46225,"244.3.160.254",80,7,448,4,256,3,192,55.105947,0.1716869999999986,11928.684175272541,8946.513131454407
"244.3.160.204",46226,"244.3.160.239",443,7,448,4,256,3,192,55.10623,0.19823300000000188,10331.276830800021,7748.457623100016
"244.3.160.204",46227,"244.3.160.239",8080,2,128,1,64,1,64,55.106478,7.099999999837792e-5,0,0
"244.3.160.204",46228,"244.3.160.239",80,7,448,4,256,3,192,55.106762,0.17275199999999558,11855.144947670953,8891.358710753215
"244.3.160.204",46545,"244.3.160.89",2785,2,128,1,64,1,64,57.103293,8.900000000267028e-5,0,0
"244.3.160.204",46546,"244.3.160.89",4000,2,128,1,64,1,64,57.103516,7.80000000020209e-5,0,0
"244.3.160.204",46547,"244.3.160.89",4001,2,128,1,64,1,64,57.103775,6.900000000342743e-5,0,0
"244.3.160.204",46548,"244.3.160.89",4002,2,128,1,64,1,64,57.10405,7.300000000043383e-5,0,0
"244.3.160.204",46549,"244.3.160.89",2048,2,128,1,64,1,64,57.104273,7.000000000090267e-5,0,0
"244.3.160.204",46550,"244.3.160.89",80,7,448,4,256,3,192,57.104563,0.1704030000000003,12018.567748220374,9013.92581116528
"244.3.160.204",46551,"244.3.160.254",2784,2,128,1,64,1,64,57.104905,4.899999999707916e-5,0,0
"244.3.160.204",46552,"244.3.160.254",2785,2,128,1,64,1,64,57.105138,7.100000000548334e-5,0,0
"244.3.160.204",46553,"244.3.160.254",4000,7,448,4,256,3,192,57.105389,0.17103999999999786,11973.807296538971,8980.355472404228
"244.3.160.204",46554,"244.3.160.254",4001,2,128,1,64,1,64,57.105641,7.40000000050145e-5,0,0
"244.3.160.204",46555,"244.3.160.254",4002,2,128,1,64,1,64,57.105927,7.099999999837792e-5,0,0
"244.3.160.204",46556,"244.3.160.254",2048,2,128,1,64,1,64,57.106185,7.599999999996498e-5,0,0
"244.3.160.204",46557,"244.3.160.239",443,7,448,4,256,3,192,57.106456,0.21391099999999597,9574.075199499037,7180.556399624278
"244.3.160.204",46558,"244.3.160.239",8080,2,128,1,64,1,64,57.106707,7.399999999790907e-5,0,0
"244.3.160.204",46559,"244.3.160.239",80,7,448,4,256,3,192,57.107011,0.1750469999999993,11699.714933703568,8774.786200277675
"244.3.160.204",46884,"244.3.160.89",443,13,3841,5,362,8,3479,59.103457,0.21387599999999907,13540.556210140514,130131.478052704
"244.3.160.204",46885,"244.3.160.89",2784,2,128,1,64,1,64,59.103723,8.19999999990273e-5,0,0
"244.3.160.204",46886,"244.3.160.89",2785,2,128,1,64,1,64,59.10398,7.000000000090267e-5,0,0
"244.3.160.204",46887,"244.3.160.89",4000,2,128,1,64,1,64,59.104249,6.799999999884676e-5,0,0
"244.3.160.204",46888,"244.3.160.89",4001,2,128,1,64,1,64,59.104498,7.699999999744023e-5,0,0
"244.3.160.204",46889,"244.3.160.89",4002,2,128,1,64,1,64,59.104794,7.099999999837792e-5,0,0
"244.3.160.204",46890,"244.3.160.254",443,7,448,4,256,3,192,59.105122,0.16846499999999764,12156.827827738869,9117.620870804152
"244.3.160.204",46891,"244.3.160.254",80,7,448,4,256,3,192,59.105356,0.16880599999999646,12132.27017997016,9099.20263497762
"244.3.160.204",46892,"244.3.160.254",2784,2,128,1,64,1,64,59.105631,5.9000000000253294e-5,0,0
"244.3.160.204",46893,"244.3.160.254",2785,2,128,1,64,1,64,59.105886,8.000000000407681e-5,0,0
"244.3.160.204",46894,"244.3.160.254",4000,7,448,4,256,3,192,59.106188,0.16915799999999592,12107.02420222543,9080.268151669074
"244.3.160.204",46895,"244.3.160.254",4001,2,128,1,64,1,64,59.106437,6.700000000137152e-5,0,0
"244.3.160.204",46896,"244.3.160.239",443,7,448,4,256,3,192,59.106766,0.20076699999999903,10200.879626631917,7650.659719973937
"244.3.160.204",46897,"244.3.160.239",8080,2,128,1,64,1,64,59.107023,7.700000000454565e-5,0,0
"244.3.160.204",46898,"244.3.160.239",80,7,448,4,256,3,192,59.107302,0.17181100000000527,11920.074966096101,8940.056224572076
"244.3.160.204",47215,"244.3.160.89",2048,2,128,1,64,1,64,61.104083,8.099999999444663e-5,0,0
"244.3.160.204",47216,"244.3.160.89",80,7,448,4,256,3,192,61.104417,0.16735200000000106,12237.678665328094,9178.25899899607
"244.3.160.204",47217,"244.3.160.89",443,13,3841,5,362,8,3479,61.104621,0.21535699999999736,13447.438439428648,129236.56997450904
"244.3.160.204",47218,"244.3.160.89",2784,2,128,1,64,1,64,61.104876,7.000000000090267e-5,0,0
"244.3.160.204",47219,"244.3.160.89",2785,2,128,1,64,1,64,61.105155,6.699999999426609e-5,0,0
"244.3.160.204",47220,"244.3.160.89",4000,2,128,1,64,1,64,61.105404,7.200000000295859e-5,0,0
"244.3.160.204",47221,"244.3.160.254",4002,2,128,1,64,1,64,61.105683,7.000000000090267e-5,0,0
"244.3.160.204",47222,"244.3.160.254",2048,2,128,1,64,1,64,61.105936,6.700000000137152e-5,0,0
"244.3.160.204",47223,"244.3.160.254",443,7,448,4,256,3,192,61.106229,0.16790699999999958,12197.228227530746,9147.92117064806
"244.3.160.204",47224,"244.3.160.254",80,7,448,4,256,3,192,61.106483,0.16888600000000054,12126.52321684446,9094.892412633346
"244.3.160.204",47225,"244.3.160.254",2784,2,128,1,64,1,64,61.106757,6.700000000137152e-5,0,0
"244.3.160.204",47226,"244.3.160.254",2785,2,128,1,64,1,64,61.106996,7.099999999837792e-5,0,0
"244.3.160.204",47227,"244.3.160.239",443,7,448,4,256,3,192,61.1073,0.2225779999999986,9201.268768701366,6900.951576526025
"244.3.160.204",47228,"244.3.160.239",8080,2,128,1,64,1,64,61.107557,7.200000000295859e-5,0,0
"244.3.160.204",47229,"244.3.160.239",80,7,448,4,256,3,192,61.107818,0.17174699999999632,11924.516876568696,8943.387657426521
"244.3.160.204",47549,"244.3.160.89",4001,2,128,1,64,1,64,63.103767,8.600000000313912e-5,0,0
"244.3.160.204",47550,"244.3.160.89",4002,2,128,1,64,1,64,63.104012,6.800000000595219e-5,0,0
"244.3.160.204",47551,"244.3.160.89",2048,2,128,1,64,1,64,63.104285,6.900000000342743e-5,0,0
"244.3.160.204",47552,"244.3.160.89",80,7,448,4,256,3,192,63.104575,0.20819100000000645,9837.120720876197,7377.840540657148
"244.3.160.204",47553,"244.3.160.89",443,13,3841,5,362,8,3479,63.104831,0.2679240000000007,10809.03539809794,103880.20483420644
"244.3.160.204",47554,"244.3.160.89",2784,2,128,1,64,1,64,63.105077,7.300000000043383e-5,0,0
"244.3.160.204",47555,"244.3.160.254",4000,7,448,4,256,3,192,63.105377,0.20862900000000195,9816.468467950193,7362.351350962645
"244.3.160.204",47556,"244.3.160.254",4001,2,128,1,64,1,64,63.10563,7.000000000090267e-5,0,0
"244.3.160.204",47557,"244.3.160.254",4002,2,128,1,64,1,64,63.105898,6.199999999978445e-5,0,0
"244.3.160.204",47558,"244.3.160.254",2048,2,128,1,64,1,64,63.106145,6.199999999978445e-5,0,0
"244.3.160.204",47559,"244.3.160.254",443,7,448,4,256,3,192,63.106431,0.2133320000000012,9600.06000037495,7200.045000281211
"244.3.160.204",47560,"244.3.160.254",80,7,448,4,256,3,192,63.106689,0.21339099999999434,9597.40570127163,7198.054275953722
"244.3.160.204",47561,"244.3.160.239",443,7,448,4,256,3,192,63.106961,0.2541170000000008,8059.27978057349,6044.459835430117
"244.3.160.204",47562,"244.3.160.239",8080,2,128,1,64,1,64,63.107223,7.700000000454565e-5,0,0
"244.3.160.204",47563,"244.3.160.239",80,7,448,4,256,3,192,63.107517,0.21369999999999578,9583.528310716147,7187.64623303711
"244.3.160.204",47885,"244.3.160.89",2785,2,128,1,64,1,64,65.103905,8.900000000267028e-5,0,0
"244.3.160.204",47886,"244.3.160.89",4000,2,128,1,64,1,64,65.104147,7.399999999790907e-5,0,0
"244.3.160.204",47887,"244.3.160.89",4001,2,128,1,64,1,64,65.104484,7.200000000295859e-5,0,0
"244.3.160.204",47888,"244.3.160.89",4002,2,128,1,64,1,64,65.104814,6.999999999379725e-5,0,0
"244.3.160.204",47889,"244.3.160.89",2048,2,128,1,64,1,64,65.104943,7.199999998874773e-5,0,0
"244.3.160.204",47890,"244.3.160.89",80,7,448,4,256,3,192,65.105195,0.16208800000001133,12635.111791124924,9476.333843343693
"244.3.160.204",47891,"244.3.160.254",2784,2,128,1,64,1,64,65.105499,7.600000000707041e-5,0,0
"244.3.160.204",47892,"244.3.160.254",2785,2,128,1,64,1,64,65.105764,7.00000000080081e-5,0,0
"244.3.160.204",47893,"244.3.160.254",4000,7,448,4,256,3,192,65.106015,0.16321700000000305,12547.712554451813,9410.78441583886
"244.3.160.204",47894,"244.3.160.254",4001,2,128,1,64,1,64,65.10627,6.799999999884676e-5,0,0
"244.3.160.204",47895,"244.3.160.254",4002,2,128,1,64,1,64,65.106552,7.00000000080081e-5,0,0
"244.3.160.204",47896,"244.3.160.254",2048,2,128,1,64,1,64,65.106809,6.8999999996322e-5,0,0
"244.3.160.204",47897,"244.3.160.239",443,7,448,4,256,3,192,65.107083,0.18850600000000384,10864.375669739735,8148.281752304801
"244.3.160.204",47898,"244.3.160.239",8080,2,128,1,64,1,64,65.107345,7.399999999790907e-5,0,0
"244.3.160.204",47899,"244.3.160.239",80,7,448,4,256,3,192,65.107627,0.16384200000000249,12499.847413971807,9374.885560478855
"244.3.160.204",48216,"244.3.160.89",443,13,3841,5,362,8,3479,67.104096,0.2250580000000042,12867.794079748091,123665.89945702655
"244.3.160.204",48217,"244.3.160.89",2784,2,128,1,64,1,64,67.104334,7.400000001211993e-5,0,0
"244.3.160.204",48218,"244.3.160.89",2785,2,128,1,64,1,64,67.104635,7.099999999127249e-5,0,0
"244.3.160.204",48219,"244.3.160.89",4000,2,128,1,64,1,64,67.104956,6.999999999379725e-5,0,0
"244.3.160.204",48220,"244.3.160.89",4001,2,128,1,64,1,64,67.105156,7.200000000295859e-5,0,0
"244.3.160.204",48221,"244.3.160.89",4002,2,128,1,64,1,64,67.105401,6.999999999379725e-5,0,0
"244.3.160.204",48222,"244.3.160.254",443,7,448,4,256,3,192,67.105674,0.1731280000000055,11829.39790212984,8872.04842659738
"244.3.160.204",48223,"244.3.160.254",80,7,448,4,256,3,192,67.10594,0.1735219999999913,11802.538006708675,8851.903505031507
"244.3.160.204",48224,"244.3.160.254",2784,2,128,1,64,1,64,67.106195,6.8999999996322e-5,0,0
"244.3.160.204",48225,"244.3.160.254",2785,2,128,1,64,1,64,67.106451,6.699999998716066e-5,0,0
"244.3.160.204",48226,"244.3.160.254",4000,7,448,4,256,3,192,67.106759,0.1744989999999973,11736.456942446843,8802.342706835132
"244.3.160.204",48227,"244.3.160.254",4001,2,128,1,64,1,64,67.107001,7.300000000043383e-5,0,0
"244.3.160.204",48228,"244.3.160.239",443,7,448,4,256,3,192,67.107261,0.23168200000000638,8839.702695936428,6629.777021952321
"244.3.160.204",48229,"244.3.160.239",8080,2,128,1,64,1,64,67.107515,7.199999998874773e-5,0,0
"244.3.160.204",48230,"244.3.160.239",80,7,448,4,256,3,192,67.1078,0.1766319999999979,11594.728022102589,8696.046016576942
"244.3.160.204",48555,"244.3.160.89",2048,2,128,1,64,1,64,69.104029,7.999999999697138e-5,0,0
"244.3.160.204",48556,"244.3.160.89",80,7,448,4,256,3,192,69.104307,0.17067099999999868,11999.695320236102,8999.771490177076
"244.3.160.204",48557,"244.3.160.89",443,13,3841,5,362,8,3479,69.104551,0.21966899999999612,13183.471495750657,126699.71639148214
"244.3.160.204",48558,"244.3.160.89",2784,2,128,1,64,1,64,69.104868,7.700000000454565e-5,0,0
"244.3.160.204",48559,"244.3.160.89",2785,2,128,1,64,1,64,69.105086,6.700000000137152e-5,0,0
"244.3.160.204",48560,"244.3.160.89",4000,2,128,1,64,1,64,69.105333,7.599999999285956e-5,0,0
"244.3.160.204",48561,"244.3.160.254",4002,2,128,1,64,1,64,69.105613,7.499999999538431e-5,0,0
"244.3.160.204",48562,"244.3.160.254",2048,2,128,1,64,1,64,69.10591,9.900000000584441e-5,0,0
"244.3.160.204",48563,"244.3.160.254",443,7,448,4,256,3,192,69.106163,0.1706840000000085,11998.781373766129,8999.086030324597
"244.3.160.204",48564,"244.3.160.254",80,7,448,4,256,3,192,69.106422,0.1710390000000075,11973.87730283684,8980.40797712763
"244.3.160.204",48565,"244.3.160.254",2784,2,128,1,64,1,64,69.106673,7.300000000043383e-5,0,0
"244.3.160.204",48566,"244.3.160.254",2785,2,128,1,64,1,64,69.106958,7.199999998874773e-5,0,0
"244.3.160.204",48567,"244.3.160.239",443,7,448,4,256,3,192,69.107234,0.2205849999999998,9284.402837908297,6963.302128431223
"244.3.160.204",48568,"244.3.160.239",8080,2,128,1,64,1,64,69.107495,6.999999999379725e-5,0,0
"244.3.160.204",48569,"244.3.160.239",80,7,448,4,256,3,192,69.107774,0.17411199999999383,11762.543650064743,8821.907737548558
"244.3.160.204",48886,"244.3.160.89",4001,2,128,1,64,1,64,71.105331,8.699999999350894e-5,0,0
"244.3.160.204",48887,"244.3.160.89",4002,2,128,1,64,1,64,71.105617,8.000000001118224e-5,0,0
"244.3.160.204",48888,"244.3.160.89",2048,2,128,1,64,1,64,71.105848,8.700000000771979e-5,0,0
"244.3.160.204",48889,"244.3.160.89",80,7,448,4,256,3,192,71.106125,0.17143599999999992,11946.149000209996,8959.611750157497
"244.3.160.204",48890,"244.3.160.89",443,13,3841,5,362,8,3479,71.106381,0.22050000000000125,13133.786848072488,126222.2222222215
"244.3.160.204",48891,"244.3.160.89",2784,2,128,1,64,1,64,71.106621,8.199999999192187e-5,0,0
"244.3.160.204",48892,"244.3.160.254",4000,7,448,4,256,3,192,71.106922,0.1721080000000086,11899.50496200001,8924.628721500008
"244.3.160.204",48893,"244.3.160.254",4001,2,128,1,64,1,64,71.10726,7.600000000707041e-5,0,0
"244.3.160.204",48894,"244.3.160.254",4002,2,128,1,64,1,64,71.107521,7.099999999127249e-5,0,0
"244.3.160.204",48895,"244.3.160.254",2048,2,128,1,64,1,64,71.107706,6.500000000642103e-5,0,0
"244.3.160.204",48896,"244.3.160.254",443,7,448,4,256,3,192,71.10799,0.17318199999999706,11825.709369334196,8869.282027000647
"244.3.160.204",48897,"244.3.160.254",80,7,448,4,256,3,192,71.108265,0.1735829999999936,11798.390395373253,8848.79279652994
"244.3.160.204",48898,"244.3.160.239",443,7,448,4,256,3,192,71.108533,0.21118800000000704,9697.520692463264,7273.1405193474475
"244.3.160.204",48899,"244.3.160.239",8080,2,128,1,64,1,64,71.10879,6.700000000137152e-5,0,0
"244.3.160.204",48900,"244.3.160.239",80,7,448,4,256,3,192,71.109099,0.17475100000000054,11719.532363191018,8789.649272393264
"244.3.160.204",49220,"244.3.160.89",2785,2,128,1,64,1,64,73.104902,0.00010199999999827014,0,0
"244.3.160.204",49221,"244.3.160.89",4000,2,128,1,64,1,64,73.10517,7.300000000043383e-5,0,0
"244.3.160.204",49222,"244.3.160.89",4001,2,128,1,64,1,64,73.105412,6.799999999884676e-5,0,0
"244.3.160.204",49223,"244.3.160.89",4002,2,128,1,64,1,64,73.105659,6.299999999725969e-5,0,0
"244.3.160.204",49224,"244.3.160.89",2048,2,128,1,64,1,64,73.105911,6.8999999996322e-5,0,0
"244.3.160.204",49225,"244.3.160.89",80,7,448,4,256,3,192,73.106191,0.17002600000000712,12045.21661392913,9033.912460446847
"244.3.160.204",49226,"244.3.160.254",2784,2,128,1,64,1,64,73.106468,7.399999999790907e-5,0,0
"244.3.160.204",49227,"244.3.160.254",2785,2,128,1,64,1,64,73.106725,6.8999999996322e-5,0,0
"244.3.160.204",49228,"244.3.160.254",4000,7,448,4,256,3,192,73.106974,0.17019100000000265,12033.538788772426,9025.154091579321
"244.3.160.204",49229,"244.3.160.254",4001,2,128,1,64,1,64,73.107258,7.300000000043383e-5,0,0
"244.3.160.204",49230,"244.3.160.254",4002,2,128,1,64,1,64,73.107518,6.799999999884676e-5,0,0
"244.3.160.204",49231,"244.3.160.254",2048,2,128,1,64,1,64,73.107783,6.799999999884676e-5,0,0
"244.3.160.204",49232,"244.3.160.239",443,7,448,4,256,3,192,73.10807,0.1998530000000045,10247.53193597271,7685.648951979532
"244.3.160.204",49233,"244.3.160.239",8080,2,128,1,64,1,64,73.108342,7.00000000080081e-5,0,0
"244.3.160.204",49234,"244.3.160.239",80,7,448,4,256,3,192,73.10861,0.1714330000000075,11946.358052416457,8959.768539312343
"244.3.160.204",49556,"244.3.160.89",443,13,3841,5,362,8,3479,75.105112,0.21402899999999647,13530.876656901857,130038.452733043
"244.3.160.204",49557,"244.3.160.89",2784,2,128,1,64,1,64,75.10537,8.300000000360797e-5,0,0
"244.3.160.204",49558,"244.3.160.89",2785,2,128,1,64,1,64,75.105618,0.000598999999994021,0,0
"244.3.160.204",49559,"244.3.160.89",4000,2,128,1,64,1,64,75.105875,0.00034600000000750697,0,0
"244.3.160.204",49560,"244.3.160.89",4001,2,128,1,64,1,64,75.10614,8.600000001024455e-5,0,0
"244.3.160.204",49561,"244.3.160.89",4002,2,128,1,64,1,64,75.106422,6.799999999884676e-5,0,0
"244.3.160.204",49562,"244.3.160.254",443,7,448,4,256,3,192,75.106684,0.17733099999999524,11549.024141295402,8661.768105971552
"244.3.160.204",49563,"244.3.160.254",80,7,448,4,256,3,192,75.106957,0.17788200000001098,11513.25035697751,8634.937767733134
"244.3.160.204",49564,"244.3.160.254",2784,2,128,1,64,1,64,75.107248,7.100000000548334e-5,0,0
"244.3.160.204",49565,"244.3.160.254",2785,2,128,1,64,1,64,75.107487,6.799999999884676e-5,0,0
"244.3.160.204",49566,"244.3.160.254",4000,7,448,4,256,3,192,75.107852,0.17815099999999973,11495.865866596332,8621.89939994725
"244.3.160.204",49567,"244.3.160.254",4001,2,128,1,64,1,64,75.108036,0.0016099999999994452,0,0
"244.3.160.204",49568,"244.3.160.239",443,7,448,4,256,3,192,75.108314,0.22094300000000544,9269.359065460094,6952.019299095071
"244.3.160.204",49569,"244.3.160.239",8080,2,128,1,64,1,64,75.108579,0.0011449999999939564,0,0
"244.3.160.204",49570,"244.3.160.239",80,7,448,4,256,3,192,75.108835,0.1764919999999961,11603.925390386223,8702.944042789668
"244.3.160.204",49887,"244.3.160.89",2048,2,128,1,64,1,64,77.104713,0.00011399999999639476,0,0
"244.3.160.204",49888,"244.3.160.89",80,7,448,4,256,3,192,77.104942,0.17169000000001233,11928.475741160539,8946.356805870404
"244.3.160.204",49889,"244.3.160.89",443,13,3841,5,362,8,3479,77.105194,0.2221890000000002,13033.948575311997,125262.72677765315
"244.3.160.204",49890,"244.3.160.89",2784,2,128,1,64,1,64,77.105455,7.599999999285956e-5,0,0
"244.3.160.204",49891,"244.3.160.89",2785,2,128,1,64,1,64,77.105706,7.00000000080081e-5,0,0
"244.3.160.204",49892,"244.3.160.89",4000,2,128,1,64,1,64,77.105942,7.700000000454565e-5,0,0
"244.3.160.204",49893,"244.3.160.254",4002,2,128,1,64,1,64,77.106213,7.399999999790907e-5,0,0
"244.3.160.204",49894,"244.3.160.254",2048,2,128,1,64,1,64,77.106486,6.8999999996322e-5,0,0
"244.3.160.204",49895,"244.3.160.254",443,7,448,4,256,3,192,77.106743,0.17255700000001184,11868.541989023102,8901.406491767328
"244.3.160.204",49896,"244.3.160.254",80,7,448,4,256,3,192,77.107002,0.17395900000001063,11772.889014077311,8829.666760557982
"244.3.160.204",49897,"244.3.160.254",2784,2,128,1,64,1,64,77.107256,7.399999999790907e-5,0,0
"244.3.160.204",49898,"244.3.160.254",2785,2,128,1,64,1,64,77.10758,4.400000000259752e-5,0,0
"244.3.160.204",49899,"244.3.160.239",443,7,448,4,256,3,192,77.107809,0.21933500000000095,9337.315065994899,7002.986299496174
"244.3.160.204",49900,"244.3.160.239",8080,2,128,1,64,1,64,77.108064,7.100000000548334e-5,0,0
"244.3.160.204",49901,"244.3.160.239",80,7,448,4,256,3,192,77.108315,0.1746569999999963,11725.839788843525,8794.379841632644
"244.3.160.204",50226,"244.3.160.89",4001,2,128,1,64,1,64,79.105307,0.00010000000000331966,0,0
"244.3.160.204",50227,"244.3.160.89",4002,2,128,1,64,1,64,79.105571,0.00029000000000678483,0,0
"244.3.160.204",50228,"244.3.160.89",2048,2,128,1,64,1,64,79.105825,7.300000000043383e-5,0,0
"244.3.160.204",50229,"244.3.160.89",80,7,448,4,256,3,192,79.10608,0.17002999999999702,12044.933247074257,9033.699935305693
"244.3.160.204",50230,"244.3.160.89",443,13,3841,5,362,8,3479,79.106341,0.22068099999999902,13123.014668231579,126118.69621761785
"244.3.160.204",50231,"244.3.160.89",2784,2,128,1,64,1,64,79.106622,7.80000000020209e-5,0,0
"244.3.160.204",50232,"244.3.160.254",4000,7,448,4,256,3,192,79.106908,0.17117199999999855,11964.57364522245,8973.430233916839
"244.3.160.204",50233,"244.3.160.254",4001,2,128,1,64,1,64,79.107162,0.00027799999999444935,0,0
"244.3.160.204",50234,"244.3.160.254",4002,2,128,1,64,1,64,79.1074,7.600000000707041e-5,0,0
"244.3.160.204",50235,"244.3.160.254",2048,2,128,1,64,1,64,79.107676,0.00012700000000620548,0,0
"244.3.160.204",50236,"244.3.160.254",443,7,448,4,256,3,192,79.107939,0.17239800000000116,11879.488161115478,8909.616120836608
"244.3.160.204",50237,"244.3.160.254",80,7,448,4,256,3,192,79.108196,0.1731709999999964,11826.460550554322,8869.845412915742
"244.3.160.204",50238,"244.3.160.239",443,7,448,4,256,3,192,79.108474,0.20654500000000553,9915.514778861483,7436.636084146113
"244.3.160.204",50239,"244.3.160.239",8080,2,128,1,64,1,64,79.108759,6.799999999884676e-5,0,0
"244.3.160.204",50240,"244.3.160.239",80,7,448,4,256,3,192,79.109036,0.174476999999996,11737.93680542448,8803.45260406836
"244.3.160.204",50557,"244.3.160.89",2785,2,128,1,64,1,64,81.105581,0.00010000000000331966,0,0
"244.3.160.204",50558,"244.3.160.89",4000,2,128,1,64,1,64,81.105858,7.700000000454565e-5,0,0
"244.3.160.204",50559,"244.3.160.89",4001,2,128,1,64,1,64,81.106107,6.700000000137152e-5,0,0
"244.3.160.204",50560,"244.3.160.89",4002,2,128,1,64,1,64,81.106339,6.8999999996322e-5,0,0
"244.3.160.204",50561,"244.3.160.89",2048,2,128,1,64,1,64,81.106593,6.299999999725969e-5,0,0
"244.3.160.204",50562,"244.3.160.89",80,7,448,4,256,3,192,81.106887,0.1649319999999932,12417.238619552812,9312.92896466461
"244.3.160.204",50563,"244.3.160.254",2784,2,128,1,64,1,64,81.107147,7.899999999949614e-5,0,0
"244.3.160.204",50564,"244.3.160.254",2785,2,128,1,64,1,64,81.10742,5.699999999819738e-5,0,0
"244.3.160.204",50565,"244.3.160.254",4000,7,448,4,256,3,192,81.107656,0.16714199999999835,12253.054289167416,9189.790716875563
"244.3.160.204",50566,"244.3.160.254",4001,2,128,1,64,1,64,81.107939,6.799999999884676e-5,0,0
"244.3.160.204",50567,"244.3.160.254",4002,2,128,1,64,1,64,81.108195,6.199999999978445e-5,0,0
"244.3.160.204",50568,"244.3.160.254",2048,2,128,1,64,1,64,81.108465,6.100000000230921e-5,0,0
"244.3.160.204",50569,"244.3.160.239",443,7,448,4,256,3,192,81.10875,0.21407700000000318,9566.6512516523,7174.988438739226
"244.3.160.204",50570,"244.3.160.239",8080,2,128,1,64,1,64,81.109025,7.399999999790907e-5,0,0
"244.3.160.204",50571,"244.3.160.239",80,7,448,4,256,3,192,81.109286,0.16820099999999627,12175.908585561592,9131.931439171194
"244.3.160.204",50891,"244.3.160.89",443,13,3841,5,362,8,3479,83.105041,0.2243079999999935,12910.819052374787,124079.3908376019
"244.3.160.204",50892,"244.3.160.89",2784,2,128,1,64,1,64,83.10529,8.700000000771979e-5,0,0
"244.3.160.204",50893,"244.3.160.89",2785,2,128,1,64,1,64,83.105512,6.599999998968542e-5,0,0
"244.3.160.204",50894,"244.3.160.89",4000,2,128,1,64,1,64,83.10579,7.899999999949614e-5,0,0
"244.3.160.204",50895,"244.3.160.89",4001,2,128,1,64,1,64,83.106014,6.8999999996322e-5,0,0
"244.3.160.204",50896,"244.3.160.89",4002,2,128,1,64,1,64,83.106284,6.199999999978445e-5,0,0
"244.3.160.204",50897,"244.3.160.254",443,7,448,4,256,3,192,83.106588,0.17253699999999128,11869.91775677161,8902.438317578708
"244.3.160.204",50898,"244.3.160.254",80,7,448,4,256,3,192,83.106799,0.17327800000001048,11819.157654173503,8864.368240630127
"244.3.160.204",50899,"244.3.160.254",2784,2,128,1,64,1,64,83.107067,7.200000000295859e-5,0,0
"244.3.160.204",50900,"244.3.160.254",2785,2,128,1,64,1,64,83.107323,7.300000000043383e-5,0,0
"244.3.160.204",50901,"244.3.160.254",4000,7,448,4,256,3,192,83.107575,0.1741489999999999,11760.044559543847,8820.033419657884
"244.3.160.204",50902,"244.3.160.254",4001,2,128,1,64,1,64,83.107821,7.200000000295859e-5,0,0
"244.3.160.204",50903,"244.3.160.239",443,7,448,4,256,3,192,83.108116,0.18133000000000266,11294.32526333188,8470.743947498911
"244.3.160.204",50904,"244.3.160.239",8080,2,128,1,64,1,64,83.108367,8.099999999444663e-5,0,0
"244.3.160.204",50905,"244.3.160.239",80,7,448,4,256,3,192,83.108653,0.17544199999998966,11673.373536554078,8755.030152415558
"244.3.160.204",51227,"244.3.160.89",2048,2,128,1,64,1,64,85.105423,8.59999999960337e-5,0,0
"244.3.160.204",51228,"244.3.160.89",80,7,448,4,256,3,192,85.105667,0.16701600000000383,12262.298222924468,9196.723667193352
"244.3.160.204",51229,"244.3.160.89",443,13,3841,5,362,8,3479,85.105961,0.21058900000001302,13751.90537017518,132162.6485713797
"244.3.160.204",51230,"244.3.160.89",2784,2,128,1,64,1,64,85.10618,6.799999999884676e-5,0,0
"244.3.160.204",51231,"244.3.160.89",2785,2,128,1,64,1,64,85.10647,6.499999999221018e-5,0,0
"244.3.160.204",51232,"244.3.160.89",4000,2,128,1,64,1,64,85.106674,7.300000000043383e-5,0,0
"244.3.160.204",51233,"244.3.160.254",4002,2,128,1,64,1,64,85.106954,9.1999999995096e-5,0,0
"244.3.160.204",51234,"244.3.160.254",2048,2,128,1,64,1,64,85.10724,5.7999999995672624e-5,0,0
"244.3.160.204",51235,"244.3.160.254",443,7,448,4,256,3,192,85.107505,0.17675799999999242,11586.46284750952,8689.84713563214
"244.3.160.204",51236,"244.3.160.254",80,7,448,4,256,3,192,85.107743,0.17720500000000072,11557.235969639636,8667.926977229727
"244.3.160.204",51237,"244.3.160.254",2784,2,128,1,64,1,64,85.107995,7.200000000295859e-5,0,0
"244.3.160.204",51238,"244.3.160.254",2785,2,128,1,64,1,64,85.108275,6.499999999221018e-5,0,0
"244.3.160.204",51239,"244.3.160.239",443,7,448,4,256,3,192,85.108544,0.20205300000000648,10135.954427798322,7601.965820848742
"244.3.160.204",51240,"244.3.160.239",8080,2,128,1,64,1,64,85.10881,8.59999999960337e-5,0,0
"244.3.160.204",51241,"244.3.160.239",80,7,448,4,256,3,192,85.109077,0.17888899999999808,11448.440094136711,8586.330070602533
"244.3.160.204",51558,"244.3.160.89",4001,2,128,1,64,1,64,87.105376,8.099999999444663e-5,0,0
"244.3.160.204",51559,"244.3.160.89",4002,2,128,1,64,1,64,87.105614,6.8999999996322e-5,0,0
"244.3.160.204",51560,"244.3.160.89",2048,2,128,1,64,1,64,87.105852,7.100000000548334e-5,0,0
"244.3.160.204",51561,"244.3.160.89",80,7,448,4,256,3,192,87.106104,0.17624800000000107,11619.99001407101,8714.992510553258
"244.3.160.204",51562,"244.3.160.89",443,13,3841,5,362,8,3479,87.106377,0.2264820000000043,12786.888141220694,122888.35315830605
"244.3.160.204",51563,"244.3.160.89",2784,2,128,1,64,1,64,87.106624,8.600000001024455e-5,0,0
"244.3.160.204",51564,"244.3.160.254",4000,7,448,4,256,3,192,87.106893,0.1765010000000018,11603.333692160266,8702.500269120199
"244.3.160.204",51565,"244.3.160.254",4001,2,128,1,64,1,64,87.107186,7.700000000454565e-5,0,0
"244.3.160.204",51566,"244.3.160.254",4002,2,128,1,64,1,64,87.10743,7.200000000295859e-5,0,0
"244.3.160.204",51567,"244.3.160.254",2048,2,128,1,64,1,64,87.107683,6.700000000137152e-5,0,0
"244.3.160.204",51568,"244.3.160.254",443,7,448,4,256,3,192,87.107928,0.17906700000000342,11437.059871444548,8577.794903583412
"244.3.160.204",51569,"244.3.160.254",80,7,448,4,256,3,192,87.108226,0.17950199999999938,11409.343628483288,8557.007721362466
"244.3.160.204",51570,"244.3.160.239",443,7,448,4,256,3,192,87.108484,0.1856509999999929,11031.451486930198,8273.588615197648
"244.3.160.204",51571,"244.3.160.239",8080,2,128,1,64,1,64,87.108746,6.600000000389628e-5,0,0
"244.3.160.204",51572,"244.3.160.239",80,7,448,4,256,3,192,87.108999,0.18004299999999773,11375.060402237386,8531.29530167804
"244.3.160.204",51897,"244.3.160.89",2785,2,128,1,64,1,64,89.106403,0.0001010000000007949,0,0
"244.3.160.204",51898,"244.3.160.89",4000,2,128,1,64,1,64,89.106651,7.200000000295859e-5,0,0
"244.3.160.204",51899,"244.3.160.89",4001,2,128,1,64,1,64,89.106915,6.8999999996322e-5,0,0
"244.3.160.204",51900,"244.3.160.89",4002,2,128,1,64,1,64,89.107155,6.8999999996322e-5,0,0
"244.3.160.204",51901,"244.3.160.89",2048,2,128,1,64,1,64,89.107415,6.499999999221018e-5,0,0
"244.3.160.204",51902,"244.3.160.89",80,7,448,4,256,3,192,89.107671,0.19195299999999804,10669.278417112631,8001.958812834473
"244.3.160.204",51903,"244.3.160.254",2784,2,128,1,64,1,64,89.107947,7.100000000548334e-5,0,0
"244.3.160.204",51904,"244.3.160.254",2785,2,128,1,64,1,64,89.108203,6.600000000389628e-5,0,0
"244.3.160.204",51905,"244.3.160.254",4000,7,448,4,256,3,192,89.108499,0.197102000000001,10390.559202849234,7792.919402136925
"244.3.160.204",51906,"244.3.160.254",4001,2,128,1,64,1,64,89.108752,7.00000000080081e-5,0,0
"244.3.160.204",51907,"244.3.160.254",4002,2,128,1,64,1,64,89.109009,6.8999999996322e-5,0,0
"244.3.160.204",51908,"244.3.160.254",2048,2,128,1,64,1,64,89.109271,6.699999998716066e-5,0,0
"244.3.160.204",51909,"244.3.160.239",443,7,448,4,256,3,192,89.109604,0.24792499999999507,8260.562670162511,6195.422002621884
"244.3.160.204",51910,"244.3.160.239",8080,2,128,1,64,1,64,89.109831,6.700000000137152e-5,0,0
"244.3.160.204",51911,"244.3.160.239",80,7,448,4,256,3,192,89.110105,0.1992039999999946,10280.918053854619,7710.688540390964
"244.3.160.204",52228,"244.3.160.89",443,13,3841,5,362,8,3479,91.106885,0.3338099999999997,8675.593900721975,83376.77121715953
"244.3.160.204",52229,"244.3.160.89",2784,2,128,1,64,1,64,91.107136,7.700000000454565e-5,0,0
"244.3.160.204",52230,"244.3.160.89",2785,2,128,1,64,1,64,91.107378,6.8999999996322e-5,0,0
"244.3.160.204",52231,"244.3.160.89",4000,2,128,1,64,1,64,91.107652,0.00011800000000050659,0,0
"244.3.160.204",52232,"244.3.160.89",4001,2,128,1,64,1,64,91.107911,6.600000000389628e-5,0,0
"244.3.160.204",52233,"244.3.160.89",4002,2,128,1,64,1,64,91.10816,6.500000000642103e-5,0,0
"244.3.160.204",52234,"244.3.160.254",443,7,448,4,256,3,192,91.108433,0.28921899999998857,7081.139205930734,5310.85440444805
"244.3.160.204",52235,"244.3.160.254",80,7,448,4,256,3,192,91.108728,0.2896259999999984,7071.188360161074,5303.391270120806
"244.3.160.204",52236,"244.3.160.254",2784,2,128,1,64,1,64,91.108983,7.100000000548334e-5,0,0
"244.3.160.204",52237,"244.3.160.254",2785,2,128,1,64,1,64,91.109248,6.600000000389628e-5,0,0
"244.3.160.204",52238,"244.3.160.254",4000,7,448,4,256,3,192,91.109544,0.2901999999999987,7057.201929703685,5292.9014472777635
"244.3.160.204",52239,"244.3.160.254",4001,2,128,1,64,1,64,91.109813,6.8999999996322e-5,0,0
"244.3.160.204",52240,"244.3.160.239",443,7,448,4,256,3,192,91.110067,0.3234819999999985,6331.109613517938,4748.332210138453
"244.3.160.204",52241,"244.3.160.239",8080,2,128,1,64,1,64,91.110324,6.8999999996322e-5,0,0
"244.3.160.204",52242,"244.3.160.239",80,7,448,4,256,3,192,91.11061,0.2923710000000028,7004.798697545175,5253.599023158881
"244.3.160.204",52562,"244.3.160.89",2048,2,128,1,64,1,64,93.106441,7.999999999697138e-5,0,0
"244.3.160.204",52563,"244.3.160.89",80,7,448,4,256,3,192,93.106679,0.17685000000000173,11580.435397229177,8685.326547921883
"244.3.160.204",52564,"244.3.160.89",443,13,3841,5,362,8,3479,93.106956,0.22867899999999963,12664.039986181524,121707.72130366166
"244.3.160.204",52565,"244.3.160.89",2784,2,128,1,64,1,64,93.107209,6.8999999996322e-5,0,0
"244.3.160.204",52566,"244.3.160.89",2785,2,128,1,64,1,64,93.107454,8.900000000267028e-5,0,0
"244.3.160.204",52567,"244.3.160.89",4000,2,128,1,64,1,64,93.107772,7.399999999790907e-5,0,0
"244.3.160.204",52568,"244.3.160.254",4002,2,128,1,64,1,64,93.107994,7.300000000043383e-5,0,0
"244.3.160.204",52569,"244.3.160.254",2048,2,128,1,64,1,64,93.108234,6.900000001053286e-5,0,0
"244.3.160.204",52570,"244.3.160.254",443,7,448,4,256,3,192,93.108538,0.1777930000000083,11519.013684452731,8639.260263339547
"244.3.160.204",52571,"244.3.160.254",80,7,448,4,256,3,192,93.108788,0.17852800000000002,11471.589890661407,8603.692417996055
"244.3.160.204",52572,"244.3.160.254",2784,2,128,1,64,1,64,93.10906,7.499999999538431e-5,0,0
"244.3.160.204",52573,"244.3.160.254",2785,2,128,1,64,1,64,93.109308,7.300000000043383e-5,0,0
"244.3.160.204",52574,"244.3.160.239",443,7,448,4,256,3,192,93.109617,0.20880699999999308,9808.10030315108,7356.075227363311
"244.3.160.204",52575,"244.3.160.239",8080,2,128,1,64,1,64,93.109904,7.599999999285956e-5,0,0
"244.3.160.204",52576,"244.3.160.239",80,7,448,4,256,3,192,93.110188,0.17921300000000429,11427.74240707957,8570.806805309678
"244.3.160.204",52898,"244.3.160.89",4001,2,128,1,64,1,64,95.106641,8.800000000519503e-5,0,0
"244.3.160.204",52899,"244.3.160.89",4002,2,128,1,64,1,64,95.106935,7.100000000548334e-5,0,0
"244.3.160.204",52900,"244.3.160.89",2048,2,128,1,64,1,64,95.107151,5.7999999995672624e-5,0,0
"244.3.160.204",52901,"244.3.160.89",80,7,448,4,256,3,192,95.107398,0.1675249999999977,12225.041038651116,9168.780778988337
"244.3.160.204",52902,"244.3.160.89",443,13,3841,5,362,8,3479,95.107669,0.21476199999999324,13484.694685279943,129594.62102234509
"244.3.160.204",52903,"244.3.160.89",2784,2,128,1,64,1,64,95.107905,7.499999999538431e-5,0,0
"244.3.160.204",52904,"244.3.160.254",4000,7,448,4,256,3,192,95.108181,0.16819900000000132,12176.053365358795,9132.040024019096
"244.3.160.204",52905,"244.3.160.254",4001,2,128,1,64,1,64,95.108444,6.799999999884676e-5,0,0
"244.3.160.204",52906,"244.3.160.254",4002,2,128,1,64,1,64,95.108688,6.8999999996322e-5,0,0
"244.3.160.204",52907,"244.3.160.254",2048,2,128,1,64,1,64,95.108974,7.999999999697138e-5,0,0
"244.3.160.204",52908,"244.3.160.254",443,7,448,4,256,3,192,95.109231,0.16976900000000228,12063.450924491353,9047.588193368514
"244.3.160.204",52909,"244.3.160.254",80,7,448,4,256,3,192,95.109564,0.17017299999999125,12034.811632868348,9026.108724651262
"244.3.160.204",52910,"244.3.160.239",443,7,448,4,256,3,192,95.109762,0.1857339999999965,11026.521799993747,8269.89134999531
"244.3.160.204",52911,"244.3.160.239",8080,2,128,1,64,1,64,95.110059,7.199999998874773e-5,0,0
"244.3.160.204",52912,"244.3.160.239",80,7,448,4,256,3,192,95.110304,0.17081400000000713,11989.649560339987,8992.23717025499
"244.3.160.204",53229,"244.3.160.89",2785,2,128,1,64,1,64,97.10654,8.600000001024455e-5,0,0
"244.3.160.204",53230,"244.3.160.89",4000,2,128,1,64,1,64,97.106795,8.299999998939711e-5,0,0
"244.3.160.204",53231,"244.3.160.89",4001,2,128,1,64,1,64,97.107051,8.400000000108321e-5,0,0
"244.3.160.204",53232,"244.3.160.89",4002,2,128,1,64,1,64,97.107306,7.500000000959517e-5,0,0
"244.3.160.204",53233,"244.3.160.89",2048,2,128,1,64,1,64,97.107581,4.5999999997548e-5,0,0
"244.3.160.204",53234,"244.3.160.89",80,7,448,4,256,3,192,97.107801,0.16810100000000716,12183.151795646147,9137.36384673461
"244.3.160.204",53235,"244.3.160.254",2784,2,128,1,64,1,64,97.108132,6.600000000389628e-5,0,0
"244.3.160.204",53236,"244.3.160.254",2785,2,128,1,64,1,64,97.108362,0.0001319999999935817,0,0
"244.3.160.204",53237,"244.3.160.254",4000,7,448,4,256,3,192,97.108621,0.16867100000000335,12141.980542001644,9106.485406501233
"244.3.160.204",53238,"244.3.160.254",4001,2,128,1,64,1,64,97.108874,7.300000000043383e-5,0,0
"244.3.160.204",53239,"244.3.160.254",4002,2,128,1,64,1,64,97.109163,7.100000000548334e-5,0,0
"244.3.160.204",53240,"244.3.160.254",2048,2,128,1,64,1,64,97.109433,6.400000000894579e-5,0,0
"244.3.160.204",53241,"244.3.160.239",443,7,448,4,256,3,192,97.109695,0.21825599999999667,9383.47628473,7037.6072135475015
"244.3.160.204",53242,"244.3.160.239",8080,2,128,1,64,1,64,97.109997,6.199999999978445e-5,0,0
"244.3.160.204",53243,"244.3.160.239",80,7,448,4,256,3,192,97.110236,0.16974299999999687,12065.298716294856,9048.974037221142
"244.3.160.204",53568,"244.3.160.89",443,13,3841,5,362,8,3479,99.106527,0.2174449999999979,13318.310377336928,127995.58509048389
"244.3.160.204",53569,"244.3.160.89",2784,2,128,1,64,1,64,99.106764,8.59999999960337e-5,0,0
"244.3.160.204",53570,"244.3.160.89",2785,2,128,1,64,1,64,99.107008,7.100000000548334e-5,0,0
"244.3.160.204",53571,"244.3.160.89",4000,2,128,1,64,1,64,99.107272,7.00000000080081e-5,0,0
"244.3.160.204",53572,"244.3.160.89",4001,2,128,1,64,1,64,99.107523,6.799999999884676e-5,0,0
"244.3.160.204",53573,"244.3.160.89",4002,2,128,1,64,1,64,99.107802,2.9999999995311555e-5,0,0
"244.3.160.204",53574,"244.3.160.254",443,7,448,4,256,3,192,99.108048,0.16933099999999968,12094.65484760619,9070.991135704644
"244.3.160.204",53575,"244.3.160.254",80,7,448,4,256,3,192,99.108345,0.1700569999999999,12043.020869473183,9032.265652104888
"244.3.160.204",53576,"244.3.160.254",2784,2,128,1,64,1,64,99.108578,7.400000001211993e-5,0,0
"244.3.160.204",53577,"244.3.160.254",2785,2,128,1,64,1,64,99.108848,5.400000000577165e-5,0,0
"244.3.160.204",53578,"244.3.160.254",4000,7,448,4,256,3,192,99.109073,0.17167200000000093,11929.726455100359,8947.294841325269
"244.3.160.204",53579,"244.3.160.254",4001,2,128,1,64,1,64,99.109365,8.800000000519503e-5,0,0
"244.3.160.204",53580,"244.3.160.239",443,7,448,4,256,3,192,99.10963,0.20941400000000954,9779.670891152964,7334.753168364723
"244.3.160.204",53581,"244.3.160.239",8080,2,128,1,64,1,64,99.109898,6.799999999884676e-5,0,0
"244.3.160.204",53582,"244.3.160.239",80,7,448,4,256,3,192,99.110151,0.171843999999993,11917.785898838967,8938.339424129224
"244.3.160.204",53899,"244.3.160.89",2048,2,128,1,64,1,64,101.10701,0.00010499999999069587,0,0
"244.3.160.204",53900,"244.3.160.89",80,7,448,4,256,3,192,101.107261,0.169234000000003,12101.587151517802,9076.190363638352
"244.3.160.204",53901,"244.3.160.89",443,13,3841,5,362,8,3479,101.107532,0.21936199999998962,13201.921937255027,126877.03430859181
"244.3.160.204",53902,"244.3.160.89",2784,2,128,1,64,1,64,101.107792,6.999999999379725e-5,0,0
"244.3.160.204",53903,"244.3.160.89",2785,2,128,1,64,1,64,101.108033,6.999999999379725e-5,0,0
"244.3.160.204",53904,"244.3.160.89",4000,2,128,1,64,1,64,101.108285,7.399999999790907e-5,0,0
"244.3.160.204",53905,"244.3.160.254",4002,2,128,1,64,1,64,101.108609,5.000000000165983e-5,0,0
"244.3.160.204",53906,"244.3.160.254",2048,2,128,1,64,1,64,101.108842,6.799999999884676e-5,0,0
"244.3.160.204",53907,"244.3.160.254",443,7,448,4,256,3,192,101.109105,0.1711739999999935,11964.43385093576,8973.32538820182
"244.3.160.204",53908,"244.3.160.254",80,7,448,4,256,3,192,101.109387,0.17167899999999747,11929.240035182114,8946.930026386586
"244.3.160.204",53909,"244.3.160.254",2784,2,128,1,64,1,64,101.109642,7.300000000043383e-5,0,0
"244.3.160.204",53910,"244.3.160.254",2785,2,128,1,64,1,64,101.1099,7.100000000548334e-5,0,0
"244.3.160.204",53911,"244.3.160.239",443,7,448,4,256,3,192,101.110175,0.20399500000000614,10039.461751513216,7529.596313634911
"244.3.160.204",53912,"244.3.160.239",8080,2,128,1,64,1,64,101.110461,7.200000000295859e-5,0,0
"244.3.160.204",53913,"244.3.160.239",80,7,448,4,256,3,192,101.110719,0.17238100000000145,11880.65970147512,8910.494776106341
"244.3.160.204",54233,"244.3.160.89",4001,2,128,1,64,1,64,103.106816,0.0001010000000007949,0,0
"244.3.160.204",54234,"244.3.160.89",4002,2,128,1,64,1,64,103.107067,6.299999999725969e-5,0,0
"244.3.160.204",54235,"244.3.160.89",2048,2,128,1,64,1,64,103.107301,6.999999999379725e-5,0,0
"244.3.160.204",54236,"244.3.160.89",80,7,448,4,256,3,192,103.107576,0.17522100000000762,11688.096746394045,8766.072559795533
"244.3.160.204",54237,"244.3.160.89",443,13,3841,5,362,8,3479,103.107817,0.22537700000000882,12849.580924406158,123490.86197792548
"244.3.160.204",54238,"244.3.160.89",2784,2,128,1,64,1,64,103.108064,7.300000000043383e-5,0,0
"244.3.160.204",54239,"244.3.160.254",4000,7,448,4,256,3,192,103.108348,0.17517999999999745,11690.8322867909,8768.124215093176
"244.3.160.204",54240,"244.3.160.254",4001,2,128,1,64,1,64,103.108614,6.399999999473494e-5,0,0
"244.3.160.204",54241,"244.3.160.254",4002,2,128,1,64,1,64,103.108879,0.0001390000000043301,0,0
"244.3.160.204",54242,"244.3.160.254",2048,2,128,1,64,1,64,103.109122,6.8999999996322e-5,0,0
"244.3.160.204",54243,"244.3.160.254",443,7,448,4,256,3,192,103.109374,0.17584099999999125,11646.885538640601,8735.164153980451
"244.3.160.204",54244,"244.3.160.254",80,7,448,4,256,3,192,103.109666,0.17608099999999638,11631.010728017458,8723.258046013094
"244.3.160.204",54245,"244.3.160.239",443,7,448,4,256,3,192,103.109933,0.22070300000000032,9279.438883929974,6959.579162947481
"244.3.160.204",54246,"244.3.160.239",8080,2,128,1,64,1,64,103.110207,5.39999999915608e-5,0,0
"244.3.160.204",54247,"244.3.160.239",80,7,448,4,256,3,192,103.110446,0.17766500000000462,11527.312638955038,8645.484479216278
"244.3.160.204",54569,"244.3.160.89",2785,2,128,1,64,1,64,105.107231,8.700000000771979e-5,0,0
"244.3.160.204",54570,"244.3.160.89",4000,2,128,1,64,1,64,105.107467,9.400000000425734e-5,0,0
"244.3.160.204",54571,"244.3.160.89",4001,2,128,1,64,1,64,105.107752,6.799999999884676e-5,0,0
"244.3.160.204",54572,"244.3.160.89",4002,2,128,1,64,1,64,105.107993,7.00000000080081e-5,0,0
"244.3.160.204",54573,"244.3.160.89",2048,2,128,1,64,1,64,105.108236,6.8999999996322e-5,0,0
"244.3.160.204",54574,"244.3.160.89",80,7,448,4,256,3,192,105.108496,0.17036099999999976,12021.530749408626,9016.148062056469
"244.3.160.204",54575,"244.3.160.254",2784,2,128,1,64,1,64,105.108791,8.300000000360797e-5,0,0
"244.3.160.204",54576,"244.3.160.254",2785,2,128,1,64,1,64,105.109067,9.000000000014552e-5,0,0
"244.3.160.204",54577,"244.3.160.254",4000,7,448,4,256,3,192,105.109318,0.17098899999999162,11977.378661785848,8983.033996339385
"244.3.160.204",54578,"244.3.160.254",4001,2,128,1,64,1,64,105.109576,7.099999999127249e-5,0,0
"244.3.160.204",54579,"244.3.160.254",4002,2,128,1,64,1,64,105.109864,7.099999999127249e-5,0,0
"244.3.160.204",54580,"244.3.160.254",2048,2,128,1,64,1,64,105.110126,7.300000000043383e-5,0,0
"244.3.160.204",54581,"244.3.160.239",443,7,448,4,256,3,192,105.110401,0.18511900000000026,11063.153971229302,8297.365478421976
"244.3.160.204",54582,"244.3.160.239",8080,2,128,1,64,1,64,105.110677,7.399999999790907e-5,0,0
"244.3.160.204",54583,"244.3.160.239",80,7,448,4,256,3,192,105.110976,0.17227600000001075,11887.900810326872,8915.925607745154
"244.3.160.204",54900,"244.3.160.89",443,13,3841,5,362,8,3479,107.107202,0.22401800000000094,12927.532608986723,124240.01642725086
"244.3.160.204",54901,"244.3.160.89",2784,2,128,1,64,1,64,107.107436,7.999999999697138e-5,0,0
"244.3.160.204",54902,"244.3.160.89",2785,2,128,1,64,1,64,107.107674,7.999999999697138e-5,0,0
"244.3.160.204",54903,"244.3.160.89",4000,2,128,1,64,1,64,107.107984,7.399999999790907e-5,0,0
"244.3.160.204",54904,"244.3.160.89",4001,2,128,1,64,1,64,107.108186,6.700000000137152e-5,0,0
"244.3.160.204",54905,"244.3.160.89",4002,2,128,1,64,1,64,107.10843,6.799999999884676e-5,0,0
"244.3.160.204",54906,"244.3.160.254",443,7,448,4,256,3,192,107.108695,0.17329300000000103,11818.134604398261,8863.600953298695
"244.3.160.204",54907,"244.3.160.254",80,7,448,4,256,3,192,107.108982,0.17374000000000933,11787.728790145562,8840.796592609171
"244.3.160.204",54908,"244.3.160.254",2784,2,128,1,64,1,64,107.109235,0.00011899999999798183,0,0
"244.3.160.204",54909,"244.3.160.254",2785,2,128,1,64,1,64,107.109487,6.700000000137152e-5,0,0
"244.3.160.204",54910,"244.3.160.254",4000,7,448,4,256,3,192,107.109741,0.17484799999999723,11713.030746705896,8784.773060029422
"244.3.160.204",54911,"244.3.160.254",4001,2,128,1,64,1,64,107.110021,6.700000000137152e-5,0,0
"244.3.160.204",54912,"244.3.160.239",443,7,448,4,256,3,192,107.110336,0.22442900000000066,9125.380409840056,6844.0353073800425
"244.3.160.204",54913,"244.3.160.239",8080,2,128,1,64,1,64,107.110541,7.300000000043383e-5,0,0
"244.3.160.204",54914,"244.3.160.239",80,7,448,4,256,3,192,107.110828,0.1754630000000077,11671.976428078342,8753.982321058756
"244.3.160.204",55239,"244.3.160.89",2048,2,128,1,64,1,64,109.107182,9.500000000173259e-5,0,0
"244.3.160.204",55240,"244.3.160.89",80,7,448,4,256,3,192,109.107424,0.16899100000000544,12118.988585190536,9089.241438892903
"244.3.160.204",55241,"244.3.160.89",443,13,3841,5,362,8,3479,109.107677,0.21981999999999857,13174.41543080711,126612.68310435893
"244.3.160.204",55242,"244.3.160.89",2784,2,128,1,64,1,64,109.107906,7.200000000295859e-5,0,0
"244.3.160.204",55243,"244.3.160.89",2785,2,128,1,64,1,64,109.108177,6.8999999996322e-5,0,0
"244.3.160.204",55244,"244.3.160.89",4000,2,128,1,64,1,64,109.108422,9.599999999920783e-5,0,0
"244.3.160.204",55245,"244.3.160.254",4002,2,128,1,64,1,64,109.108699,6.799999999884676e-5,0,0
"244.3.160.204",55246,"244.3.160.254",2048,2,128,1,64,1,64,109.108939,6.599999998968542e-5,0,0
"244.3.160.204",55247,"244.3.160.254",443,7,448,4,256,3,192,109.109218,0.1712440000000015,11959.543108079593,8969.657331059696
"244.3.160.204",55248,"244.3.160.254",80,7,448,4,256,3,192,109.10949,0.17153300000001082,11939.393586073063,8954.545189554798
"244.3.160.204",55249,"244.3.160.254",2784,2,128,1,64,1,64,109.109751,6.700000000137152e-5,0,0
"244.3.160.204",55250,"244.3.160.254",2785,2,128,1,64,1,64,109.110014,7.199999998874773e-5,0,0
"244.3.160.204",55251,"244.3.160.239",443,7,448,4,256,3,192,109.110293,0.20625200000000632,9929.600682659742,7447.200511994807
"244.3.160.204",55252,"244.3.160.239",8080,2,128,1,64,1,64,109.110555,7.099999999127249e-5,0,0
"244.3.160.204",55253,"244.3.160.239",80,7,448,4,256,3,192,109.110801,0.17240400000000022,11879.07473144473,8909.306048583549
"244.3.160.204",55570,"244.3.160.89",4001,2,128,1,64,1,64,111.108588,0.00010500000000490672,0,0
"244.3.160.204",55571,"244.3.160.89",4002,2,128,1,64,1,64,111.108829,7.599999999285956e-5,0,0
"244.3.160.204",55572,"244.3.160.89",2048,2,128,1,64,1,64,111.109075,6.799999999884676e-5,0,0
"244.3.160.204",55573,"244.3.160.89",80,7,448,4,256,3,192,111.109353,0.1715729999999951,11936.610072680774,8952.457554510582
"244.3.160.204",55574,"244.3.160.89",443,13,3841,5,362,8,3479,111.10961,0.2199679999999944,13165.551352924398,126527.49490835353
"244.3.160.204",55575,"244.3.160.89",2784,2,128,1,64,1,64,111.109859,7.100000000548334e-5,0,0
"244.3.160.204",55576,"244.3.160.254",4000,7,448,4,256,3,192,111.110154,0.17164200000000562,11931.81156127249,8948.858670954369
"244.3.160.204",55577,"244.3.160.254",4001,2,128,1,64,1,64,111.11042,6.8999999996322e-5,0,0
"244.3.160.204",55578,"244.3.160.254",4002,2,128,1,64,1,64,111.110675,7.100000000548334e-5,0,0
"244.3.160.204",55579,"244.3.160.254",2048,2,128,1,64,1,64,111.110935,7.00000000080081e-5,0,0
"244.3.160.204",55580,"244.3.160.254",443,7,448,4,256,3,192,111.111217,0.17318300000000875,11825.641084863391,8869.230813647542
"244.3.160.204",55581,"244.3.160.254",80,7,448,4,256,3,192,111.11148,0.17360899999999901,11796.623446941181,8847.467585205886
"244.3.160.204",55582,"244.3.160.239",443,7,448,4,256,3,192,111.111756,0.2214960000000019,9246.216635966259,6934.662476974693
"244.3.160.204",55583,"244.3.160.239",8080,2,128,1,64,1,64,111.112023,7.200000000295859e-5,0,0
"244.3.160.204",55584,"244.3.160.239",80,7,448,4,256,3,192,111.11231,0.17460300000000473,11729.466274920504,8797.099706190376
"244.3.160.204",55904,"244.3.160.89",2785,2,128,1,64,1,64,113.107969,7.300000000043383e-5,0,0
"244.3.160.204",55905,"244.3.160.89",4000,2,128,1,64,1,64,113.108198,9.099999999762076e-5,0,0
"244.3.160.204",55906,"244.3.160.89",4001,2,128,1,64,1,64,113.10846,7.500000000959517e-5,0,0
"244.3.160.204",55907,"244.3.160.89",4002,2,128,1,64,1,64,113.108725,6.699999998716066e-5,0,0
"244.3.160.204",55908,"244.3.160.89",2048,2,128,1,64,1,64,113.108966,6.300000001147055e-5,0,0
"244.3.160.204",55909,"244.3.160.89",80,7,448,4,256,3,192,113.10922,0.17134300000000735,11952.63302264996,8964.47476698747
"244.3.160.204",55910,"244.3.160.254",2784,2,128,1,64,1,64,113.109518,7.100000000548334e-5,0,0
"244.3.160.204",55911,"244.3.160.254",2785,2,128,1,64,1,64,113.109781,6.700000000137152e-5,0,0
"244.3.160.204",55912,"244.3.160.254",4000,7,448,4,256,3,192,113.110045,0.17202699999999993,11905.107919105727,8928.830939329295
"244.3.160.204",55913,"244.3.160.254",4001,2,128,1,64,1,64,113.110321,7.700000000454565e-5,0,0
"244.3.160.204",55914,"244.3.160.254",4002,2,128,1,64,1,64,113.110567,6.799999999884676e-5,0,0
"244.3.160.204",55915,"244.3.160.254",2048,2,128,1,64,1,64,113.110827,6.500000000642103e-5,0,0
"244.3.160.204",55916,"244.3.160.239",443,7,448,4,256,3,192,113.111124,0.21327199999998925,9602.760793728681,7202.070595296511
"244.3.160.204",55917,"244.3.160.239",8080,2,128,1,64,1,64,113.11138,7.399999999790907e-5,0,0
"244.3.160.204",55918,"244.3.160.239",80,7,448,4,256,3,192,113.111655,0.17384900000000414,11780.338109508546,8835.25358213141
"244.3.160.204",56240,"244.3.160.89",443,13,3841,5,362,8,3479,115.107517,0.1975010000000026,14663.216895104137,140920.80546427428
"244.3.160.204",56241,"244.3.160.89",2784,2,128,1,64,1,64,115.107766,0.00010400000000743148,0,0
"244.3.160.204",56242,"244.3.160.89",2785,2,128,1,64,1,64,115.10801,6.900000001053286e-5,0,0
"244.3.160.204",56243,"244.3.160.89",4000,2,128,1,64,1,64,115.108267,0.0001010000000007949,0,0
"244.3.160.204",56244,"244.3.160.89",4001,2,128,1,64,1,64,115.108545,7.69999999903348e-5,0,0
"244.3.160.204",56245,"244.3.160.89",4002,2,128,1,64,1,64,115.108776,8.199999999192187e-5,0,0
"244.3.160.204",56246,"244.3.160.254",443,7,448,4,256,3,192,115.109048,0.1539849999999916,13299.996752931205,9974.997564698404
"244.3.160.204",56247,"244.3.160.254",80,7,448,4,256,3,192,115.109378,0.1545979999999929,13247.26063726629,9935.445477949717
"244.3.160.204",56248,"244.3.160.254",2784,2,128,1,64,1,64,115.109588,0.0002829999999960364,0,0
"244.3.160.204",56249,"244.3.160.254",2785,2,128,1,64,1,64,115.109867,3.500000001110948e-5,0,0
"244.3.160.204",56250,"244.3.160.254",4000,7,448,4,256,3,192,115.110101,0.15534099999999285,13183.898648779745,9887.923986584809
"244.3.160.204",56251,"244.3.160.254",4001,2,128,1,64,1,64,115.110369,4.999999998744897e-5,0,0
"244.3.160.204",56252,"244.3.160.239",443,7,448,4,256,3,192,115.110643,0.19108599999999853,10717.687324032193,8038.265493024145
"244.3.160.204",56253,"244.3.160.239",8080,2,128,1,64,1,64,115.1109,7.100000000548334e-5,0,0
"244.3.160.204",56254,"244.3.160.239",80,7,448,4,256,3,192,115.111149,0.157905999999997,12969.741491773833,9727.306118830375
"244.3.160.204",56571,"244.3.160.89",2048,2,128,1,64,1,64,117.123743,8.899999998845942e-5,0,0
"244.3.160.204",56572,"244.3.160.89",80,7,448,4,256,3,192,117.124133,0.17452699999999766,11734.57402006582,8800.930515049366
"244.3.160.204",56573,"244.3.160.89",443,13,3841,5,362,8,3479,117.124543,0.22321999999999775,12973.747872054606,124684.16808529827
"244.3.160.204",56574,"244.3.160.89",2784,2,128,1,64,1,64,117.125016,7.099999999127249e-5,0,0
"244.3.160.204",56575,"244.3.160.89",2785,2,128,1,64,1,64,117.125449,6.999999999379725e-5,0,0
"244.3.160.204",56576,"244.3.160.89",4000,2,128,1,64,1,64,117.125905,6.799999999884676e-5,0,0
"244.3.160.204",56577,"244.3.160.254",4002,2,128,1,64,1,64,117.126353,6.900000001053286e-5,0,0
"244.3.160.204",56578,"244.3.160.254",2048,2,128,1,64,1,64,117.126824,7.100000000548334e-5,0,0
"244.3.160.204",56579,"244.3.160.254",443,7,448,4,256,3,192,117.127276,0.17527499999999918,11684.4957923264,8763.371844244799
"244.3.160.204",56580,"244.3.160.254",80,7,448,4,256,3,192,117.127727,0.1757740000000041,11651.324996870711,8738.493747653032
"244.3.160.204",56581,"244.3.160.254",2784,2,128,1,64,1,64,117.128183,5.7999999995672624e-5,0,0
"244.3.160.204",56582,"244.3.160.254",2785,2,128,1,64,1,64,117.128608,6.700000000137152e-5,0,0
"244.3.160.204",56583,"244.3.160.239",443,7,448,4,256,3,192,117.129102,0.22974299999999914,8914.308596997547,6685.731447748161
"244.3.160.204",56584,"244.3.160.239",8080,2,128,1,64,1,64,117.129543,7.399999999790907e-5,0,0
"244.3.160.204",56585,"244.3.160.239",80,7,448,4,256,3,192,117.130008,0.17652599999999552,11601.690402547229,8701.26780191042
"244.3.160.204",56910,"244.3.160.89",4001,2,128,1,64,1,64,119.108285,9.30000000067821e-5,0,0
"244.3.160.204",56911,"244.3.160.89",4002,2,128,1,64,1,64,119.108533,7.200000000295859e-5,0,0
"244.3.160.204",56912,"244.3.160.89",2048,2,128,1,64,1,64,119.108766,7.200000000295859e-5,0,0
"244.3.160.204",56913,"244.3.160.89",80,7,448,4,256,3,192,119.109041,0.2097869999999915,9762.28269625898,7321.712022194236
"244.3.160.204",56914,"244.3.160.89",443,13,3841,5,362,8,3479,119.109296,0.27008299999999963,10722.62971012616,103049.80320864341
"244.3.160.204",56915,"244.3.160.89",2784,2,128,1,64,1,64,119.109538,7.399999999790907e-5,0,0
"244.3.160.204",56916,"244.3.160.254",4000,7,448,4,256,3,192,119.109844,0.2109269999999981,9709.520355383704,7282.140266537778
"244.3.160.204",56917,"244.3.160.254",4001,2,128,1,64,1,64,119.110115,6.100000000230921e-5,0,0
"244.3.160.204",56918,"244.3.160.254",4002,2,128,1,64,1,64,119.11035,6.299999999725969e-5,0,0
"244.3.160.204",56919,"244.3.160.254",2048,2,128,1,64,1,64,119.110603,7.399999999790907e-5,0,0
"244.3.160.204",56920,"244.3.160.254",443,7,448,4,256,3,192,119.110902,0.2143740000000065,9553.397333631587,7165.04800022369
"244.3.160.204",56921,"244.3.160.254",80,7,448,4,256,3,192,119.111157,0.21505899999999656,9522.968115726535,7142.226086794901
"244.3.160.204",56922,"244.3.160.239",443,7,448,4,256,3,192,119.111428,0.266295999999997,7690.6900591823505,5768.017544386763
"244.3.160.204",56923,"244.3.160.239",8080,2,128,1,64,1,64,119.111689,6.8999999996322e-5,0,0
"244.3.160.204",56924,"244.3.160.239",80,7,448,4,256,3,192,119.111979,0.2170330000000007,9436.35299700964,7077.264747757231
"244.3.160.204",57241,"244.3.160.89",2785,2,128,1,64,1,64,121.109216,8.499999999855845e-5,0,0
"244.3.160.204",57242,"244.3.160.89",4000,2,128,1,64,1,64,121.109463,7.799999998781004e-5,0,0
"244.3.160.204",57243,"244.3.160.89",4001,2,128,1,64,1,64,121.109731,6.799999999884676e-5,0,0
"244.3.160.204",57244,"244.3.160.89",4002,2,128,1,64,1,64,121.109988,7.100000000548334e-5,0,0
"244.3.160.204",57245,"244.3.160.89",2048,2,128,1,64,1,64,121.110245,6.799999999884676e-5,0,0
"244.3.160.204",57246,"244.3.160.89",80,7,448,4,256,3,192,121.11051,0.1544499999999971,13259.954677889535,9944.96600841715
"244.3.160.204",57247,"244.3.160.254",2784,2,128,1,64,1,64,121.1108,6.700000000137152e-5,0,0
"244.3.160.204",57248,"244.3.160.254",2785,2,128,1,64,1,64,121.111108,7.100000000548334e-5,0,0
"244.3.160.204",57249,"244.3.160.254",4000,7,448,4,256,3,192,121.111359,0.15517400000000237,13198.087308440647,9898.565481330485
"244.3.160.204",57250,"244.3.160.254",4001,2,128,1,64,1,64,121.11168,6.8999999996322e-5,0,0
"244.3.160.204",57251,"244.3.160.254",4002,2,128,1,64,1,64,121.111866,6.699999998716066e-5,0,0
"244.3.160.204",57252,"244.3.160.254",2048,2,128,1,64,1,64,121.112154,6.999999999379725e-5,0,0
"244.3.160.204",57253,"244.3.160.239",443,7,448,4,256,3,192,121.112439,0.20021100000001013,10229.208185363923,7671.906139022943
"244.3.160.204",57254,"244.3.160.239",8080,2,128,1,64,1,64,121.112704,7.200000000295859e-5,0,0
"244.3.160.204",57255,"244.3.160.239",80,7,448,4,256,3,192,121.113005,0.15718599999999583,13029.150178769447,9771.862634077086
"244.3.160.204",57575,"244.3.160.89",443,13,3841,5,362,8,3479,123.108329,0.20563599999999838,14083.13719387667,135345.95109805782
"244.3.160.204",57576,"244.3.160.89",2784,2,128,1,64,1,64,123.108569,8.099999999444663e-5,0,0
"244.3.160.204",57577,"244.3.160.89",2785,2,128,1,64,1,64,123.108818,6.500000000642103e-5,0,0
"244.3.160.204",57578,"244.3.160.89",4000,2,128,1,64,1,64,123.109071,7.200000000295859e-5,0,0
"244.3.160.204",57579,"244.3.160.89",4001,2,128,1,64,1,64,123.109354,4.70000000092341e-5,0,0
"244.3.160.204",57580,"244.3.160.89",4002,2,128,1,64,1,64,123.109585,6.700000000137152e-5,0,0
"244.3.160.204",57581,"244.3.160.254",443,7,448,4,256,3,192,123.109873,0.15990500000000907,12807.604515180163,9605.703386385121
"244.3.160.204",57582,"244.3.160.254",80,7,448,4,256,3,192,123.110128,0.1604809999999901,12761.635333778617,9571.226500333963
"244.3.160.204",57583,"244.3.160.254",2784,2,128,1,64,1,64,123.110402,7.00000000080081e-5,0,0
"244.3.160.204",57584,"244.3.160.254",2785,2,128,1,64,1,64,123.110649,7.200000000295859e-5,0,0
"244.3.160.204",57585,"244.3.160.254",4000,7,448,4,256,3,192,123.110909,0.16131899999999177,12695.342768056487,9521.507076042366
"244.3.160.204",57586,"244.3.160.254",4001,2,128,1,64,1,64,123.1112,5.900000000735872e-5,0,0
"244.3.160.204",57587,"244.3.160.239",443,7,448,4,256,3,192,123.111483,0.19918099999999583,10282.105220879717,7711.5789156597875
"244.3.160.204",57588,"244.3.160.239",8080,2,128,1,64,1,64,123.111733,7.100000000548334e-5,0,0
"244.3.160.204",57589,"244.3.160.239",80,7,448,4,256,3,192,123.111996,0.1637889999999942,12503.892202773524,9377.919152080143
"244.3.160.204",57911,"244.3.160.89",2048,2,128,1,64,1,64,125.108673,0.00011299999999891952,0,0
"244.3.160.204",57912,"244.3.160.89",80,7,448,4,256,3,192,125.108921,0.15395200000000386,13302.84764082278,9977.135730617085
"244.3.160.204",57913,"244.3.160.89",443,13,3841,5,362,8,3479,125.109169,0.1970580000000126,14696.180819859203,141237.60517207228
"244.3.160.204",57914,"244.3.160.89",2784,2,128,1,64,1,64,125.109446,7.599999999285956e-5,0,0
"244.3.160.204",57915,"244.3.160.89",2785,2,128,1,64,1,64,125.109693,7.100000000548334e-5,0,0
"244.3.160.204",57916,"244.3.160.89",4000,2,128,1,64,1,64,125.109947,7.599999999285956e-5,0,0
"244.3.160.204",57917,"244.3.160.254",4002,2,128,1,64,1,64,125.110231,7.00000000080081e-5,0,0
"244.3.160.204",57918,"244.3.160.254",2048,2,128,1,64,1,64,125.110548,7.600000000707041e-5,0,0
"244.3.160.204",57919,"244.3.160.254",443,7,448,4,256,3,192,125.110769,0.15520599999999263,13195.366158525427,9896.52461889407
"244.3.160.204",57920,"244.3.160.254",80,7,448,4,256,3,192,125.111015,0.15580900000000497,13144.298467995653,9858.22385099674
"244.3.160.204",57921,"244.3.160.254",2784,2,128,1,64,1,64,125.111296,7.100000000548334e-5,0,0
"244.3.160.204",57922,"244.3.160.254",2785,2,128,1,64,1,64,125.111624,7.69999999903348e-5,0,0
"244.3.160.204",57923,"244.3.160.239",443,7,448,4,256,3,192,125.111845,0.18813199999999597,10885.973678056067,8164.480258542049
"244.3.160.204",57924,"244.3.160.239",8080,2,128,1,64,1,64,125.112136,8.399999998687235e-5,0,0
"244.3.160.204",57925,"244.3.160.239",80,7,448,4,256,3,192,125.112401,0.15747100000000103,13005.569279422793,9754.176959567094
"244.3.160.204",58242,"244.3.160.89",4001,2,128,1,64,1,64,127.109045,8.700000000771979e-5,0,0
"244.3.160.204",58243,"244.3.160.89",4002,2,128,1,64,1,64,127.109273,0.00011599999999134525,0,0
"244.3.160.204",58244,"244.3.160.89",2048,2,128,1,64,1,64,127.109551,7.100000000548334e-5,0,0
"244.3.160.204",58245,"244.3.160.89",80,7,448,4,256,3,192,127.109828,0.15685799999999972,13056.39495594744,9792.29621696058
"244.3.160.204",58246,"244.3.160.89",443,13,3841,5,362,8,3479,127.110064,0.20718300000000056,13977.980818889542,134335.34604673128
"244.3.160.204",58247,"244.3.160.89",2784,2,128,1,64,1,64,127.110358,7.599999999285956e-5,0,0
"244.3.160.204",58248,"244.3.160.254",4000,7,448,4,256,3,192,127.110634,0.1576999999999913,12986.683576411624,9740.012682308718
"244.3.160.204",58249,"244.3.160.254",4001,2,128,1,64,1,64,127.110869,6.0000000004833964e-5,0,0
"244.3.160.204",58250,"244.3.160.254",4002,2,128,1,64,1,64,127.111177,6.600000000389628e-5,0,0
"244.3.160.204",58251,"244.3.160.254",2048,2,128,1,64,1,64,127.111367,9.099999999762076e-5,0,0
"244.3.160.204",58252,"244.3.160.254",443,7,448,4,256,3,192,127.11167,0.15988899999999262,12808.886164777405,9606.664623583054
"244.3.160.204",58253,"244.3.160.254",80,7,448,4,256,3,192,127.111917,0.16570799999999508,12359.089482704883,9269.317112028662
"244.3.160.204",58254,"244.3.160.239",443,7,448,4,256,3,192,127.112194,0.1681080000000037,12182.64449044635,9136.983367834762
"244.3.160.204",58255,"244.3.160.239",8080,2,128,1,64,1,64,127.11248,7.599999999285956e-5,0,0
"244.3.160.204",58256,"244.3.160.239",80,7,448,4,256,3,192,127.112739,0.16593199999999797,12342.405322662446,9256.803991996834
"244.3.160.204",58581,"244.3.160.89",2785,2,128,1,64,1,64,129.108768,8.900000000267028e-5,0,0
"244.3.160.204",58582,"244.3.160.89",4000,2,128,1,64,1,64,129.109013,7.399999998369822e-5,0,0
"244.3.160.204",58583,"244.3.160.89",4001,2,128,1,64,1,64,129.109262,6.600000000389628e-5,0,0
"244.3.160.204",58584,"244.3.160.89",4002,2,128,1,64,1,64,129.10951,6.600000000389628e-5,0,0
"244.3.160.204",58585,"244.3.160.89",2048,2,128,1,64,1,64,129.10978,6.799999999884676e-5,0,0
"244.3.160.204",58586,"244.3.160.89",80,7,448,4,256,3,192,129.110027,0.15054299999999898,13604.086540058413,10203.064905043811
"244.3.160.204",58587,"244.3.160.254",2784,2,128,1,64,1,64,129.110315,6.8999999996322e-5,0,0
"244.3.160.204",58588,"244.3.160.254",2785,2,128,1,64,1,64,129.110555,6.999999999379725e-5,0,0
"244.3.160.204",58589,"244.3.160.254",4000,7,448,4,256,3,192,129.110852,0.15184999999999604,13486.993743826495,10115.24530786987
"244.3.160.204",58590,"244.3.160.254",4001,2,128,1,64,1,64,129.111097,6.8999999996322e-5,0,0
"244.3.160.204",58591,"244.3.160.254",4002,2,128,1,64,1,64,129.111344,6.700000000137152e-5,0,0
"244.3.160.204",58592,"244.3.160.254",2048,2,128,1,64,1,64,129.11162,6.700000000137152e-5,0,0
"244.3.160.204",58593,"244.3.160.239",443,7,448,4,256,3,192,129.111901,0.1976240000000189,10363.113791846154,7772.335343884615
"244.3.160.204",58594,"244.3.160.239",8080,2,128,1,64,1,64,129.11216,7.10000000196942e-5,0,0
"244.3.160.204",58595,"244.3.160.239",80,7,448,4,256,3,192,129.112412,0.15378599999999665,13317.207027948218,9987.905270961164
"244.3.160.204",58912,"244.3.160.89",443,13,3841,5,362,8,3479,131.109775,0.2015819999999735,14366.362075980895,138067.8830451313
"244.3.160.204",58913,"244.3.160.89",2784,2,128,1,64,1,64,131.110054,7.999999999697138e-5,0,0
"244.3.160.204",58914,"244.3.160.89",2785,2,128,1,64,1,64,131.110281,6.900000002474371e-5,0,0
"244.3.160.204",58915,"244.3.160.89",4000,2,128,1,64,1,64,131.110548,6.700000000137152e-5,0,0
"244.3.160.204",58916,"244.3.160.89",4001,2,128,1,64,1,64,131.110798,5.8000000024094334e-5,0,0
"244.3.160.204",58917,"244.3.160.89",4002,2,128,1,64,1,64,131.111074,5.400000000577165e-5,0,0
"244.3.160.204",58918,"244.3.160.254",443,7,448,4,256,3,192,131.111316,0.1577090000000112,12985.942463650486,9739.456847737865
"244.3.160.204",58919,"244.3.160.254",80,7,448,4,256,3,192,131.11165,0.15856400000001258,12915.920385458474,9686.940289093856
"244.3.160.204",58920,"244.3.160.254",2784,2,128,1,64,1,64,131.111859,7.899999999949614e-5,0,0
"244.3.160.204",58921,"244.3.160.254",2785,2,128,1,64,1,64,131.112115,6.600000000389628e-5,0,0
"244.3.160.204",58922,"244.3.160.254",4000,7,448,4,256,3,192,131.112365,0.1595919999999751,12832.723444786203,9624.542583589653
"244.3.160.204",58923,"244.3.160.254",4001,2,128,1,64,1,64,131.112624,6.499999997799932e-5,0,0
"244.3.160.204",58924,"244.3.160.239",443,7,448,4,256,3,192,131.112926,0.2094720000000052,9776.963030858296,7332.722273143722
"244.3.160.204",58925,"244.3.160.239",8080,2,128,1,64,1,64,131.113173,7.80000000020209e-5,0,0
"244.3.160.204",58926,"244.3.160.239",80,7,448,4,256,3,192,131.113444,0.1610330000000033,12717.890121900218,9538.417591425165
"244.3.160.204",59246,"244.3.160.89",2048,2,128,1,64,1,64,133.109326,9.099999999762076e-5,0,0
"244.3.160.204",59247,"244.3.160.89",80,7,448,4,256,3,192,133.109574,0.15953199999998446,12837.549833263542,9628.162374947657
"244.3.160.204",59248,"244.3.160.89",443,13,3841,5,362,8,3479,133.10982,0.20827699999998117,13904.559792969276,133629.73347994505
"244.3.160.204",59249,"244.3.160.89",2784,2,128,1,64,1,64,133.110087,7.500000000959517e-5,0,0
"244.3.160.204",59250,"244.3.160.89",2785,2,128,1,64,1,64,133.110338,6.8999999996322e-5,0,0
"244.3.160.204",59251,"244.3.160.89",4000,2,128,1,64,1,64,133.110601,7.199999998874773e-5,0,0
"244.3.160.204",59252,"244.3.160.254",4002,2,128,1,64,1,64,133.110861,6.600000000389628e-5,0,0
"244.3.160.204",59253,"244.3.160.254",2048,2,128,1,64,1,64,133.111142,6.8999999996322e-5,0,0
"244.3.160.204",59254,"244.3.160.254",443,7,448,4,256,3,192,133.111463,0.16230100000001357,12618.529768761922,9463.897326571441
"244.3.160.204",59255,"244.3.160.254",80,7,448,4,256,3,192,133.11172,0.162698000000006,12587.73924694787,9440.804435210903
"244.3.160.204",59256,"244.3.160.254",2784,2,128,1,64,1,64,133.111909,6.700000000137152e-5,0,0
"244.3.160.204",59257,"244.3.160.254",2785,2,128,1,64,1,64,133.11219,6.8999999996322e-5,0,0
"244.3.160.204",59258,"244.3.160.239",443,7,448,4,256,3,192,133.112465,0.1941940000000102,10546.15487605123,7909.616157038422
"244.3.160.204",59259,"244.3.160.239",8080,2,128,1,64,1,64,133.112728,7.199999998874773e-5,0,0
"244.3.160.204",59260,"244.3.160.239",80,7,448,4,256,3,192,133.113008,0.16375099999999065,12506.793851641314,9380.095388730986
"244.3.160.204",59582,"244.3.160.89",4001,2,128,1,64,1,64,135.109407,0.00010399999999322063,0,0
"244.3.160.204",59583,"244.3.160.89",4002,2,128,1,64,1,64,135.109651,7.299999998622297e-5,0,0
"244.3.160.204",59584,"244.3.160.89",2048,2,128,1,64,1,64,135.10989,7.099999999127249e-5,0,0
"244.3.160.204",59585,"244.3.160.89",80,7,448,4,256,3,192,135.11016,0.15458399999999983,13248.460383998357,9936.345287998769
"244.3.160.204",59586,"244.3.160.89",443,13,3841,5,362,8,3479,135.110409,0.19903999999999655,14549.839228296072,139831.18971061334
"244.3.160.204",59587,"244.3.160.89",2784,2,128,1,64,1,64,135.110658,6.999999999379725e-5,0,0
"244.3.160.204",59588,"244.3.160.254",4000,7,448,4,256,3,192,135.110953,0.1549710000000175,13215.37577998315,9911.531834987361
"244.3.160.204",59589,"244.3.160.254",4001,2,128,1,64,1,64,135.111206,7.099999999127249e-5,0,0
"244.3.160.204",59590,"244.3.160.254",4002,2,128,1,64,1,64,135.111453,7.099999999127249e-5,0,0
"244.3.160.204",59591,"244.3.160.254",2048,2,128,1,64,1,64,135.111706,6.700000000137152e-5,0,0
"244.3.160.204",59592,"244.3.160.254",443,7,448,4,256,3,192,135.111963,0.15664899999998738,13073.81470676586,9805.361030074393
"244.3.160.204",59593,"244.3.160.254",80,7,448,4,256,3,192,135.112251,0.15763700000002245,12991.873735225285,9743.905301418963
"244.3.160.204",59594,"244.3.160.239",443,7,448,4,256,3,192,135.112519,0.20727700000000482,9880.498077451683,7410.3735580887615
"244.3.160.204",59595,"244.3.160.239",8080,2,128,1,64,1,64,135.112774,7.099999999127249e-5,0,0
"244.3.160.204",59596,"244.3.160.239",80,7,448,4,256,3,192,135.113044,0.15830499999998437,12937.051893498008,9702.788920123507
"244.3.160.204",59913,"244.3.160.89",2785,2,128,1,64,1,64,137.110133,0.0001010000000007949,0,0
"244.3.160.204",59914,"244.3.160.89",4000,2,128,1,64,1,64,137.11041,7.500000000959517e-5,0,0
"244.3.160.204",59915,"244.3.160.89",4001,2,128,1,64,1,64,137.110663,6.900000002474371e-5,0,0
"244.3.160.204",59916,"244.3.160.89",4002,2,128,1,64,1,64,137.110915,7.099999999127249e-5,0,0
"244.3.160.204",59917,"244.3.160.89",2048,2,128,1,64,1,64,137.111168,6.999999999379725e-5,0,0
"244.3.160.204",59918,"244.3.160.89",80,7,448,4,256,3,192,137.111445,0.15701400000000376,13043.42287948814,9782.567159616106
"244.3.160.204",59919,"244.3.160.254",2784,2,128,1,64,1,64,137.111749,6.8999999996322e-5,0,0
"244.3.160.204",59920,"244.3.160.254",2785,2,128,1,64,1,64,137.111989,7.200000001716944e-5,0,0
"244.3.160.204",59921,"244.3.160.254",4000,7,448,4,256,3,192,137.112267,0.1585499999999911,12917.060864081457,9687.795648061094
"244.3.160.204",59922,"244.3.160.254",4001,2,128,1,64,1,64,137.112537,6.999999999379725e-5,0,0
"244.3.160.204",59923,"244.3.160.254",4002,2,128,1,64,1,64,137.112795,6.8999999996322e-5,0,0
"244.3.160.204",59924,"244.3.160.254",2048,2,128,1,64,1,64,137.113053,7.099999999127249e-5,0,0
"244.3.160.204",59925,"244.3.160.239",443,7,448,4,256,3,192,137.113364,0.1937210000000107,10571.90495609607,7928.928717072054
"244.3.160.204",59926,"244.3.160.239",8080,2,128,1,64,1,64,137.113642,7.300000001464468e-5,0,0
"244.3.160.204",59927,"244.3.160.239",80,7,448,4,256,3,192,137.113889,0.15960599999999658,12831.59780960643,9623.698357204823
"244.3.160.204",60252,"244.3.160.89",443,13,3841,5,362,8,3479,139.109674,0.1943159999999864,14903.559151074553,143230.61405134908
"244.3.160.204",60253,"244.3.160.89",2784,2,128,1,64,1,64,139.109923,8.599999998182284e-5,0,0
"244.3.160.204",60254,"244.3.160.89",2785,2,128,1,64,1,64,139.110181,7.399999998369822e-5,0,0
"244.3.160.204",60255,"244.3.160.89",4000,2,128,1,64,1,64,139.110481,6.000000001904482e-5,0,0
"244.3.160.204",60256,"244.3.160.89",4001,2,128,1,64,1,64,139.110703,6.999999999379725e-5,0,0
"244.3.160.204",60257,"244.3.160.89",4002,2,128,1,64,1,64,139.110956,0.0002230000000054133,0,0
"244.3.160.204",60258,"244.3.160.254",443,7,448,4,256,3,192,139.111223,0.15313199999999938,13374.082490922918,10030.561868192188
"244.3.160.204",60259,"244.3.160.254",80,7,448,4,256,3,192,139.111509,0.15385200000000054,13311.49416322175,9983.620622416312
"244.3.160.204",60260,"244.3.160.254",2784,2,128,1,64,1,64,139.111757,7.499999998117346e-5,0,0
"244.3.160.204",60261,"244.3.160.254",2785,2,128,1,64,1,64,139.112015,6.8999999996322e-5,0,0
"244.3.160.204",60262,"244.3.160.254",4000,7,448,4,256,3,192,139.112273,0.15540400000000432,13178.5539625746,9883.91547193095
"244.3.160.204",60263,"244.3.160.254",4001,2,128,1,64,1,64,139.112553,6.500000000642103e-5,0,0
"244.3.160.204",60264,"244.3.160.239",443,7,448,4,256,3,192,139.112827,0.16246899999998732,12605.481661117874,9454.111245838405
"244.3.160.204",60265,"244.3.160.239",8080,2,128,1,64,1,64,139.113088,7.299999998622297e-5,0,0
"244.3.160.204",60266,"244.3.160.239",80,7,448,4,256,3,192,139.11335,0.15674200000000837,13066.057597835235,9799.543198376427
"244.3.160.204",60583,"244.3.160.89",2048,2,128,1,64,1,64,141.110402,9.40000000184682e-5,0,0
"244.3.160.204",60584,"244.3.160.89",80,7,448,4,256,3,192,141.110677,0.15652399999999034,13084.255449644314,9813.191587233234
"244.3.160.204",60585,"244.3.160.89",443,13,3841,5,362,8,3479,141.110922,0.20352600000001075,14229.140257263676,136749.11313541527
"244.3.160.204",60586,"244.3.160.89",2784,2,128,1,64,1,64,141.111171,7.299999998622297e-5,0,0
"244.3.160.204",60587,"244.3.160.89",2785,2,128,1,64,1,64,141.111424,6.700000000137152e-5,0,0
"244.3.160.204",60588,"244.3.160.89",4000,2,128,1,64,1,64,141.111715,7.099999999127249e-5,0,0
"244.3.160.204",60589,"244.3.160.254",4002,2,128,1,64,1,64,141.111979,7.10000000196942e-5,0,0
"244.3.160.204",60590,"244.3.160.254",2048,2,128,1,64,1,64,141.112247,6.600000000389628e-5,0,0
"244.3.160.204",60591,"244.3.160.254",443,7,448,4,256,3,192,141.112499,0.15897799999999052,12882.285599266075,9661.714199449556
"244.3.160.204",60592,"244.3.160.254",80,7,448,4,256,3,192,141.11279,0.15941600000002154,12846.891152705646,9635.168364529234
"244.3.160.204",60593,"244.3.160.254",2784,2,128,1,64,1,64,141.113053,7.299999998622297e-5,0,0
"244.3.160.204",60594,"244.3.160.254",2785,2,128,1,64,1,64,141.113326,7.199999998874773e-5,0,0
"244.3.160.204",60595,"244.3.160.239",443,7,448,4,256,3,192,141.113613,0.1999540000000195,10242.35574181962,7681.766806364714
"244.3.160.204",60596,"244.3.160.239",8080,2,128,1,64,1,64,141.113898,6.999999999379725e-5,0,0
"244.3.160.204",60597,"244.3.160.239",80,7,448,4,256,3,192,141.114149,0.1613839999999982,12690.229514698005,9517.672136023504
"244.3.160.204",60917,"244.3.160.89",4001,2,128,1,64,1,64,143.110493,0.00010400000002164234,0,0
"244.3.160.204",60918,"244.3.160.89",4002,2,128,1,64,1,64,143.110773,8.800000000519503e-5,0,0
"244.3.160.204",60919,"244.3.160.89",2048,2,128,1,64,1,64,143.111059,8.599999998182284e-5,0,0
"244.3.160.204",60920,"244.3.160.89",80,7,448,4,256,3,192,143.111283,0.15966900000000805,12826.534894061444,9619.901170546083
"244.3.160.204",60921,"244.3.160.89",443,13,3841,5,362,8,3479,143.111527,0.20454300000000103,14158.392122927626,136069.1883858155
"244.3.160.204",60922,"244.3.160.89",2784,2,128,1,64,1,64,143.111806,6.700000000137152e-5,0,0
"244.3.160.204",60923,"244.3.160.254",4000,7,448,4,256,3,192,143.112109,0.1606299999999976,12749.797671667999,9562.348253750999
"244.3.160.204",60924,"244.3.160.254",4001,2,128,1,64,1,64,143.112354,5.999999999062311e-5,0,0
"244.3.160.204",60925,"244.3.160.254",4002,2,128,1,64,1,64,143.11261,7.000000002221896e-5,0,0
"244.3.160.204",60926,"244.3.160.254",2048,2,128,1,64,1,64,143.112898,7.199999998874773e-5,0,0
"244.3.160.204",60927,"244.3.160.254",443,7,448,4,256,3,192,143.113162,0.16108300000001918,12713.94250169016,9535.45687626762
"244.3.160.204",60928,"244.3.160.254",80,7,448,4,256,3,192,143.113404,0.16181199999999762,12656.663288260635,9492.497466195477
"244.3.160.204",60929,"244.3.160.239",443,7,448,4,256,3,192,143.113687,0.1861690000000067,11000.757376361942,8250.568032271456
"244.3.160.204",60930,"244.3.160.239",8080,2,128,1,64,1,64,143.113983,7.000000002221896e-5,0,0
"244.3.160.204",60931,"244.3.160.239",80,7,448,4,256,3,192,143.114252,0.16301599999999894,12563.183981940505,9422.387986455378
"244.3.160.204",61253,"244.3.160.89",2785,2,128,1,64,1,64,145.110362,0.0004289999999969041,0,0
"244.3.160.204",61254,"244.3.160.89",4000,2,128,1,64,1,64,145.110605,0.0002159999999946649,0,0
"244.3.160.204",61255,"244.3.160.89",4001,2,128,1,64,1,64,145.110892,7.700000000454565e-5,0,0
"244.3.160.204",61256,"244.3.160.89",4002,2,128,1,64,1,64,145.111121,6.799999999884676e-5,0,0
"244.3.160.204",61257,"244.3.160.89",2048,2,128,1,64,1,64,145.111367,6.999999999379725e-5,0,0
"244.3.160.204",61258,"244.3.160.89",80,7,448,4,256,3,192,145.111628,0.15102699999999913,13560.48918405326,10170.366888039945
"244.3.160.204",61259,"244.3.160.254",2784,2,128,1,64,1,64,145.111928,0.00011799999998629573,0,0
"244.3.160.204",61260,"244.3.160.254",2785,2,128,1,64,1,64,145.112195,6.8999999996322e-5,0,0
"244.3.160.204",61261,"244.3.160.254",4000,7,448,4,256,3,192,145.112438,0.15173300000000722,13497.393447700253,10123.04508577519
"244.3.160.204",61262,"244.3.160.254",4001,2,128,1,64,1,64,145.112713,6.999999999379725e-5,0,0
"244.3.160.204",61263,"244.3.160.254",4002,2,128,1,64,1,64,145.112981,6.600000000389628e-5,0,0
"244.3.160.204",61264,"244.3.160.254",2048,2,128,1,64,1,64,145.113239,6.600000000389628e-5,0,0
"244.3.160.204",61265,"244.3.160.239",443,7,448,4,256,3,192,145.113506,0.19260199999999372,10633.326756731845,7974.9950675488835
"244.3.160.204",61266,"244.3.160.239",8080,2,128,1,64,1,64,145.113783,7.299999998622297e-5,0,0
"244.3.160.204",61267,"244.3.160.239",80,7,448,4,256,3,192,145.114051,0.1531050000000107,13376.441004538434,10032.330753403825
"244.3.160.204",61584,"244.3.160.89",443,13,3841,5,362,8,3479,147.11013,0.20423199999999042,14179.952211211445,136276.39155470888
"244.3.160.204",61585,"244.3.160.89",2784,2,128,1,64,1,64,147.110378,8.099999999444663e-5,0,0
"244.3.160.204",61586,"244.3.160.89",2785,2,128,1,64,1,64,147.110624,7.199999998874773e-5,0,0
"244.3.160.204",61587,"244.3.160.89",4000,2,128,1,64,1,64,147.110865,7.200000001716944e-5,0,0
"244.3.160.204",61588,"244.3.160.89",4001,2,128,1,64,1,64,147.111142,6.8999999996322e-5,0,0
"244.3.160.204",61589,"244.3.160.89",4002,2,128,1,64,1,64,147.111388,6.799999999884676e-5,0,0
"244.3.160.204",61590,"244.3.160.254",443,7,448,4,256,3,192,147.11166,0.17492699999999672,11707.740943365166,8780.805707523874
"244.3.160.204",61591,"244.3.160.254",80,7,448,4,256,3,192,147.111908,0.1883850000000109,10871.35387636957,8153.5154072771775
"244.3.160.204",61592,"244.3.160.254",2784,2,128,1,64,1,64,147.112206,6.600000000389628e-5,0,0
"244.3.160.204",61593,"244.3.160.254",2785,2,128,1,64,1,64,147.112449,6.799999999884676e-5,0,0
"244.3.160.204",61594,"244.3.160.254",4000,7,448,4,256,3,192,147.112697,0.17444800000001237,11739.888104190675,8804.916078143006
"244.3.160.204",61595,"244.3.160.254",4001,2,128,1,64,1,64,147.112961,6.499999997799932e-5,0,0
"244.3.160.204",61596,"244.3.160.239",443,7,448,4,256,3,192,147.113271,0.1967649999999992,10408.35514446171,7806.266358346283
"244.3.160.204",61597,"244.3.160.239",8080,2,128,1,64,1,64,147.113509,7.400000001211993e-5,0,0
"244.3.160.204",61598,"244.3.160.239",80,7,448,4,256,3,192,147.113771,0.19505499999999643,10499.602676168453,7874.70200712634
"244.3.160.204",61923,"244.3.160.89",2048,2,128,1,64,1,64,149.110425,8.600000001024455e-5,0,0
"244.3.160.204",61924,"244.3.160.89",80,7,448,4,256,3,192,149.110664,0.15537599999998974,13180.928843580316,9885.696632685236
"244.3.160.204",61925,"244.3.160.89",443,13,3841,5,362,8,3479,149.110911,0.20094900000000848,14411.616877913688,138502.80419409316
"244.3.160.204",61926,"244.3.160.89",2784,2,128,1,64,1,64,149.111157,6.8999999996322e-5,0,0
"244.3.160.204",61927,"244.3.160.89",2785,2,128,1,64,1,64,149.111434,7.299999998622297e-5,0,0
"244.3.160.204",61928,"244.3.160.89",4000,2,128,1,64,1,64,149.11167,7.299999998622297e-5,0,0
"244.3.160.204",61929,"244.3.160.254",4002,2,128,1,64,1,64,149.111939,6.8999999996322e-5,0,0
"244.3.160.204",61930,"244.3.160.254",2048,2,128,1,64,1,64,149.11219,7.80000000020209e-5,0,0
"244.3.160.204",61931,"244.3.160.254",443,7,448,4,256,3,192,149.112528,0.15736200000000622,13014.57785233995,9760.933389254962
"244.3.160.204",61932,"244.3.160.254",80,7,448,4,256,3,192,149.112743,0.15797900000001164,12963.748346298236,9722.811259723678
"244.3.160.204",61933,"244.3.160.254",2784,2,128,1,64,1,64,149.112983,6.8999999996322e-5,0,0
"244.3.160.204",61934,"244.3.160.254",2785,2,128,1,64,1,64,149.113262,7.000000002221896e-5,0,0
"244.3.160.204",61935,"244.3.160.239",443,7,448,4,256,3,192,149.113542,0.18564700000001721,11031.689173538005,8273.766880153504
"244.3.160.204",61936,"244.3.160.239",8080,2,128,1,64,1,64,149.113804,6.700000000137152e-5,0,0
"244.3.160.204",61937,"244.3.160.239",80,7,448,4,256,3,192,149.114058,0.15928400000001375,12857.537480222893,9643.15311016717
"244.3.160.204",62254,"244.3.160.89",4001,2,128,1,64,1,64,151.112085,0.00010899999998059684,0,0
"244.3.160.204",62255,"244.3.160.89",4002,2,128,1,64,1,64,151.112326,7.099999999127249e-5,0,0
"244.3.160.204",62256,"244.3.160.89",2048,2,128,1,64,1,64,151.112604,6.999999999379725e-5,0,0
"244.3.160.204",62257,"244.3.160.89",80,7,448,4,256,3,192,151.112862,0.16524899999998865,12393.418417056324,9295.063812792243
"244.3.160.204",62258,"244.3.160.89",443,13,3841,5,362,8,3479,151.113119,0.21064699999999448,13748.118890846183,132126.25862224825
"244.3.160.204",62259,"244.3.160.89",2784,2,128,1,64,1,64,151.113422,6.799999999884676e-5,0,0
"244.3.160.204",62260,"244.3.160.254",4000,7,448,4,256,3,192,151.113696,0.1658390000000054,12349.32675667324,9261.99506750493
"244.3.160.204",62261,"244.3.160.254",4001,2,128,1,64,1,64,151.113949,6.600000000389628e-5,0,0
"244.3.160.204",62262,"244.3.160.254",4002,2,128,1,64,1,64,151.114222,6.399999998052408e-5,0,0
"244.3.160.204",62263,"244.3.160.254",2048,2,128,1,64,1,64,151.114505,6.799999999884676e-5,0,0
"244.3.160.204",62264,"244.3.160.254",443,7,448,4,256,3,192,151.114809,0.1666179999999997,12291.589144030078,9218.69185802256
"244.3.160.204",62265,"244.3.160.254",80,7,448,4,256,3,192,151.115084,0.16720399999999813,12248.510801177143,9186.383100882857
"244.3.160.204",62266,"244.3.160.239",443,7,448,4,256,3,192,151.115356,0.21448600000002216,9548.40875395032,7161.30656546274
"244.3.160.204",62267,"244.3.160.239",8080,2,128,1,64,1,64,151.115655,6.999999999379725e-5,0,0
"244.3.160.204",62268,"244.3.160.239",80,7,448,4,256,3,192,151.11592,0.17028799999999933,12026.684205581181,9020.013154185885
"244.3.160.204",62588,"244.3.160.89",2785,2,128,1,64,1,64,153.11131,9.900000000584441e-5,0,0
"244.3.160.204",62589,"244.3.160.89",4000,2,128,1,64,1,64,153.111575,7.500000000959517e-5,0,0
"244.3.160.204",62590,"244.3.160.89",4001,2,128,1,64,1,64,153.111834,6.900000002474371e-5,0,0
"244.3.160.204",62591,"244.3.160.89",4002,2,128,1,64,1,64,153.112077,8.50000000127693e-5,0,0
"244.3.160.204",62592,"244.3.160.89",2048,2,128,1,64,1,64,153.112332,7.299999998622297e-5,0,0
"244.3.160.204",62593,"244.3.160.89",80,7,448,4,256,3,192,153.112598,0.1585450000000037,12917.468226686127,9688.101170014595
"244.3.160.204",62594,"244.3.160.254",2784,2,128,1,64,1,64,153.112866,9.000000000014552e-5,0,0
"244.3.160.204",62595,"244.3.160.254",2785,2,128,1,64,1,64,153.113125,6.400000000894579e-5,0,0
"244.3.160.204",62596,"244.3.160.254",4000,7,448,4,256,3,192,153.113373,0.15916599999999903,12867.069600291597,9650.302200218699
"244.3.160.204",62597,"244.3.160.254",4001,2,128,1,64,1,64,153.113659,6.700000000137152e-5,0,0
"244.3.160.204",62598,"244.3.160.254",4002,2,128,1,64,1,64,153.113915,6.600000000389628e-5,0,0
"244.3.160.204",62599,"244.3.160.254",2048,2,128,1,64,1,64,153.114191,6.400000000894579e-5,0,0
"244.3.160.204",62600,"244.3.160.239",443,7,448,4,256,3,192,153.114448,0.20286899999999264,10095.184577239866,7571.388432929899
"244.3.160.204",62601,"244.3.160.239",8080,2,128,1,64,1,64,153.114755,7.099999999127249e-5,0,0
"244.3.160.204",62602,"244.3.160.239",80,7,448,4,256,3,192,153.115073,0.1602010000000007,12783.940175154905,9587.95513136618
"244.3.160.204",62924,"244.3.160.89",443,13,3841,5,362,8,3479,155.111137,0.19907999999998083,14546.915812739999,139803.09423348744
"244.3.160.204",62925,"244.3.160.89",2784,2,128,1,64,1,64,155.111367,7.999999999697138e-5,0,0
"244.3.160.204",62926,"244.3.160.89",2785,2,128,1,64,1,64,155.111614,7.099999999127249e-5,0,0
"244.3.160.204",62927,"244.3.160.89",4000,2,128,1,64,1,64,155.111969,7.10000000196942e-5,0,0
"244.3.160.204",62928,"244.3.160.89",4001,2,128,1,64,1,64,155.112158,6.500000000642103e-5,0,0
"244.3.160.204",62929,"244.3.160.89",4002,2,128,1,64,1,64,155.112396,7.000000002221896e-5,0,0
"244.3.160.204",62930,"244.3.160.254",443,7,448,4,256,3,192,155.112664,0.15790100000000962,12970.15218396258,9727.614137971934
"244.3.160.204",62931,"244.3.160.254",80,7,448,4,256,3,192,155.112942,0.1583389999999838,12934.2739312501,9700.705448437575
"244.3.160.204",62932,"244.3.160.254",2784,2,128,1,64,1,64,155.113196,6.900000002474371e-5,0,0
"244.3.160.204",62933,"244.3.160.254",2785,2,128,1,64,1,64,155.113459,6.500000000642103e-5,0,0
"244.3.160.204",62934,"244.3.160.254",4000,7,448,4,256,3,192,155.113724,0.16010300000002076,12791.765301085767,9593.823975814325
"244.3.160.204",62935,"244.3.160.254",4001,2,128,1,64,1,64,155.113997,6.8999999996322e-5,0,0
"244.3.160.204",62936,"244.3.160.239",443,7,448,4,256,3,192,155.114262,0.2041590000000042,10031.397097360184,7523.547823020138
"244.3.160.204",62937,"244.3.160.239",8080,2,128,1,64,1,64,155.114509,6.799999999884676e-5,0,0
"244.3.160.204",62938,"244.3.160.239",80,7,448,4,256,3,192,155.114823,0.16209399999999619,12634.64409540173,9475.983071551298
"244.3.160.204",63255,"244.3.160.89",2048,2,128,1,64,1,64,157.111665,8.50000000127693e-5,0,0
"244.3.160.204",63256,"244.3.160.89",80,7,448,4,256,3,192,157.111931,0.15711799999999698,13034.789139373206,9776.091854529905
"244.3.160.204",63257,"244.3.160.89",443,13,3841,5,362,8,3479,157.112199,0.20657399999998916,14019.189249373841,134731.37955406518
"244.3.160.204",63258,"244.3.160.89",2784,2,128,1,64,1,64,157.112432,7.099999999127249e-5,0,0
"244.3.160.204",63259,"244.3.160.89",2785,2,128,1,64,1,64,157.112688,6.8999999996322e-5,0,0
"244.3.160.204",63260,"244.3.160.89",4000,2,128,1,64,1,64,157.112961,7.299999998622297e-5,0,0
"244.3.160.204",63261,"244.3.160.254",4002,2,128,1,64,1,64,157.113237,7.300000001464468e-5,0,0
"244.3.160.204",63262,"244.3.160.254",2048,2,128,1,64,1,64,157.113535,6.999999999379725e-5,0,0
"244.3.160.204",63263,"244.3.160.254",443,7,448,4,256,3,192,157.113755,0.15983700000001022,12813.053298046567,9609.789973534926
"244.3.160.204",63264,"244.3.160.254",80,7,448,4,256,3,192,157.114038,0.16052400000000944,12758.216839848743,9568.662629886558
"244.3.160.204",63265,"244.3.160.254",2784,2,128,1,64,1,64,157.114298,7.400000001211993e-5,0,0
"244.3.160.204",63266,"244.3.160.254",2785,2,128,1,64,1,64,157.114563,6.999999999379725e-5,0,0
"244.3.160.204",63267,"244.3.160.239",443,7,448,4,256,3,192,157.11493,0.20550600000001396,9965.645771898928,7474.234328924195
"244.3.160.204",63268,"244.3.160.239",8080,2,128,1,64,1,64,157.115168,6.999999999379725e-5,0,0
"244.3.160.204",63269,"244.3.160.239",80,7,448,4,256,3,192,157.115423,0.1613140000000044,12695.736265915817,9521.802199436863
"244.3.160.204",63594,"244.3.160.89",4001,2,128,1,64,1,64,159.111382,8.50000000127693e-5,0,0
"244.3.160.204",63595,"244.3.160.89",4002,2,128,1,64,1,64,159.111622,7.099999999127249e-5,0,0
"244.3.160.204",63596,"244.3.160.89",2048,2,128,1,64,1,64,159.111888,6.999999999379725e-5,0,0
"244.3.160.204",63597,"244.3.160.89",80,7,448,4,256,3,192,159.1122,0.16050699999999551,12759.568118524783,9569.676088893586
"244.3.160.204",63598,"244.3.160.89",443,13,3841,5,362,8,3479,159.112404,0.2047770000000071,14142.213236837631,135913.70124574067
"244.3.160.204",63599,"244.3.160.89",2784,2,128,1,64,1,64,159.112668,6.999999999379725e-5,0,0
"244.3.160.204",63600,"244.3.160.254",4000,7,448,4,256,3,192,159.112931,0.16162199999999416,12671.54224053702,9503.656680402764
"244.3.160.204",63601,"244.3.160.254",4001,2,128,1,64,1,64,159.11321,6.700000000137152e-5,0,0
"244.3.160.204",63602,"244.3.160.254",4002,2,128,1,64,1,64,159.113526,6.700000000137152e-5,0,0
"244.3.160.204",63603,"244.3.160.254",2048,2,128,1,64,1,64,159.113718,6.799999999884676e-5,0,0
"244.3.160.204",63604,"244.3.160.254",443,7,448,4,256,3,192,159.113994,0.16261199999999576,12594.396477505064,9445.797358128797
"244.3.160.204",63605,"244.3.160.254",80,7,448,4,256,3,192,159.114328,0.16318100000000868,12550.480754498936,9412.860565874204
"244.3.160.204",63606,"244.3.160.239",443,7,448,4,256,3,192,159.114539,0.1989539999999863,10293.836766288394,7720.3775747162945
"244.3.160.204",63607,"244.3.160.239",8080,2,128,1,64,1,64,159.114838,7.000000002221896e-5,0,0
"244.3.160.204",63608,"244.3.160.239",80,7,448,4,256,3,192,159.11513,0.16445300000000884,12453.406140355542,9340.054605266656
"244.3.160.204",63925,"244.3.160.89",2785,2,128,1,64,1,64,161.111912,8.100000002286833e-5,0,0
"244.3.160.204",63926,"244.3.160.89",4000,2,128,1,64,1,64,161.112156,6.700000000137152e-5,0,0
"244.3.160.204",63927,"244.3.160.89",4001,2,128,1,64,1,64,161.112423,6.700000000137152e-5,0,0
"244.3.160.204",63928,"244.3.160.89",4002,2,128,1,64,1,64,161.112687,6.300000001147055e-5,0,0
"244.3.160.204",63929,"244.3.160.89",2048,2,128,1,64,1,64,161.112904,6.700000000137152e-5,0,0
"244.3.160.204",63930,"244.3.160.89",80,7,448,4,256,3,192,161.113152,0.15416699999997263,13284.295601525382,9963.221701144037
"244.3.160.204",63931,"244.3.160.254",2784,2,128,1,64,1,64,161.113451,6.700000000137152e-5,0,0
"244.3.160.204",63932,"244.3.160.254",2785,2,128,1,64,1,64,161.113711,7.200000001716944e-5,0,0
"244.3.160.204",63933,"244.3.160.254",4000,7,448,4,256,3,192,161.113956,0.15605500000000916,13123.578225624811,9842.683669218608
"244.3.160.204",63934,"244.3.160.254",4001,2,128,1,64,1,64,161.114233,7.099999999127249e-5,0,0
"244.3.160.204",63935,"244.3.160.254",4002,2,128,1,64,1,64,161.11449,6.900000002474371e-5,0,0
"244.3.160.204",63936,"244.3.160.254",2048,2,128,1,64,1,64,161.114781,7.500000000959517e-5,0,0
"244.3.160.204",63937,"244.3.160.239",443,7,448,4,256,3,192,161.115057,0.16991600000000062,12053.014430659812,9039.760822994858
"244.3.160.204",63938,"244.3.160.239",8080,2,128,1,64,1,64,161.115339,6.799999999884676e-5,0,0
"244.3.160.204",63939,"244.3.160.239",80,7,448,4,256,3,192,161.115594,0.15731400000001372,13018.548889481046,9763.911667110786
"244.3.160.204",64259,"244.3.160.89",443,13,3841,5,362,8,3479,163.112008,0.20705300000000193,13986.757013904522,134419.6896446791
"244.3.160.204",64260,"244.3.160.89",2784,2,128,1,64,1,64,163.112256,7.700000000454565e-5,0,0
"244.3.160.204",64261,"244.3.160.89",2785,2,128,1,64,1,64,163.112531,7.200000001716944e-5,0,0
"244.3.160.204",64262,"244.3.160.89",4000,2,128,1,64,1,64,163.112783,8.49999999843476e-5,0,0
"244.3.160.204",64263,"244.3.160.89",4001,2,128,1,64,1,64,163.113072,5.1000000013345925e-5,0,0
"244.3.160.204",64264,"244.3.160.89",4002,2,128,1,64,1,64,163.113339,6.700000000137152e-5,0,0
"244.3.160.204",64265,"244.3.160.254",443,7,448,4,256,3,192,163.113597,0.16159899999999539,12673.345750902286,9505.009313176713
"244.3.160.204",64266,"244.3.160.254",80,7,448,4,256,3,192,163.11385,0.16224299999998948,12623.040747521512,9467.280560641135
"244.3.160.204",64267,"244.3.160.254",2784,2,128,1,64,1,64,163.114112,6.999999999379725e-5,0,0
"244.3.160.204",64268,"244.3.160.254",2785,2,128,1,64,1,64,163.114394,6.700000000137152e-5,0,0
"244.3.160.204",64269,"244.3.160.254",4000,7,448,4,256,3,192,163.114675,0.16280399999999418,12579.54350016015,9434.657625120113
"244.3.160.204",64270,"244.3.160.254",4001,2,128,1,64,1,64,163.114951,6.799999999884676e-5,0,0
"244.3.160.204",64271,"244.3.160.239",443,7,448,4,256,3,192,163.11523,0.2163099999999929,9467.893301280881,7100.91997596066
"244.3.160.204",64272,"244.3.160.239",8080,2,128,1,64,1,64,163.115537,7.000000002221896e-5,0,0
"244.3.160.204",64273,"244.3.160.239",80,7,448,4,256,3,192,163.115795,0.16445900000002212,12452.951799534989,9339.713849651242
"244.3.160.204",64595,"244.3.160.89",2048,2,128,1,64,1,64,165.112251,8.800000000519503e-5,0,0
"244.3.160.204",64596,"244.3.160.89",80,7,448,4,256,3,192,165.112503,0.15418499999998403,13282.744754679197,9962.058566009398
"244.3.160.204",64597,"244.3.160.89",443,13,3841,5,362,8,3479,165.112778,0.1990729999999985,14547.427325654518,139808.01012693942
"244.3.160.204",64598,"244.3.160.89",2784,2,128,1,64,1,64,165.113024,7.200000001716944e-5,0,0
"244.3.160.204",64599,"244.3.160.89",2785,2,128,1,64,1,64,165.11328,6.799999999884676e-5,0,0
"244.3.160.204",64600,"244.3.160.89",4000,2,128,1,64,1,64,165.113551,6.400000000894579e-5,0,0
"244.3.160.204",64601,"244.3.160.254",4002,2,128,1,64,1,64,165.113819,6.999999999379725e-5,0,0
"244.3.160.204",64602,"244.3.160.254",2048,2,128,1,64,1,64,165.114088,6.700000000137152e-5,0,0
"244.3.160.204",64603,"244.3.160.254",443,7,448,4,256,3,192,165.114329,0.15535299999999097,13182.88027910706,9887.160209330295
"244.3.160.204",64604,"244.3.160.254",80,7,448,4,256,3,192,165.114613,0.15650600000000736,13085.760290339691,9814.320217754768
"244.3.160.204",64605,"244.3.160.254",2784,2,128,1,64,1,64,165.11491,7.80000000020209e-5,0,0
"244.3.160.204",64606,"244.3.160.254",2785,2,128,1,64,1,64,165.115162,7.700000000454565e-5,0,0
"244.3.160.204",64607,"244.3.160.239",443,7,448,4,256,3,192,165.115448,0.19921200000001704,10280.505190449496,7710.378892837121
"244.3.160.204",64608,"244.3.160.239",8080,2,128,1,64,1,64,165.115731,8.699999997929808e-5,0,0
"244.3.160.204",64609,"244.3.160.239",80,7,448,4,256,3,192,165.116012,0.15782600000000002,12976.31568943013,9732.236767072598
"244.3.160.204",64926,"244.3.160.89",4001,2,128,1,64,1,64,167.111934,8.800000000519503e-5,0,0
"244.3.160.204",64927,"244.3.160.89",4002,2,128,1,64,1,64,167.112203,7.300000001464468e-5,0,0
"244.3.160.204",64928,"244.3.160.89",2048,2,128,1,64,1,64,167.112451,6.999999999379725e-5,0,0
"244.3.160.204",64929,"244.3.160.89",80,7,448,4,256,3,192,167.112666,0.15871100000001093,12903.957507670288,9677.968130752715
"244.3.160.204",64930,"244.3.160.89",443,13,3841,5,362,8,3479,167.112967,0.2060419999999965,14055.386765805268,135079.25568573628
"244.3.160.204",64931,"244.3.160.89",2784,2,128,1,64,1,64,167.113184,7.400000001211993e-5,0,0
"244.3.160.204",64932,"244.3.160.254",4000,7,448,4,256,3,192,167.11346,0.15993599999998764,12805.122048820516,9603.841536615388
"244.3.160.204",64933,"244.3.160.254",4001,2,128,1,64,1,64,167.113739,6.999999999379725e-5,0,0
"244.3.160.204",64934,"244.3.160.254",4002,2,128,1,64,1,64,167.114001,6.799999999884676e-5,0,0
"244.3.160.204",64935,"244.3.160.254",2048,2,128,1,64,1,64,167.114239,6.999999999379725e-5,0,0
"244.3.160.204",64936,"244.3.160.254",443,7,448,4,256,3,192,167.114513,0.16129600000002142,12697.153060210594,9522.864795157946
"244.3.160.204",64937,"244.3.160.254",80,7,448,4,256,3,192,167.114827,0.1620240000000024,12640.102700834257,9480.077025625693
"244.3.160.204",64938,"244.3.160.239",443,7,448,4,256,3,192,167.115144,0.19934600000001979,10273.594654519262,7705.195990889446
"244.3.160.204",64939,"244.3.160.239",8080,2,128,1,64,1,64,167.115393,7.199999998874773e-5,0,0
"244.3.160.204",64940,"244.3.160.239",80,7,448,4,256,3,192,167.115647,0.1625970000000052,12595.558343634473,9446.668757725854
"244.3.160.204",65265,"244.3.160.89",2785,2,128,1,64,1,64,169.112728,9.399999999004649e-5,0,0
"244.3.160.204",65266,"244.3.160.89",4000,2,128,1,64,1,64,169.113022,7.700000000454565e-5,0,0
"244.3.160.204",65267,"244.3.160.89",4001,2,128,1,64,1,64,169.113241,6.900000002474371e-5,0,0
"244.3.160.204",65268,"244.3.160.89",4002,2,128,1,64,1,64,169.113488,7.000000002221896e-5,0,0
"244.3.160.204",65269,"244.3.160.89",2048,2,128,1,64,1,64,169.113737,7.000000002221896e-5,0,0
"244.3.160.204",65270,"244.3.160.89",80,7,448,4,256,3,192,169.114019,0.15674599999999828,13065.724165210102,9799.293123907575
"244.3.160.204",65271,"244.3.160.254",2784,2,128,1,64,1,64,169.1143,7.200000001716944e-5,0,0
"244.3.160.204",65272,"244.3.160.254",2785,2,128,1,64,1,64,169.114587,6.799999999884676e-5,0,0
"244.3.160.204",65273,"244.3.160.254",4000,7,448,4,256,3,192,169.114884,0.1575210000000027,13001.441077697355,9751.080808273016
"244.3.160.204",65274,"244.3.160.254",4001,2,128,1,64,1,64,169.115138,6.999999999379725e-5,0,0
"244.3.160.204",65275,"244.3.160.254",4002,2,128,1,64,1,64,169.115396,7.099999999127249e-5,0,0
"244.3.160.204",65276,"244.3.160.254",2048,2,128,1,64,1,64,169.115656,6.700000000137152e-5,0,0
"244.3.160.204",65277,"244.3.160.239",443,7,448,4,256,3,192,169.115952,0.16893799999999715,12122.790609572947,9092.092957179711
"244.3.160.204",65278,"244.3.160.239",8080,2,128,1,64,1,64,169.116229,7.399999998369822e-5,0,0
"244.3.160.204",65279,"244.3.160.239",80,7,448,4,256,3,192,169.116468,0.15882799999999975,12894.451859873594,9670.838894905195
"244.3.160.204",1084,"244.3.160.89",443,13,3841,5,362,8,3479,171.113233,0.19516400000000544,14838.802238117272,142608.26791825963
"244.3.160.204",1090,"244.3.160.254",443,7,448,4,256,3,192,171.114808,0.15578299999998535,13146.492235996178,9859.869176997134
"244.3.160.204",1091,"244.3.160.254",80,7,448,4,256,3,192,171.115096,0.15599299999999516,13128.794240767622,9846.595680575716
"244.3.160.204",1096,"244.3.160.239",443,7,448,4,256,3,192,171.116437,0.1980180000000189,10342.494116695474,7756.8705875216065
"244.3.160.204",1098,"244.3.160.239",80,7,448,4,256,3,192,171.11695,0.15827699999999822,12939.34052326,9704.505392445
"244.3.160.204",1419,"244.3.160.89",80,7,448,4,256,3,192,173.113066,0.1615639999999985,12676.091208437641,9507.068406328232
"244.3.160.204",1420,"244.3.160.89",443,13,3841,5,362,8,3479,173.113321,0.20823799999999437,13907.163918209348,133654.76041837106
"244.3.160.204",1426,"244.3.160.254",443,7,448,4,256,3,192,173.114972,0.16247599999999807,12604.938575543614,9453.703931657712
"244.3.160.204",1427,"244.3.160.254",80,7,448,4,256,3,192,173.115187,0.1630750000000205,12558.638663190204,9418.978997392653
"244.3.160.204",1430,"244.3.160.239",443,7,448,4,256,3,192,173.115991,0.19212500000000432,10659.726740403143,7994.7950553023575
"244.3.160.204",1432,"244.3.160.239",80,7,448,4,256,3,192,173.116548,0.16488100000000827,12421.079445174988,9315.80958388124
"244.3.160.204",1757,"244.3.160.89",80,7,448,4,256,3,192,175.1134,0.1547159999999792,13237.157113681036,9927.867835260777
"244.3.160.204",1758,"244.3.160.89",443,13,3841,5,362,8,3479,175.113657,0.2007949999999994,14422.66988719843,138609.029109291
"244.3.160.204",1764,"244.3.160.254",443,7,448,4,256,3,192,175.115288,0.15669800000000578,13069.726480235386,9802.29486017654
"244.3.160.204",1765,"244.3.160.254",80,7,448,4,256,3,192,175.115584,0.1573749999999734,13013.502779986315,9760.127084989736
"244.3.160.204",1766,"244.3.160.239",443,7,448,4,256,3,192,175.115868,0.19652999999999565,10420.800895537808,7815.600671653356
"244.3.160.204",1768,"244.3.160.239",80,7,448,4,256,3,192,175.116407,0.15809899999999288,12953.90862687362,9715.431470155214
"244.3.160.204",2089,"244.3.160.89",2048,2,128,1,64,1,64,177.114129,6.600000000389628e-5,0,0
"244.3.160.204",2090,"244.3.160.89",80,7,448,4,256,3,192,177.114375,0.1554399999999987,13175.501801338249,9881.626351003686
"244.3.160.204",2096,"244.3.160.254",2048,2,128,1,64,1,64,177.116038,8.099999999444663e-5,0,0
"244.3.160.204",2097,"244.3.160.239",443,7,448,4,256,3,192,177.116324,0.1586200000000133,12911.360484174935,9683.520363131202
"244.3.160.204",2099,"244.3.160.239",80,7,448,4,256,3,192,177.116915,0.15679199999999582,13061.890912802022,9796.418184601516
"244.3.160.204",2424,"244.3.160.89",443,13,3841,5,362,8,3479,179.113041,0.20123099999997862,14391.420804947089,138308.7098906379
"244.3.160.204",2430,"244.3.160.254",443,7,448,4,256,3,192,179.114525,0.15860900000001266,12912.255924946481,9684.191943709862
"244.3.160.204",2431,"244.3.160.254",80,7,448,4,256,3,192,179.114867,0.15895900000001006,12883.825388935955,9662.869041701966
"244.3.160.204",2436,"244.3.160.239",443,7,448,4,256,3,192,179.116186,0.19794799999999668,10346.151514539346,7759.613635904509
"244.3.160.204",2438,"244.3.160.239",80,7,448,4,256,3,192,179.116716,0.16181000000000267,12656.819726839913,9492.614795129934
"244.3.160.204",2755,"244.3.160.89",2048,2,128,1,64,1,64,181.113682,9.299999999257125e-5,0,0
"244.3.160.204",2756,"244.3.160.89",80,7,448,4,256,3,192,181.113928,0.1549500000000137,13217.166828007868,9912.8751210059
"244.3.160.204",2757,"244.3.160.89",443,13,3841,5,362,8,3479,181.11421,0.19915299999999547,14541.583606574171,139751.84908086061
"244.3.160.204",2762,"244.3.160.254",2048,2,128,1,64,1,64,181.115525,7.10000000196942e-5,0,0
"244.3.160.204",2763,"244.3.160.254",443,7,448,4,256,3,192,181.11579,0.15672000000000708,13067.891781520595,9800.918836140445
"244.3.160.204",2764,"244.3.160.254",80,7,448,4,256,3,192,181.116072,0.15719400000000405,13028.487092382325,9771.365319286744
"244.3.160.204",2767,"244.3.160.239",443,7,448,4,256,3,192,181.116912,0.18145099999998138,11286.793679837589,8465.095259878191
"244.3.160.204",2769,"244.3.160.239",80,7,448,4,256,3,192,181.11742,0.1586240000000032,12911.034900140954,9683.276175105715
"244.3.160.204",3091,"244.3.160.89",2048,2,128,1,64,1,64,183.113988,0.0001859999999851425,0,0
"244.3.160.204",3092,"244.3.160.89",80,7,448,4,256,3,192,183.114275,0.16170100000002208,12665.351482054659,9499.013611540993
"244.3.160.204",3093,"244.3.160.89",443,13,3841,5,362,8,3479,183.114574,0.2110619999999983,13721.086694904925,131866.46577782938
"244.3.160.204",3094,"244.3.160.89",2784,2,128,1,64,1,64,183.114751,0.00024199999998586463,0,0
"244.3.160.204",3098,"244.3.160.254",2048,2,128,1,64,1,64,183.115838,0.00017099999999459214,0,0
"244.3.160.204",3099,"244.3.160.254",443,7,448,4,256,3,192,183.116096,0.16350099999999657,12525.917272677494,9394.437954508121
"244.3.160.204",3100,"244.3.160.254",80,7,448,4,256,3,192,183.116354,0.16435599999999795,12460.755920076088,9345.566940057066
"244.3.160.204",3101,"244.3.160.239",443,7,448,4,256,3,192,183.116633,0.21241000000000554,9641.730615319178,7231.297961489384
"244.3.160.204",3103,"244.3.160.239",80,7,448,4,256,3,192,183.117176,0.16567499999999313,12361.551229817926,9271.163422363445
"244.3.160.204",3425,"244.3.160.89",2785,2,128,1,64,1,64,185.113218,7.80000000020209e-5,0,0
"244.3.160.204",3429,"244.3.160.89",2048,2,128,1,64,1,64,185.114218,7.10000000196942e-5,0,0
"244.3.160.204",3430,"244.3.160.89",80,7,448,4,256,3,192,185.114472,0.15141800000000671,13525.472532987553,10144.104399740665
"244.3.160.204",3431,"244.3.160.254",2784,2,128,1,64,1,64,185.114776,6.799999999884676e-5,0,0
"244.3.160.204",3432,"244.3.160.254",2785,2,128,1,64,1,64,185.115032,7.099999999127249e-5,0,0
"244.3.160.204",3436,"244.3.160.254",2048,2,128,1,64,1,64,185.116088,7.600000000707041e-5,0,0
"244.3.160.204",3437,"244.3.160.239",443,7,448,4,256,3,192,185.116392,0.18227100000001428,11236.016700406753,8427.012525305066
"244.3.160.204",3439,"244.3.160.239",80,7,448,4,256,3,192,185.116917,0.1541650000000061,13284.467940193423,9963.350955145066
"244.3.160.204",3756,"244.3.160.89",443,13,3841,5,362,8,3479,187.113667,0.2033749999999941,14239.70497848843,136850.64535956146
"244.3.160.204",3757,"244.3.160.89",2784,2,128,1,64,1,64,187.11389,7.80000000020209e-5,0,0
"244.3.160.204",3758,"244.3.160.89",2785,2,128,1,64,1,64,187.114116,6.20000000139953e-5,0,0
"244.3.160.204",3762,"244.3.160.254",443,7,448,4,256,3,192,187.115181,0.1566349999999943,13074.983241293929,9806.237430970446
"244.3.160.204",3763,"244.3.160.254",80,7,448,4,256,3,192,187.115459,0.15811100000001943,12952.925476404225,9714.694107303168
"244.3.160.204",3764,"244.3.160.254",2784,2,128,1,64,1,64,187.115723,8.900000000267028e-5,0,0
"244.3.160.204",3765,"244.3.160.254",2785,2,128,1,64,1,64,187.115967,7.499999998117346e-5,0,0
"244.3.160.204",3768,"244.3.160.239",443,7,448,4,256,3,192,187.116781,0.20908099999999763,9795.246818218888,7346.435113664165
"244.3.160.204",3770,"244.3.160.239",80,7,448,4,256,3,192,187.117283,0.16121700000002193,12703.374954252477,9527.531215689358
"244.3.160.204",4095,"244.3.160.89",2048,2,128,1,64,1,64,189.113691,8.700000000771979e-5,0,0
"244.3.160.204",4096,"244.3.160.89",80,7,448,4,256,3,192,189.113934,0.15593599999999697,13133.593269033705,9850.194951775278
"244.3.160.204",4097,"244.3.160.89",443,13,3841,5,362,8,3479,189.114234,0.1991379999999765,14542.67894626009,139762.37583988634
"244.3.160.204",4098,"244.3.160.89",2784,2,128,1,64,1,64,189.114513,6.900000002474371e-5,0,0
"244.3.160.204",4099,"244.3.160.89",2785,2,128,1,64,1,64,189.114726,6.500000000642103e-5,0,0
"244.3.160.204",4100,"244.3.160.89",4000,2,128,1,64,1,64,189.115002,6.999999999379725e-5,0,0
"244.3.160.204",4101,"244.3.160.254",4002,2,128,1,64,1,64,189.115299,6.500000000642103e-5,0,0
"244.3.160.204",4102,"244.3.160.254",2048,2,128,1,64,1,64,189.115535,6.600000000389628e-5,0,0
"244.3.160.204",4103,"244.3.160.254",443,7,448,4,256,3,192,189.115796,0.15770700000001625,12986.107148064379,9739.580361048284
"244.3.160.204",4104,"244.3.160.254",80,7,448,4,256,3,192,189.116048,0.15820700000000443,12945.065641848607,9708.799231386456
"244.3.160.204",4105,"244.3.160.254",2784,2,128,1,64,1,64,189.116363,7.099999999127249e-5,0,0
"244.3.160.204",4106,"244.3.160.254",2785,2,128,1,64,1,64,189.11664,6.700000000137152e-5,0,0
"244.3.160.204",4107,"244.3.160.239",443,7,448,4,256,3,192,189.116877,0.19442700000001878,10533.516435473479,7900.13732660511
"244.3.160.204",4109,"244.3.160.239",80,7,448,4,256,3,192,189.117385,0.1595659999999839,12834.814434153936,9626.110825615451
"244.3.160.204",4426,"244.3.160.89",4001,2,128,1,64,1,64,191.114838,8.300000001781882e-5,0,0
"244.3.160.204",4427,"244.3.160.89",4002,2,128,1,64,1,64,191.115085,7.10000000196942e-5,0,0
"244.3.160.204",4428,"244.3.160.89",2048,2,128,1,64,1,64,191.115336,7.099999999127249e-5,0,0
"244.3.160.204",4429,"244.3.160.89",80,7,448,4,256,3,192,191.115592,0.15769900000000803,12986.765927494123,9740.074445620592
"244.3.160.204",4430,"244.3.160.89",443,13,3841,5,362,8,3479,191.115881,0.2058370000000025,14069.384998809568,135213.78566535492
"244.3.160.204",4431,"244.3.160.89",2784,2,128,1,64,1,64,191.116137,7.399999998369822e-5,0,0
"244.3.160.204",4432,"244.3.160.254",4000,7,448,4,256,3,192,191.116421,0.16908699999999044,12112.10796808812,9084.080976066089
"244.3.160.204",4433,"244.3.160.254",4001,2,128,1,64,1,64,191.116714,6.8999999996322e-5,0,0
"244.3.160.204",4434,"244.3.160.254",4002,2,128,1,64,1,64,191.116984,6.8999999996322e-5,0,0
"244.3.160.204",4435,"244.3.160.254",2048,2,128,1,64,1,64,191.117239,6.999999999379725e-5,0,0
"244.3.160.204",4436,"244.3.160.254",443,7,448,4,256,3,192,191.11751,0.16886399999998503,12128.103088877331,9096.077316657998
"244.3.160.204",4437,"244.3.160.254",80,7,448,4,256,3,192,191.117848,0.16009199999999169,12792.644229568663,9594.483172176497
"244.3.160.204",4438,"244.3.160.239",443,7,448,4,256,3,192,191.118084,0.18949499999999375,10807.673025673857,8105.754769255393
"244.3.160.204",4440,"244.3.160.239",80,7,448,4,256,3,192,191.118637,0.16149899999999207,12681.193072403548,9510.894804302661
"244.3.160.204",4760,"244.3.160.89",2785,2,128,1,64,1,64,193.113908,9.399999999004649e-5,0,0
"244.3.160.204",4761,"244.3.160.89",4000,2,128,1,64,1,64,193.114147,7.399999998369822e-5,0,0
"244.3.160.204",4762,"244.3.160.89",4001,2,128,1,64,1,64,193.1144,6.799999999884676e-5,0,0
"244.3.160.204",4763,"244.3.160.89",4002,2,128,1,64,1,64,193.114643,8.299999998939711e-5,0,0
"244.3.160.204",4764,"244.3.160.89",2048,2,128,1,64,1,64,193.114933,6.8999999996322e-5,0,0
"244.3.160.204",4765,"244.3.160.89",80,7,448,4,256,3,192,193.115184,0.1575679999999977,12997.562956945761,9748.172217709322
"244.3.160.204",4766,"244.3.160.254",2784,2,128,1,64,1,64,193.115458,7.500000000959517e-5,0,0
"244.3.160.204",4767,"244.3.160.254",2785,2,128,1,64,1,64,193.115729,0.00013200000000779255,0,0
"244.3.160.204",4768,"244.3.160.254",4000,7,448,4,256,3,192,193.115993,0.15837999999999397,12930.925621922452,9698.19421644184
"244.3.160.204",4769,"244.3.160.254",4001,2,128,1,64,1,64,193.116243,6.8999999996322e-5,0,0
"244.3.160.204",4770,"244.3.160.254",4002,2,128,1,64,1,64,193.116496,6.8999999996322e-5,0,0
"244.3.160.204",4771,"244.3.160.254",2048,2,128,1,64,1,64,193.116767,7.099999999127249e-5,0,0
"244.3.160.204",4772,"244.3.160.239",443,7,448,4,256,3,192,193.117055,0.16863700000001813,12144.428565497368,9108.321424123027
"244.3.160.204",4774,"244.3.160.239",80,7,448,4,256,3,192,193.117574,0.15971200000001318,12823.081546783154,9617.311160087365
"244.3.160.204",5096,"244.3.160.89",443,13,3841,5,362,8,3479,195.114231,0.19571500000000697,14797.026288224699,142206.78026722025
"244.3.160.204",5097,"244.3.160.89",2784,2,128,1,64,1,64,195.114468,7.80000000020209e-5,0,0
"244.3.160.204",5098,"244.3.160.89",2785,2,128,1,64,1,64,195.114769,7.500000000959517e-5,0,0
"244.3.160.204",5099,"244.3.160.89",4000,2,128,1,64,1,64,195.115053,7.600000000707041e-5,0,0
"244.3.160.204",5100,"244.3.160.89",4001,2,128,1,64,1,64,195.115297,6.999999999379725e-5,0,0
"244.3.160.204",5101,"244.3.160.89",4002,2,128,1,64,1,64,195.115533,7.099999999127249e-5,0,0
"244.3.160.204",5102,"244.3.160.254",443,7,448,4,256,3,192,195.115797,0.155571000000009,13164.407248136744,9873.305436102559
"244.3.160.204",5103,"244.3.160.254",80,7,448,4,256,3,192,195.116073,0.155698000000001,13153.66928284234,9865.251962131755
"244.3.160.204",5104,"244.3.160.254",2784,2,128,1,64,1,64,195.116359,7.400000001211993e-5,0,0
"244.3.160.204",5105,"244.3.160.254",2785,2,128,1,64,1,64,195.116582,7.400000001211993e-5,0,0
"244.3.160.204",5106,"244.3.160.254",4000,7,448,4,256,3,192,195.116835,0.15670000000000073,13069.55966815565,9802.169751116739
"244.3.160.204",5107,"244.3.160.254",4001,2,128,1,64,1,64,195.117153,7.299999998622297e-5,0,0
"244.3.160.204",5108,"244.3.160.239",443,7,448,4,256,3,192,195.117393,0.2038180000000125,10048.180239232426,7536.135179424319
"244.3.160.204",5110,"244.3.160.239",80,7,448,4,256,3,192,195.117969,0.15848700000000804,12922.19551130311,9691.646633477334
"244.3.160.204",5427,"244.3.160.89",2048,2,128,1,64,1,64,197.114383,8.600000001024455e-5,0,0
"244.3.160.204",5428,"244.3.160.89",80,7,448,4,256,3,192,197.114618,0.15972600000000625,12821.957602393599,9616.468201795198
"244.3.160.204",5429,"244.3.160.89",443,13,3841,5,362,8,3479,197.114903,0.20914999999999395,13846.521635190455,133071.9579249381
"244.3.160.204",5430,"244.3.160.89",2784,2,128,1,64,1,64,197.115157,7.399999998369822e-5,0,0
"244.3.160.204",5431,"244.3.160.89",2785,2,128,1,64,1,64,197.11541,6.999999999379725e-5,0,0
"244.3.160.204",5432,"244.3.160.89",4000,2,128,1,64,1,64,197.115657,7.600000000707041e-5,0,0
"244.3.160.204",5433,"244.3.160.254",4002,2,128,1,64,1,64,197.115939,7.400000001211993e-5,0,0
"244.3.160.204",5434,"244.3.160.254",2048,2,128,1,64,1,64,197.116215,6.8999999996322e-5,0,0
"244.3.160.204",5435,"244.3.160.254",443,7,448,4,256,3,192,197.116465,0.1607569999999896,12739.725175265354,9554.793881449015
"244.3.160.204",5436,"244.3.160.254",80,7,448,4,256,3,192,197.116728,0.161295999999993,12697.153060212831,9522.864795159623
"244.3.160.204",5437,"244.3.160.254",2784,2,128,1,64,1,64,197.11698,7.099999999127249e-5,0,0
"244.3.160.204",5438,"244.3.160.254",2785,2,128,1,64,1,64,197.117334,7.099999999127249e-5,0,0
"244.3.160.204",5439,"244.3.160.239",443,7,448,4,256,3,192,197.117545,0.20924299999998652,9787.66314763281,7340.747360724607
"244.3.160.204",5441,"244.3.160.239",80,7,448,4,256,3,192,197.118062,0.16215499999998428,12629.89115352717,9472.418365145379
"244.3.160.204",5766,"244.3.160.89",4001,2,128,1,64,1,64,199.115495,8.199999999192187e-5,0,0
"244.3.160.204",5767,"244.3.160.89",4002,2,128,1,64,1,64,199.115747,7.600000000707041e-5,0,0
"244.3.160.204",5768,"244.3.160.89",2048,2,128,1,64,1,64,199.115999,7.300000001464468e-5,0,0
"244.3.160.204",5769,"244.3.160.89",80,7,448,4,256,3,192,199.116244,0.15923100000000545,12861.81710847718,9646.362831357885
"244.3.160.204",5770,"244.3.160.89",443,13,3841,5,362,8,3479,199.116532,0.2075749999999914,13951.58376490483,134081.65723233123
"244.3.160.204",5771,"244.3.160.89",2784,2,128,1,64,1,64,199.116801,5.3999999977349944e-5,0,0
"244.3.160.204",5772,"244.3.160.254",4000,7,448,4,256,3,192,199.117084,0.15991499999998382,12806.803614421457,9605.102710816092
"244.3.160.204",5773,"244.3.160.254",4001,2,128,1,64,1,64,199.117347,7.200000001716944e-5,0,0
"244.3.160.204",5774,"244.3.160.254",4002,2,128,1,64,1,64,199.11761,6.999999999379725e-5,0,0
"244.3.160.204",5775,"244.3.160.254",2048,2,128,1,64,1,64,199.117886,6.999999999379725e-5,0,0
"244.3.160.204",5776,"244.3.160.254",443,7,448,4,256,3,192,199.118142,0.16092199999999934,12726.662606728778,9544.996955046583
"244.3.160.204",5777,"244.3.160.254",80,7,448,4,256,3,192,199.118438,0.16139899999998875,12689.050118031357,9516.787588523517
"244.3.160.204",5778,"244.3.160.239",443,7,448,4,256,3,192,199.118727,0.1986530000000073,10309.434038247218,7732.075528685415
"244.3.160.204",5780,"244.3.160.239",80,7,448,4,256,3,192,199.119264,0.16275600000000168,12583.253459165739,9437.440094374304
"244.3.160.204",6097,"244.3.160.89",2785,2,128,1,64,1,64,201.115699,0.00010000000000331966,0,0
"244.3.160.204",6098,"244.3.160.89",4000,2,128,1,64,1,64,201.115977,8.100000002286833e-5,0,0
"244.3.160.204",6099,"244.3.160.89",4001,2,128,1,64,1,64,201.116109,6.8999999996322e-5,0,0
"244.3.160.204",6100,"244.3.160.89",4002,2,128,1,64,1,64,201.116354,6.799999999884676e-5,0,0
"244.3.160.204",6101,"244.3.160.89",2048,2,128,1,64,1,64,201.116633,7.999999999697138e-5,0,0
"244.3.160.204",6102,"244.3.160.89",80,7,448,4,256,3,192,201.116889,0.15410100000002558,13289.98513961402,9967.488854710515
"244.3.160.204",6103,"244.3.160.254",2784,2,128,1,64,1,64,201.117165,6.799999999884676e-5,0,0
"244.3.160.204",6104,"244.3.160.254",2785,2,128,1,64,1,64,201.117415,8.199999999192187e-5,0,0
"244.3.160.204",6105,"244.3.160.254",4000,7,448,4,256,3,192,201.11774,0.1551860000000147,13197.066745710348,9897.800059282761
"244.3.160.204",6106,"244.3.160.254",4001,2,128,1,64,1,64,201.11797,6.8999999996322e-5,0,0
"244.3.160.204",6107,"244.3.160.254",4002,2,128,1,64,1,64,201.118234,6.8999999996322e-5,0,0
"244.3.160.204",6108,"244.3.160.254",2048,2,128,1,64,1,64,201.118495,7.400000001211993e-5,0,0
"244.3.160.204",6109,"244.3.160.239",443,7,448,4,256,3,192,201.118789,0.18248300000001905,11222.963234930301,8417.222426197726
"244.3.160.204",6111,"244.3.160.239",80,7,448,4,256,3,192,201.119286,0.1570170000000246,13043.173669091111,9782.380251818333
"244.3.160.204",6431,"244.3.160.89",443,13,3841,5,362,8,3479,203.11496,0.20393699999999626,14200.463868744038,136473.51878276386
"244.3.160.204",6432,"244.3.160.89",2784,2,128,1,64,1,64,203.115205,8.199999999192187e-5,0,0
"244.3.160.204",6433,"244.3.160.89",2785,2,128,1,64,1,64,203.11545,6.799999999884676e-5,0,0
"244.3.160.204",6434,"244.3.160.89",4000,2,128,1,64,1,64,203.115712,0.0002819999999985612,0,0
"244.3.160.204",6435,"244.3.160.89",4001,2,128,1,64,1,64,203.115986,4.80000000209202e-5,0,0
"244.3.160.204",6436,"244.3.160.89",4002,2,128,1,64,1,64,203.116204,7.399999998369822e-5,0,0
"244.3.160.204",6437,"244.3.160.254",443,7,448,4,256,3,192,203.116478,0.16098900000000071,12721.366056065886,9541.024542049414
"244.3.160.204",6438,"244.3.160.254",80,7,448,4,256,3,192,203.116758,0.1594169999999906,12846.81056600062,9635.107924500466
"244.3.160.204",6439,"244.3.160.254",2784,2,128,1,64,1,64,203.116998,7.200000001716944e-5,0,0
"244.3.160.204",6440,"244.3.160.254",2785,2,128,1,64,1,64,203.117261,7.299999998622297e-5,0,0
"244.3.160.204",6441,"244.3.160.254",4000,7,448,4,256,3,192,203.1175,0.16075200000000223,12740.121429282197,9555.091071961648
"244.3.160.204",6442,"244.3.160.254",4001,2,128,1,64,1,64,203.117786,7.200000001716944e-5,0,0
"244.3.160.204",6443,"244.3.160.239",443,7,448,4,256,3,192,203.118059,0.21007900000000745,9748.71357917701,7311.535184382758
"244.3.160.204",6445,"244.3.160.239",80,7,448,4,256,3,192,203.1186,0.16192500000002497,12647.8307858557,9485.873089391775
"244.3.160.204",6767,"244.3.160.89",2048,2,128,1,64,1,64,205.115014,0.00010399999999322063,0,0
"244.3.160.204",6768,"244.3.160.89",80,7,448,4,256,3,192,205.115252,0.15368000000000848,13326.392503903482,9994.794377927612
"244.3.160.204",6769,"244.3.160.89",443,13,3841,5,362,8,3479,205.115505,0.1989109999999812,14559.275253758082,139921.87460724963
"244.3.160.204",6770,"244.3.160.89",2784,2,128,1,64,1,64,205.115773,7.500000000959517e-5,0,0
"244.3.160.204",6771,"244.3.160.89",2785,2,128,1,64,1,64,205.116006,6.700000000137152e-5,0,0
"244.3.160.204",6772,"244.3.160.89",4000,2,128,1,64,1,64,205.116247,7.500000000959517e-5,0,0
"244.3.160.204",6773,"244.3.160.254",4002,2,128,1,64,1,64,205.116527,8.200000002034358e-5,0,0
"244.3.160.204",6774,"244.3.160.254",2048,2,128,1,64,1,64,205.116795,7.200000001716944e-5,0,0
"244.3.160.204",6775,"244.3.160.254",443,7,448,4,256,3,192,205.117046,0.1566050000000132,13077.487947382442,9808.115960536832
"244.3.160.204",6776,"244.3.160.254",80,7,448,4,256,3,192,205.117306,0.15729099999998652,13020.452537018491,9765.339402763868
"244.3.160.204",6777,"244.3.160.254",2784,2,128,1,64,1,64,205.11757,5.600000000072214e-5,0,0
"244.3.160.204",6778,"244.3.160.254",2785,2,128,1,64,1,64,205.117844,6.400000000894579e-5,0,0
"244.3.160.204",6779,"244.3.160.239",443,7,448,4,256,3,192,205.118117,0.19992999999999483,10243.585254839458,7682.688941129594
"244.3.160.204",6781,"244.3.160.239",80,7,448,4,256,3,192,205.118632,0.1596930000000043,12824.607215093616,9618.455411320212
"244.3.160.204",7098,"244.3.160.89",4001,2,128,1,64,1,64,207.115482,9.40000000184682e-5,0,0
"244.3.160.204",7099,"244.3.160.89",4002,2,128,1,64,1,64,207.115725,7.300000001464468e-5,0,0
"244.3.160.204",7100,"244.3.160.89",2048,2,128,1,64,1,64,207.115995,7.199999998874773e-5,0,0
"244.3.160.204",7101,"244.3.160.89",80,7,448,4,256,3,192,207.116251,0.15688000000000102,13054.56399796014,9790.922998470105
"244.3.160.204",7102,"244.3.160.89",443,13,3841,5,362,8,3479,207.11651,0.20383699999999294,14207.430446877162,136540.47106266755
"244.3.160.204",7103,"244.3.160.89",2784,2,128,1,64,1,64,207.116752,6.799999999884676e-5,0,0
"244.3.160.204",7104,"244.3.160.254",4000,7,448,4,256,3,192,207.117053,0.15812099999999418,12952.10629834162,9714.079723756215
"244.3.160.204",7105,"244.3.160.254",4001,2,128,1,64,1,64,207.117314,7.500000000959517e-5,0,0
"244.3.160.204",7106,"244.3.160.254",4002,2,128,1,64,1,64,207.117573,6.400000000894579e-5,0,0
"244.3.160.204",7107,"244.3.160.254",2048,2,128,1,64,1,64,207.117826,9.900000000584441e-5,0,0
"244.3.160.204",7108,"244.3.160.254",443,7,448,4,256,3,192,207.118114,0.15904600000001778,12876.777787556877,9657.583340667657
"244.3.160.204",7109,"244.3.160.254",80,7,448,4,256,3,192,207.118382,0.1598160000000064,12814.7369474891,9611.052710616825
"244.3.160.204",7110,"244.3.160.239",443,7,448,4,256,3,192,207.118652,0.19211400000000367,10660.337091518373,7995.252818638781
"244.3.160.204",7112,"244.3.160.239",80,7,448,4,256,3,192,207.119215,0.16055399999999054,12755.832928485872,9566.874696364404
"244.3.160.204",7437,"244.3.160.89",2785,2,128,1,64,1,64,209.115561,9.399999999004649e-5,0,0
"244.3.160.204",7438,"244.3.160.89",4000,2,128,1,64,1,64,209.115809,8.399999998687235e-5,0,0
"244.3.160.204",7439,"244.3.160.89",4001,2,128,1,64,1,64,209.116131,7.600000000707041e-5,0,0
"244.3.160.204",7440,"244.3.160.89",4002,2,128,1,64,1,64,209.116333,7.300000001464468e-5,0,0
"244.3.160.204",7441,"244.3.160.89",2048,2,128,1,64,1,64,209.116653,6.599999997547457e-5,0,0
"244.3.160.204",7442,"244.3.160.89",80,7,448,4,256,3,192,209.116824,0.1530379999999809,13382.297207231246,10036.722905423434
"244.3.160.204",7443,"244.3.160.254",2784,2,128,1,64,1,64,209.11718,0.00017600000001039007,0,0
"244.3.160.204",7444,"244.3.160.254",2785,2,128,1,64,1,64,209.117468,7.399999998369822e-5,0,0
"244.3.160.204",7445,"244.3.160.254",4000,7,448,4,256,3,192,209.117658,0.15366900000000783,13327.346439424318,9995.50982956824
"244.3.160.204",7446,"244.3.160.254",4001,2,128,1,64,1,64,209.117898,8.700000000771979e-5,0,0
"244.3.160.204",7447,"244.3.160.254",4002,2,128,1,64,1,64,209.118178,7.899999999949614e-5,0,0
"244.3.160.204",7448,"244.3.160.254",2048,2,128,1,64,1,64,209.118465,5.5000000003246896e-5,0,0
"244.3.160.204",7449,"244.3.160.239",443,7,448,4,256,3,192,209.118737,0.173831999999976,11781.490174422906,8836.11763081718
"244.3.160.204",7451,"244.3.160.239",80,7,448,4,256,3,192,209.11927,0.15483199999999897,13227.239847060127,9920.429885295096
"244.3.160.204",7768,"244.3.160.89",443,13,3841,5,362,8,3479,211.116298,0.201075000000003,14402.586099713822,138416.01392515024
"244.3.160.204",7769,"244.3.160.89",2784,2,128,1,64,1,64,211.116553,8.299999998939711e-5,0,0
"244.3.160.204",7770,"244.3.160.89",2785,2,128,1,64,1,64,211.116814,7.099999999127249e-5,0,0
"244.3.160.204",7771,"244.3.160.89",4000,2,128,1,64,1,64,211.117046,7.300000001464468e-5,0,0
"244.3.160.204",7772,"244.3.160.89",4001,2,128,1,64,1,64,211.117328,6.900000002474371e-5,0,0
"244.3.160.204",7773,"244.3.160.89",4002,2,128,1,64,1,64,211.117628,6.999999999379725e-5,0,0
"244.3.160.204",7774,"244.3.160.254",443,7,448,4,256,3,192,211.117858,0.15901999999999816,12878.883159351173,9659.16236951338
"244.3.160.204",7775,"244.3.160.254",80,7,448,4,256,3,192,211.118117,0.15987599999999702,12809.92769396306,9607.445770472295
"244.3.160.204",7776,"244.3.160.254",2784,2,128,1,64,1,64,211.11843,7.300000001464468e-5,0,0
"244.3.160.204",7777,"244.3.160.254",2785,2,128,1,64,1,64,211.118656,6.900000002474371e-5,0,0
"244.3.160.204",7778,"244.3.160.254",4000,7,448,4,256,3,192,211.118909,0.16100099999999884,12720.417885603287,9540.313414202465
"244.3.160.204",7779,"244.3.160.254",4001,2,128,1,64,1,64,211.119166,7.899999999949614e-5,0,0
"244.3.160.204",7780,"244.3.160.239",443,7,448,4,256,3,192,211.119471,0.20924299999998652,9787.66314763281,7340.747360724607
"244.3.160.204",7782,"244.3.160.239",80,7,448,4,256,3,192,211.120011,0.163218999999998,12547.55880136519,9410.669101023894
"244.3.160.239",50433,"244.244.229.164",80,7,2687,4,256,3,2431,0.008063,0.339251,6036.82818915788,57326.28643688596
"244.3.160.239",50434,"244.244.229.164",80,4,256,3,192,1,64,0.008068,0.275926,5566.709914977204,1855.569971659068
"244.3.160.239",50441,"188.68.211.254",80,25,19821,9,1706,16,18115,0.011512,1.218227,11203.166569120534,118959.76693998738
"244.3.160.239",50438,"40.248.176.156",80,5,1877,2,128,3,1749,0.033359,0.066117,15487.696053964943,211624.84686238033
"244.3.160.239",50435,"244.244.229.164",80,3,192,2,128,1,64,0.034156,0.146993,6966.318123992299,3483.1590619961494
"244.3.160.239",50436,"244.244.229.164",80,3,192,2,128,1,64,0.034441,0.147464,6944.0677046601195,3472.0338523300597
"244.3.160.239",50431,"244.186.155.13",80,16,16524,4,256,12,16268,0.036102,0.31118199999999996,6581.357533533432,418224.70451375726
"244.3.160.239",50442,"244.244.229.164",80,10,2000,6,1330,4,670,0.047821,0.646849,16448.970316101593,8286.323392321856
"244.3.160.239",50112,"176.41.89.210",80,1796,1578456,654,41856,1142,1536600,0.048107,181.78644100000002,1841.9855637087915,67622.20511264644
"244.3.160.239",50443,"244.244.229.164",80,10,2020,6,1331,4,689,0.048664,0.6471549999999999,16453.55440350457,8517.279477095906
"244.3.160.239",50444,"244.244.229.164",80,10,2020,6,1331,4,689,0.049813,0.647428,16446.616457737386,8513.688008550758
"244.3.160.239",50440,"244.244.229.164",80,10,2485,5,320,5,2165,0.050736,0.403247,6348.466324609978,42951.342477439386
"244.3.160.239",50439,"244.244.229.164",80,8,1149,4,256,4,893,0.052179,0.23368799999999998,8763.821847933998,30570.675430488518
"244.3.160.239",50437,"40.248.176.156",80,20,15470,8,512,12,14958,0.053389,0.20310799999999998,20166.61086712488,589164.3854501054
"244.3.160.239",50446,"244.244.229.164",80,10,2017,6,1329,4,688,0.160463,0.536417,19820.400919433945,10260.67406513962
"244.3.160.239",50445,"244.244.229.164",80,10,2018,6,1330,4,688,0.160539,0.534991,19888.185034888436,10288.023536844545
"244.3.160.239",50447,"244.244.229.164",80,12,2322,7,1397,5,925,0.160835,0.644372,17344.018672443868,11484.049586263836
"244.3.160.239",49121,"176.41.89.121",80,32,23039,12,768,20,22271,0.334384,1.895314,3241.679215159071,94004.476303135
"244.3.160.239",50448,"244.244.229.164",80,10,2018,6,1331,4,687,0.445473,0.580225,18351.501572665777,9472.187513464605
"244.3.160.239",50449,"244.244.229.164",80,10,2036,6,1338,4,698,0.446229,0.579493,18471.31889427482,9636.009408224085
"244.3.160.239",50450,"244.244.229.164",80,10,2009,6,1339,4,670,0.447369,0.5781439999999999,18528.255936237343,9271.046659655727
"244.3.160.239",50451,"117.142.224.75",80,14,5295,8,2280,6,3015,0.47105,0.3209199999999999,56836.59478997882,75158.91811043253
"244.3.160.239",50452,"244.244.229.164",80,10,2035,6,1338,4,697,0.561325,0.5748540000000001,18620.380131302903,9699.8542238551
"244.3.160.239",50453,"244.244.229.164",80,12,2768,7,1403,5,1365,0.561538,0.5741030000000001,19550.49877809382,19020.977072058493
"244.3.160.239",50454,"244.244.229.164",80,10,2037,6,1338,4,699,0.562479,0.572117,18709.459778332053,9774.224503029975
"244.3.160.239",50455,"244.244.229.84",80,13,3766,7,1417,6,2349,0.636472,0.595101,19048.867335124625,31577.83300649806
"244.3.160.239",50456,"244.244.229.84",80,121,112096,44,3806,77,108290,0.643024,1.677508,18150.73311125789,516432.7085176345
"244.3.160.239",50457,"244.244.229.84",80,51,42630,20,2244,31,40386,0.645283,1.1120679999999998,16142.897736469355,290528.996428276
"244.3.160.239",50458,"117.142.224.176",80,13,3225,8,2719,5,506,0.709866,0.28360300000000005,76698.76552786816,14273.473834903014
"244.3.160.239",50459,"244.244.229.164",80,10,2035,6,1338,4,697,0.775922,0.456175,23464.67912533567,12223.379185619555
"244.3.160.239",50460,"244.244.229.164",80,13,3680,7,1398,6,2282,0.776876,0.606221,18448.71754690121,30114.430216043325
"244.3.160.239",50461,"244.244.229.164",80,12,2371,7,1435,5,936,0.777744,0.45559499999999997,25197.81823768918,16435.650083956145
"244.3.160.239",50429,"177.124.75.164",80,418,401358,141,9024,277,392334,0.788879,2.93884,24564.794272570132,1067996.8967347662
"244.3.160.239",50462,"177.124.75.164",80,15,4191,8,2117,7,2074,0.829396,0.19143599999999994,88468.20869637898,86671.26350320736
"244.3.160.239",50463,"177.124.75.164",80,26,17110,11,2562,15,14548,0.833489,0.17146499999999987,119534.59889773432,678762.4296503665
"244.3.160.239",50464,"177.124.75.164",80,36,26880,15,2792,21,24088,0.835024,0.2041250000000001,109423.14758113895,944048.9895897117
"244.3.160.239",50465,"117.142.224.75",80,12,3703,7,2340,5,1363,0.910092,0.32869800000000005,56951.97415256557,33173.30802134482
"244.3.160.239",50466,"177.124.75.164",80,39,29640,16,2854,23,26786,1.025952,0.1980280000000001,115296.8267113741,1082109.600662532
"244.3.160.239",50467,"177.124.75.164",80,15,4938,8,2350,7,2588,1.208202,0.09927099999999989,189380.58446071885,208560.40535503847
"244.3.160.239",50468,"188.68.211.254",80,59,48042,25,2433,34,45609,1.208709,0.6570389999999999,29623.8122851155,555327.7659317028
"244.3.160.239",50469,"188.68.211.254",80,11,2136,6,1173,5,963,1.2231779999999999,0.2427560000000002,38656.09912834283,31735.569872629283
"244.3.160.239",50470,"188.68.211.254",80,20,12080,9,1364,11,10716,1.239919,0.3284750000000001,33220.18418448892,260987.89862242175
"244.3.160.239",50471,"188.68.211.254",80,11,2247,6,1171,5,1076,1.252667,0.283377,33058.434523620475,30376.494916665786
"244.3.160.239",50472,"188.68.211.254",80,16,6253,8,1301,8,4952,1.265474,0.34231199999999995,30405.010633574053,115730.67844539486
"244.3.160.239",50473,"188.68.211.254",80,11,1921,6,1170,5,751,1.277803,0.28956800000000005,32324.013703171615,20748.14896673665
"244.3.160.239",50474,"177.124.75.164",80,15,5139,8,2342,7,2797,1.458312,0.10780100000000004,173801.7272567044,207567.6477954749
"244.3.160.239",50475,"177.124.75.164",80,148,135469,53,5600,95,129869,1.5428899999999999,4.58688,9766.987581972931,226505.16255057906
"244.3.160.239",50476,"188.68.211.254",80,19,9383,9,1344,10,8039,1.659214,0.35227200000000014,30521.86946450469,182563.47367942947
"244.3.160.239",50477,"188.68.211.254",80,13,4178,7,1225,6,2953,1.706766,0.27195400000000003,36035.50600469197,86867.63202600439
"244.3.160.239",50478,"176.41.89.121",80,16,6237,10,5492,6,745,2.012621,1.021985,42990.84624529714,5831.788137790672
"244.3.160.239",50479,"244.186.155.13",80,10,1951,6,1257,4,694,2.138308,0.6159310000000002,16326.504105167618,9013.996697682041
"244.3.160.239",50480,"188.68.211.254",80,13,4448,7,1257,6,3191,2.186944,0.3864019999999999,26024.710017028905,66065.91063193257
"244.3.160.239",50481,"188.68.211.254",80,11,2130,6,1192,5,938,2.20514,0.36832699999999985,25890.03792825398,20373.200987166303
"244.3.160.239",50482,"188.68.211.254",80,11,2489,6,1236,5,1253,2.221111,0.4627300000000001,21368.83279666328,21662.740691115767
"244.3.160.239",50483,"188.68.211.254",80,11,2508,6,1217,5,1291,2.234381,0.44972600000000007,21648.737231114053,22965.0943018638
"244.3.160.239",50484,"188.68.211.254",80,11,2592,6,1216,5,1376,2.248634,0.4360780000000002,22307.935736267355,25243.190438407797
"244.3.160.239",50485,"188.68.211.254",80,11,2529,6,1217,5,1312,2.263387,0.5299080000000003,18373.00059632992,19807.211817900457
"244.3.160.239",50486,"188.68.211.254",80,30,21662,13,1678,17,19984,2.542953,0.5104390000000003,26298.930920247065,313204.9079321915
"244.3.160.239",50487,"188.68.211.254",80,20,11722,9,1421,11,10301,2.575564,0.3612679999999999,31466.944207624263,228107.66522360136
"244.3.160.239",50488,"188.68.211.254",80,11,1934,6,1231,5,703,2.688433,0.2567520000000001,38356.07901788495,21904.405807939173
"244.3.160.239",50489,"188.68.211.254",80,11,2807,6,1236,5,1571,2.748399,0.4149449999999999,23829.664172360197,30288.351468266887
"244.3.160.239",50490,"188.68.211.254",80,11,2922,6,1238,5,1684,2.762711,0.40093500000000004,24702.258470824447,33601.4565952087
"244.3.160.239",50491,"188.68.211.254",80,11,2741,6,1231,5,1510,2.824096,0.44909200000000027,21928.69167119431,26898.720084080753
"244.3.160.239",50492,"41.43.180.128",80,92,87230,33,3259,59,83971,2.8815049999999998,0.7148850000000002,36470.2015009407,939686.8027724737
"244.3.160.239",50493,"188.68.211.254",80,11,2693,6,1231,5,1462,3.061984,0.31361300000000014,31401.759493388334,37294.37236339053
"244.3.160.239",50494,"188.68.211.254",80,11,2422,6,1225,5,1197,3.127506,0.24834600000000018,39461.07446868479,38559.10705225771
"244.3.160.239",50495,"188.68.211.254",80,11,2424,6,1224,5,1200,3.14764,0.44612799999999986,21948.857726930393,21518.487967578818
"244.3.160.239",50496,"188.68.211.254",80,11,1924,6,1219,5,705,3.17205,0.42219000000000007,23098.604893531345,13358.9142329283
"244.3.160.239",50497,"188.68.211.254",80,11,2068,6,1233,5,835,3.230423,0.36414100000000005,27088.408061712355,18344.54236133805
"244.3.160.239",50498,"188.68.211.254",80,11,2566,6,1245,5,1321,3.268785,0.4351130000000003,22890.605428934537,24287.943591664676
"244.3.160.239",50499,"41.43.180.128",80,13,3373,7,1917,6,1456,3.360073,0.2925180000000003,52427.54292043562,39819.77177472835
"244.3.160.239",50500,"188.68.211.254",80,11,2536,6,1247,5,1289,3.456748,0.247722,40270.94888625152,41627.30803077643
"244.3.160.239",50501,"188.68.211.254",80,11,2372,6,1244,5,1128,3.55186,0.392061,25383.805071149643,23016.826463228936
"244.3.160.239",50502,"41.43.180.128",80,14,6134,7,1663,7,4471,3.57343,0.2091529999999997,63608.93699827408,171013.5642328824
"244.3.160.239",50503,"188.68.211.254",80,11,2363,6,1243,5,1120,3.576435,0.36885900000000005,26958.810819310358,24291.12479294256
"244.3.160.239",50504,"188.68.211.254",80,11,1938,6,1232,5,706,3.605054,0.4481580000000003,21992.24380687167,12602.6981555612
"244.3.160.239",50505,"41.43.180.128",80,17,4806,9,2677,8,2129,3.6491160000000002,0.24383599999999994,87829.52476254533,69850.22720188981
"244.3.160.239",50506,"188.68.211.254",80,11,2298,6,1239,5,1059,3.657615,0.3960600000000003,25026.511134676544,21390.698379033463
"244.3.160.239",50507,"188.68.211.254",80,11,2277,6,1236,5,1041,3.743251,0.42012099999999997,23536.076511290797,19822.86055683958
"244.3.160.239",50508,"188.68.211.254",80,11,2388,6,1245,5,1143,3.79093,0.3731849999999999,26689.175609952177,24502.592547932
"244.3.160.239",50509,"188.68.211.254",80,11,2463,6,1247,5,1216,3.91333,0.36018799999999995,27696.64730640666,27008.11798283119
"244.3.160.239",50510,"41.43.180.128",80,11,2680,6,1617,5,1063,3.922814,0.1900719999999998,68058.41996717041,44740.94027526416
"244.3.160.239",50511,"188.68.211.254",80,16,6953,8,1349,8,5604,3.9313219999999998,0.45191400000000037,23880.649858158835,99204.71594152862
"244.3.160.239",50512,"188.68.211.254",80,11,2702,6,1232,5,1470,4.03742,0.44726599999999994,22036.103795057083,26293.078391829473
"244.3.160.239",50513,"188.68.211.254",80,11,2499,6,1233,5,1266,4.107781,0.37665400000000027,26188.491294397492,26889.39982052492
"244.3.160.239",50514,"188.68.211.254",80,11,1945,6,1233,5,712,4.148258,0.4450479999999999,22163.901421869108,12798.619474753288
"244.3.160.239",50515,"244.186.155.13",80,10,2047,6,1391,4,656,4.614801,0.868989,12805.685687620902,6039.201877123876
"244.3.160.239",50516,"41.43.180.128",80,11,2588,6,1693,5,895,5.059476,0.07849400000000006,172548.22024613334,91217.16309526835
"244.3.160.239",50517,"188.68.72.48",80,11,2525,6,1622,5,903,5.129264,0.4090239999999996,31724.299796588984,17661.55531215774
"244.3.160.239",50518,"244.186.155.13",80,1630,1674575,547,36063,1083,1638512,5.403041,10.932998,26388.370326236225,1198947.9921243927
"244.3.160.239",50519,"188.68.72.48",80,211,208148,73,5932,138,202216,5.478459,3.1748979999999998,14947.25184872081,509536.99929887516
"244.3.160.239",50520,"41.43.180.128",80,13,3516,7,2041,6,1475,5.503666,0.25901399999999963,63039.06352552381,45557.38299860246
"244.3.160.239",50521,"188.68.211.254",80,11,1786,6,1130,5,656,5.823831,0.2327969999999997,38832.11553413494,22543.245832205772
"244.3.160.239",50522,"177.124.75.164",80,55,44360,21,3174,34,41186,6.160585,0.24508099999999988,103606.56272824091,1344404.5030010494
"244.3.160.239",50523,"177.124.75.164",80,48,38722,19,3051,29,35671,6.404049,0.23467400000000005,104008.1133828204,1216018.817593768
"244.3.160.239",50524,"188.68.211.254",80,11,2076,6,1200,5,876,6.443224,0.24448700000000034,39265.89143799051,28664.100749733076
"244.3.160.239",50525,"177.124.75.164",80,15,5250,8,2345,7,2905,6.631234,0.10690899999999992,175476.33969076516,217381.13722885834
"244.3.160.239",50526,"177.124.75.164",80,27,18971,12,2626,15,16345,6.715746,0.2600069999999999,80797.82467395112,502909.5370509258
"244.3.160.239",50527,"177.124.75.164",80,15,5013,8,2374,7,2639,6.717182,0.12795999999999985,148421.38168177573,164989.059080963
"244.3.160.239",50528,"177.124.75.164",80,13,2939,7,2293,6,646,6.718957,0.1266860000000003,144798.95173894477,40793.77358192687
"244.3.160.239",50529,"188.68.211.254",80,45,39312,17,1905,28,37407,6.762642,1.1553360000000001,13190.967822347782,259020.7524044953
"244.3.160.239",50530,"177.124.75.164",80,13,3036,7,2325,6,711,6.957928,0.19626300000000008,94770.79225325197,28981.519695510604
"244.3.160.239",50531,"177.124.75.164",80,13,3035,7,2326,6,709,6.961068,0.19210300000000036,96864.70278964912,29525.827290568024
"244.3.160.239",50532,"177.124.75.164",80,13,3954,7,2337,6,1617,6.964356,0.18912699999999916,98854.20907644114,68398.48355866723
"244.3.160.239",50533,"177.124.75.164",80,13,2992,7,2321,6,671,6.99045,0.16371599999999997,113415.91536563319,32788.487380585895
"244.3.160.239",50534,"177.124.75.164",80,13,3049,7,2335,6,714,6.997362,0.1585239999999999,117837.0467563272,36032.398879664936
"244.3.160.239",50535,"177.124.75.164",80,13,3124,7,2337,6,787,7.006298,0.14836899999999975,126010.15036833861,42434.740410732775
"244.3.160.239",50536,"177.124.75.164",80,15,4318,8,2398,7,1920,7.044248,0.12843099999999996,149372.03634636503,119597.29348833229
"244.3.160.239",50537,"177.124.75.164",80,15,4360,8,2395,7,1965,7.065979,0.11654600000000048,164398.60655878298,134882.36404509752
"244.3.160.239",50538,"177.124.75.164",80,14,3838,8,2830,6,1008,7.073506,4.362833999999999,5189.287513574893,1848.3398634924
"244.3.160.239",50539,"177.124.75.164",80,13,3319,7,2323,6,996,7.113936,0.189705,97962.62618275743,42002.05582351545
"244.3.160.239",50540,"177.124.75.164",80,13,4063,7,2337,6,1726,7.114477,0.19042799999999982,98178.83924632941,72510.34511731475
"244.3.160.239",50541,"177.124.75.164",80,13,3344,7,2337,6,1007,7.263301,0.1910279999999993,97870.46925058142,42171.82821366516
"244.3.160.239",50542,"177.124.75.164",80,13,3274,7,2337,6,937,7.265949,0.1884319999999997,99218.81633692807,39780.92892926897
"244.3.160.239",50543,"177.124.75.164",80,13,4108,7,2327,6,1781,7.277827,0.1770239999999994,105160.88214027512,80486.2617498195
"244.3.160.239",50544,"177.124.75.164",80,13,2998,7,2341,6,657,7.350825,0.11614699999999978,161243.94086803822,45252.9983555323
"244.3.160.239",50545,"177.124.75.164",80,13,3058,7,2335,6,723,7.3534,0.11381500000000067,164125.99393752925,50819.31204147051
"244.3.160.239",50546,"41.43.180.128",80,13,3578,7,2112,6,1466,7.389507,0.0851329999999999,198465.9297804614,137760.91527374828
"244.3.160.239",50547,"177.124.75.164",80,13,3062,7,2336,6,726,7.389613,0.19521299999999986,95731.32936843352,29752.116918442953
"244.3.160.239",50548,"177.124.75.164",80,14,3541,8,2828,6,713,7.392118,4.3390260000000005,5214.0733888204395,1314.580737704729
"244.3.160.239",50549,"177.124.75.164",80,13,3083,7,2326,6,757,7.394005,0.19223500000000016,96798.18971571246,31503.108174890083
"244.3.160.239",50550,"177.124.75.164",80,13,3361,7,2324,6,1037,7.426444,0.17389100000000024,106917.55179969047,47708.046994956545
"244.3.160.239",50551,"177.124.75.164",80,13,3633,7,2338,6,1295,7.469002,0.131621,142104.98324735416,78710.84401425305
"244.3.160.239",50552,"177.124.75.164",80,13,3631,7,2333,6,1298,7.470723,0.1308580000000008,142627.88671689836,79353.19200965883
"244.3.160.239",50553,"177.124.75.164",80,13,3638,7,2350,6,1288,7.50537,0.10938099999999995,171876.28564375904,94202.83230177092
"244.3.160.239",50554,"177.124.75.164",80,13,3313,7,2323,6,990,7.507228,0.1062120000000002,174970.8130907992,74567.84544119294
"244.3.160.239",50555,"177.124.75.164",80,13,3512,7,2325,6,1187,7.543878,0.115043,161678.67666872387,82543.04912076354
"244.3.160.239",50556,"177.124.75.164",80,14,3810,8,2814,6,996,7.545586,4.333608,5194.747655994728,1838.652688475746
"244.3.160.239",50557,"177.124.75.164",80,13,3607,7,2339,6,1268,7.575848,0.1700500000000007,110038.22405174903,59653.04322258135
"244.3.160.239",50558,"177.124.75.164",80,13,3656,7,2335,6,1321,7.576359,0.17015400000000014,109782.9025471043,62108.44293992496
"244.3.160.239",50559,"188.68.211.254",80,47,39440,18,1969,29,37471,7.788865,1.234763,12757.103994855692,242773.7144699023
"244.3.160.239",50560,"177.124.75.164",80,14,3630,8,2886,6,744,7.966914,4.34261,5316.618347030933,1370.6043139955004
"244.3.160.239",50561,"188.68.72.48",80,19,11066,9,1707,10,9359,7.988532,0.38419699999999946,35544.2650515231,194879.18958242805
"244.3.160.239",50562,"177.124.75.164",80,14,3467,8,2818,6,649,8.020246,4.3403480000000005,5194.053564368571,1196.2174461586949
"244.3.160.239",50563,"177.124.75.164",80,13,3486,7,2326,6,1160,8.023934,0.16658299999999926,111704.07544587433,55707.96539863036
"244.3.160.239",50564,"177.124.75.164",80,21,12160,10,2552,11,9608,8.092259,0.3178459999999994,64232.36410085399,241827.80340164778
"244.3.160.239",50565,"188.68.72.48",80,26,18055,11,1828,15,16227,8.234161,0.433662,33722.115380180876,299348.34041257936
"244.3.160.239",50566,"177.124.75.164",80,14,3930,8,2808,6,1122,8.3094,4.345122,5169.935389616218,2065.7647817483607
"244.3.160.239",50567,"188.68.72.48",80,13,4098,7,1575,6,2523,8.566969,0.25554699999999997,49305.99850516735,78983.51379589665
"244.3.160.239",50568,"188.68.72.48",80,11,2228,6,1528,5,700,8.753134,0.25008799999999987,48878.7946642782,22392.117974472996
"244.3.160.239",50569,"188.68.72.48",80,11,2996,6,1529,5,1467,8.753545,0.2503579999999985,48858.03529346005,46876.8723188397
"244.3.160.239",50570,"188.68.72.48",80,22,14123,10,1800,12,12323,8.75511,0.39289100000000055,36651.38677139456,250919.4662132751
"244.3.160.239",50571,"188.68.72.48",80,11,2251,6,1544,5,707,8.758121,0.2459150000000001,50228.73757192524,22999.81700994245
"244.3.160.239",50572,"188.68.72.48",80,11,2269,6,1537,5,732,8.759055,0.24515300000000018,50156.43292148165,23887.123551414814
"244.3.160.239",50573,"188.68.72.48",80,11,2761,6,1538,5,1223,8.763363,0.2526030000000006,48708.84352125657,38732.71497171442
"244.3.160.239",50574,"188.68.211.254",80,28,19767,12,1559,16,18208,8.832699999999999,0.4209510000000005,29628.151495067086,346035.5243246835
"244.3.160.239",50575,"188.68.211.254",80,11,2255,6,1179,5,1076,8.84527,0.266,35458.64661654135,32360.902255639096
"244.3.160.239",50576,"188.68.72.72",80,14,5645,7,1367,7,4278,8.873923,0.24435099999999998,44755.2905451584,140060.81415668444
"244.3.160.239",50577,"188.68.72.40",80,16,8648,8,1426,8,7222,8.885386,0.34436099999999925,33128.02553134654,167777.41962649697
"244.3.160.239",50578,"188.68.161.64",80,14,6173,7,1657,7,4516,8.902064,0.2423940000000009,54687.82230583245,149046.5935625464
"244.3.160.239",50579,"188.68.72.16",80,13,4389,7,1367,6,3022,8.905207,0.24984499999999876,43771.1381056257,96763.99367607966
"244.3.160.239",50580,"188.68.55.163",80,16,6862,8,1442,8,5420,8.913733,0.31715999999999944,36372.808677008514,136713.3308109474
"244.3.160.239",50581,"188.68.211.177",80,16,8657,8,1425,8,7232,8.922635,0.3349550000000008,34034.42253437021,172727.67983758973
"244.3.160.239",50582,"188.68.72.48",80,11,3257,6,1554,5,1703,8.930886,0.24866700000000108,49994.5710528536,54788.13031081704
"244.3.160.239",50583,"188.68.72.48",80,11,2275,6,1539,5,736,8.933095,0.27838599999999936,44226.36195785718,21150.48888952754
"244.3.160.239",50584,"188.68.72.48",80,11,2278,6,1539,5,739,8.933931,0.27817300000000067,44260.22654966503,21252.96128668126
"244.3.160.239",50585,"188.68.72.48",80,11,2298,6,1532,5,766,8.935237,0.27724499999999885,44206.38785190013,22103.193925950065
"244.3.160.239",50586,"188.68.72.48",80,11,2271,6,1532,5,739,8.936598,0.27631300000000003,44355.49539833449,21396.025521781456
"244.3.160.239",50587,"188.68.72.48",80,11,2239,6,1529,5,710,8.942144,0.2787659999999992,43879.09572903452,20375.512078230546
"244.3.160.239",50588,"188.68.72.111",80,17,8362,8,1434,9,6928,8.957198,0.3269549999999999,35087.39734825895,169515.6825862887
"244.3.160.239",50589,"188.68.211.201",80,14,5145,7,1375,7,3770,8.962671,0.25778000000000034,42672.04593063847,116998.99138800512
"244.3.160.239",50590,"188.68.211.139",80,16,7409,8,1438,8,5971,8.96782,0.3277239999999999,35102.708376560775,145756.79535218663
"244.3.160.239",50591,"188.68.194.132",80,16,6342,8,1429,8,4913,8.989219,0.3090659999999996,36988.86322015367,127170.24842590271
"244.3.160.239",50592,"188.68.72.71",80,14,5624,7,1372,7,4252,9.013704,0.24216399999999894,45324.65601823577,140466.79110024674
"244.3.160.239",50593,"188.68.72.48",80,11,2270,6,1532,5,738,9.110739,0.30358599999999925,40370.76808548494,19447.537106454234
"244.3.160.239",50594,"188.68.72.48",80,11,2233,6,1531,5,702,9.113947,0.30081100000000127,40716.59613511457,18669.53003713287
"244.3.160.239",50595,"188.68.72.48",80,14,6321,7,1626,7,4695,9.114812,0.3001769999999997,43334.43268471606,125126.17555642183
"244.3.160.239",50596,"188.68.72.48",80,14,5488,7,1626,7,3862,9.116181,0.2993660000000009,43451.828196922695,103204.77275308454
"244.3.160.239",50597,"188.68.72.48",80,33,22081,16,2238,17,19843,9.117097,0.554450000000001,32291.46000541071,286308.9548200915
"244.3.160.239",50598,"188.68.72.48",80,17,8675,8,1669,9,7006,9.153556,0.3216870000000007,41506.18458315061,174231.47345090064
"244.3.160.239",50599,"188.68.72.48",80,13,3492,7,1618,6,1874,9.337949,0.2527790000000003,51206.785373784944,59308.724221553144
"244.3.160.239",50600,"188.68.72.48",80,11,2328,6,1544,5,784,9.339046,0.25202600000000075,49010.81634434528,24886.321252569105
"244.3.160.239",50601,"188.68.72.48",80,11,3296,6,1550,5,1746,9.33987,0.2517490000000002,49255.409157533846,55483.835089712324
"244.3.160.239",50602,"188.68.72.48",80,13,4198,7,1617,6,2581,9.341843,0.24843999999999866,52068.909998390234,83110.61020769647
"244.3.160.239",50603,"188.68.211.254",80,19,10725,9,1366,10,9359,9.355684,0.33504300000000065,32616.708900051573,223469.82327641483
"244.3.160.239",50604,"188.68.211.254",80,26,17714,11,1487,15,16227,9.373517,0.39777600000000035,29906.27891074371,326354.5311934352
"244.3.160.239",50605,"188.68.211.254",80,13,3757,7,1234,6,2523,9.38531,0.28587399999999974,34532.69622281148,70604.53206657484
"244.3.160.239",50606,"188.68.72.48",80,13,3841,7,1616,6,2225,9.398874,0.28357900000000136,45588.70720328352,62769.10490551104
"244.3.160.239",50607,"188.68.72.48",80,11,2993,6,1554,5,1439,9.516371,0.2504470000000012,49639.245029886326,45965.81312613026
"244.3.160.239",50608,"188.68.72.48",80,11,2935,6,1553,5,1382,9.517797999999999,0.2497940000000014,49736.98327421767,44260.470627797054
"244.3.160.239",50609,"188.68.72.48",80,13,3502,7,1620,6,1882,9.518253,0.24936300000000067,51972.42574078739,60377.84274330979
"244.3.160.239",50610,"188.68.72.48",80,11,3027,6,1557,5,1470,9.519259,0.24859900000000046,50104.78722762351,47305.09776789117
"244.3.160.239",50611,"188.68.72.48",80,11,3078,6,1551,5,1527,9.563899,0.2916950000000007,42537.58206345659,41879.36029071452
"244.3.160.239",50612,"188.68.72.48",80,13,3930,7,1618,6,2312,9.603838,0.2522750000000009,51309.087305519584,73316.81696561266
"244.3.160.239",50613,"188.68.72.48",80,11,2732,6,1553,5,1179,9.69847,0.3058379999999996,40622.81338486393,30839.856394561866
"244.3.160.239",50614,"188.68.72.48",80,17,9018,8,1670,9,7348,9.698958,0.3105890000000002,43015.045606895255,189266.2006703391
"244.3.160.239",50615,"188.68.72.48",80,28,19912,12,1933,16,17979,9.700274,0.4421689999999998,34973.05328957934,325287.3901155442
"244.3.160.239",50616,"188.68.72.48",80,11,2313,6,1538,5,775,9.700892,0.3037130000000001,40511.93067139041,20414.009278496465
"244.3.160.239",50617,"188.68.72.48",80,11,2298,6,1538,5,760,9.77999,0.242267,50786.94168004722,25096.278073365334
"244.3.160.239",50618,"188.68.72.48",80,11,2279,6,1535,5,744,9.780336,0.24207499999999982,50728.08014045238,24587.421253743694
"244.3.160.239",50619,"188.68.72.48",80,11,2277,6,1535,5,742,9.926911,0.25767199999999946,47657.48703778457,23037.03933683137
"244.3.160.239",50620,"188.68.72.48",80,11,2318,6,1536,5,782,9.927774,0.2575820000000011,47705.196791701084,24287.411387441567
"244.3.160.239",50621,"188.68.211.254",80,11,1887,6,1187,5,700,9.933653,0.25075299999999956,37869.935753510494,22332.73380577704
"244.3.160.239",50622,"188.68.211.254",80,13,4451,7,1265,6,3186,9.96076,0.25388500000000036,39860.56679205146,100391.9097229059
"244.3.160.239",50623,"188.68.211.254",80,13,4431,7,1265,6,3166,9.978047,0.3211739999999992,31509.399889156735,78860.67988068792
"244.3.160.239",50624,"188.68.211.254",80,13,4376,7,1265,6,3111,9.991424,0.30846700000000027,32807.399170737845,80682.8607274035
"244.3.160.239",50625,"117.246.95.43",80,10,2366,6,887,4,1479,9.999842,0.1175480000000011,60366.8288699079,100656.75298601329
"244.3.160.239",50626,"188.68.72.48",80,11,2154,6,1498,5,656,10.111597,0.2445800000000009,48998.28277046347,21457.191920843816
"244.3.160.239",50627,"128.71.90.164",80,44,41162,15,2150,29,39012,10.123267,0.8444109999999991,20369.2277812582,369602.0066057883
"244.3.160.239",50628,"94.2.202.203",80,13,3788,8,2787,5,1001,10.186461,0.15442100000000103,144384.5072885155,51858.23171718838
"244.3.160.239",50629,"94.2.202.203",80,81,71307,30,2872,51,68435,10.306559,0.6731440000000006,34132.36989410881,813317.8042142536
"244.3.160.239",50630,"128.71.90.164",80,10,2920,6,1428,4,1492,10.867276,0.26062799999999875,43832.58897739328,45797.0747578927
"244.3.160.239",50631,"177.124.75.164",80,13,2922,7,2310,6,612,11.40113,0.10534099999999924,175430.2693158422,46477.62979276858
"244.3.160.239",50632,"177.124.75.164",80,13,3391,7,2361,6,1030,11.479384,0.3287250000000004,57458.3618526123,25066.544984409433
"244.3.160.239",50633,"177.124.75.164",80,16,7274,8,2424,8,4850,11.695414,0.323068000000001,60024.51496279402,120098.55510295008
"244.3.160.239",50634,"177.124.75.164",80,15,5187,8,2424,7,2763,11.764662,0.25300999999999974,76645.1918896487,87364.13580490899
"244.3.160.239",50635,"177.124.75.164",80,16,6881,8,2424,8,4457,11.842865,0.32173799999999986,60272.64420118235,110823.09208113438
"244.3.160.239",50636,"177.124.75.164",80,13,3819,7,2361,6,1458,11.991915,0.31947300000000034,59122.367148397454,36510.12761641825
"244.3.160.239",50637,"177.124.75.164",80,13,3430,7,2361,6,1069,11.992517,0.32028700000000043,58972.10938939131,26701.052493544816
"244.3.160.239",50638,"177.124.75.164",80,13,3710,7,2361,6,1349,12.138338,0.35129800000000166,53766.31805475667,30720.357075758897
"244.3.160.239",50639,"177.124.75.164",80,13,3245,7,2361,6,884,12.222208,0.2675009999999993,70609.08183520827,26437.28434660064
"244.3.160.239",50640,"177.124.75.164",80,13,3225,7,2361,6,864,12.222873,0.26721400000000095,70684.91920333491,25866.908170978975
"244.3.160.239",50641,"177.124.75.164",80,13,3352,7,2361,6,991,12.28136,0.33493500000000154,56393.031483720464,23670.264379655644
"244.3.160.239",50642,"177.124.75.164",80,13,3355,7,2361,6,994,12.325273,0.29189299999999996,64708.643235706244,27242.859540996193
"244.3.160.239",50643,"177.124.75.164",80,13,3352,7,2361,6,991,12.442851,0.35968200000000117,52513.053196990506,22041.692383827867
"244.3.160.239",50644,"177.124.75.164",80,13,3536,7,2361,6,1175,12.443683,0.3598440000000007,52489.41207856727,26122.430831137885
"244.3.160.239",50645,"177.124.75.164",80,13,3949,7,2361,6,1588,12.44398,0.3598219999999994,52492.62135166841,35306.34591548049
"244.3.160.239",50646,"41.43.180.128",80,89,85212,32,3395,57,81817,12.47522,0.7488510000000002,36268.89728397237,874053.7169610509
"244.3.160.239",50647,"177.124.75.164",80,16,7833,8,2424,8,5409,12.581672,0.2457640000000012,78904.96573948953,176071.35300532132
"244.3.160.239",50648,"177.124.75.164",80,16,7878,8,2424,8,5454,12.582122,0.36445999999999934,53207.48504637007,119716.84135433266
"244.3.160.239",50649,"177.124.75.164",80,13,3586,7,2361,6,1225,12.623305,0.3130120000000005,60342.73446385432,31308.703819661816
"244.3.160.239",50650,"198.123.241.156",80,1031,1035496,352,23311,679,1012185,12.769285,7.391158999999998,25231.22557639472,1095562.9556880053
"244.3.160.239",50651,"177.124.75.164",80,16,8283,8,2424,8,5859,12.772251,0.4007259999999988,48392.16821469048,116967.7036179338
"244.3.160.239",50652,"177.124.75.164",80,19,11626,9,2488,10,9138,12.773514,0.4253789999999995,46791.21442290292,171856.15650984203
"244.3.160.239",50653,"177.124.75.164",80,22,14298,10,2552,12,11746,12.774639,0.4240289999999991,48147.650278636705,221607.48439375655
"244.3.160.239",50654,"177.124.75.164",80,16,7179,8,2424,8,4755,12.79767,0.34408499999999975,56358.167313309255,110554.07820741976
"244.3.160.239",50655,"177.124.75.164",80,16,8667,8,2424,8,6243,12.887314,0.2805990000000005,69109.29832251706,177990.65570440347
"244.3.160.239",50656,"188.68.72.48",80,14,5574,7,1662,7,3912,12.909035,0.3703050000000001,35905.537327338265,84514.11674160487
"244.3.160.239",50657,"177.124.75.164",80,19,10967,9,2488,10,8479,12.913437,0.259544,76688.34571402152,261350.67657121722
"244.3.160.239",50658,"177.124.75.164",80,16,6130,8,2424,8,3706,13.114037,0.24863999999999997,77992.277992278,119240.66924066926
"244.3.160.239",50659,"177.124.75.164",80,13,3480,7,2331,6,1149,13.139906,0.1076359999999994,173250.58530603242,85398.93715857196
"244.3.160.239",50660,"177.124.75.164",80,13,3084,7,2329,6,755,13.141082,0.10645599999999966,175020.66581498514,56737.05568497801
"244.3.160.239",50661,"177.124.75.164",80,13,2983,7,2328,6,655,13.146642,0.09805000000000064,189943.90617032003,53442.12136664932
"244.3.160.239",50662,"177.124.75.164",80,13,3485,7,2332,6,1153,13.146878,0.10178400000000032,183290.10453509336,90623.28067279702
"244.3.160.239",50663,"177.124.75.164",80,13,3112,7,2330,6,782,13.172225,0.11650600000000111,159991.76008102435,53696.805314747224
"244.3.160.239",50664,"177.124.75.164",80,13,3064,7,2330,6,734,13.216829,0.14152099999999912,131711.90141392525,41492.07538103912
"244.3.160.239",50665,"177.124.75.164",80,13,3048,7,2332,6,716,13.217814,0.13936099999999918,133868.15536627974,41101.88646751985
"244.3.160.239",50666,"177.124.75.164",80,13,3107,7,2329,6,778,13.218838,0.13973299999999966,133340.01273858032,44542.090987812575
"244.3.160.239",50667,"177.124.75.164",80,13,3103,7,2329,6,774,13.219699,0.13939099999999982,133667.16645981465,44421.80628591522
"244.3.160.239",50668,"188.68.72.48",80,31,23323,13,2048,18,21275,13.233102,0.5030019999999986,32572.43509966172,338368.43591079256
"244.3.160.239",50669,"188.68.72.48",80,35,28056,14,2188,21,25868,13.234729,0.5386790000000001,32494.305514044536,384169.4218634845
"244.3.160.239",50670,"177.124.75.164",80,15,4423,8,2425,7,1998,13.248038,0.2554759999999998,75936.6828978065,62565.56388858449
"244.3.160.239",50671,"177.124.75.164",80,15,4422,8,2425,7,1997,13.322561,0.3301829999999999,58755.29630538219,48385.28936983432
"244.3.160.239",50672,"177.124.75.164",80,13,3814,7,2361,6,1453,13.323435,0.3286479999999994,57471.82395754739,35369.148754898924
"244.3.160.239",50673,"177.124.75.164",80,13,3108,7,2328,6,780,13.323685,0.17494300000000074,106457.53188181248,35668.760682050575
"244.3.160.239",50674,"177.124.75.164",80,14,4102,8,2882,6,1220,13.324554,4.554400000000001,5062.357280871244,2142.9826102230804
"244.3.160.239",50675,"177.124.75.164",80,15,4458,8,2425,7,2033,13.335984,0.38298400000000044,50654.85764418351,42466.52601675261
"244.3.160.239",50676,"177.124.75.164",80,15,5048,8,2425,7,2623,13.396259,0.4237120000000001,45785.81678120987,49524.20512045917
"244.3.160.239",50677,"177.124.75.164",80,13,4181,7,2361,6,1820,13.472038,0.3480160000000012,54273.36674175881,41837.15691232572
"244.3.160.239",50678,"41.43.180.128",80,11,2287,6,1837,5,450,13.543481,0.07604899999999937,193243.82963615726,47337.90056411037
"244.3.160.239",50679,"188.68.72.48",80,11,3340,6,1648,5,1692,13.554185,0.2925310000000003,45068.727758767396,46272.01903388012
"244.3.160.239",50680,"188.68.72.48",80,11,2398,6,1658,5,740,13.557133,0.2897210000000001,45781.976453208415,20433.45149298807
"244.3.160.239",50681,"177.124.75.164",80,13,3690,7,2361,6,1329,13.620049,0.4707550000000005,40122.78148930969,22584.996441885884
"244.3.160.239",50682,"177.124.75.164",80,16,6282,9,2946,7,3336,13.621345,4.607025000000002,5115.665749588941,5792.892376316601
"244.3.160.239",50683,"177.124.75.164",80,15,5027,8,2425,7,2602,13.680992,0.411226000000001,47176.00540821824,50619.36745244695
"244.3.160.239",50684,"188.68.72.48",80,11,2359,6,1651,5,708,13.703943,0.2892349999999997,45665.28947049982,19582.692274448134
"244.3.160.239",50685,"177.124.75.164",80,15,4739,8,2425,7,2314,13.792767,0.29864099999999993,64960.939723614654,61987.46990533786
"244.3.160.239",50686,"177.124.75.164",80,15,5121,8,2425,7,2696,13.793723,0.2989580000000007,64892.05841623223,72143.91319181942
"244.3.160.239",50687,"41.43.180.128",80,17,5025,9,2866,8,2159,13.882799,0.09502699999999997,241278.79444789383,181758.86853210145
"244.3.160.239",50688,"177.124.75.164",80,16,5653,8,2425,8,3228,14.002613,0.26750700000000016,72521.46672797343,96535.79158676216
"244.3.160.239",50689,"177.124.75.164",80,15,5329,8,2425,7,2904,14.065792,0.3228390000000001,60091.8724193793,71961.56598180515
"244.3.160.239",50690,"177.124.75.164",80,16,5485,8,2425,8,3060,14.066441,0.3221950000000007,60211.98342618588,75978.8326944861
"244.3.160.239",50691,"177.124.75.164",80,13,3983,7,2361,6,1622,14.067093,0.3215470000000007,58741.02386276333,40354.90923566375
"244.3.160.239",50692,"41.43.180.128",80,11,2849,6,1781,5,1068,14.143096,0.09644600000000025,147730.33614665162,88588.43290545982
"244.3.160.239",50693,"177.124.75.164",80,13,3658,7,2361,6,1297,14.243391,0.29965699999999984,63032.0666628846,34626.25601938218
"244.3.160.239",50694,"177.124.75.164",80,15,5013,8,2384,7,2629,14.361047,0.11022900000000035,173021.61863030546,190802.78329659102
"244.3.160.239",50695,"40.248.176.156",80,13,4560,7,1797,6,2763,14.570613,2.647025000000001,5431.002729479319,8350.506700918953
"244.3.160.239",50696,"188.68.72.48",80,427,432440,145,10527,282,421913,15.222131,4.694172,17940.54414708281,719041.3985682672
"244.3.160.239",50697,"188.68.211.254",80,26,17155,11,1537,15,15618,15.458683,1.0473099999999995,11740.55437263084,119299.92074934838
"244.3.160.239",50698,"94.2.202.203",80,37,24634,24,23117,13,1517,15.604185,0.6434850000000001,287397.5306339697,18859.80248179833
"244.3.160.239",50699,"244.3.85.248",8080,5,330,5,330,0,0,15.644242,50.613024,52.160487387594145,0
"244.3.160.239",50700,"117.246.95.43",80,123,106680,45,3677,78,103003,15.772525,0.8876429999999988,33139.449080317245,928328.16796843
"244.3.160.239",50701,"94.2.202.203",80,216,203759,75,6805,141,196954,16.216467,1.4281549999999967,38119.11172106678,1103264.0014564272
"244.3.160.239",50702,"188.68.211.254",80,26,17155,11,1537,15,15618,16.550635,1.020671,12046.976939679877,122413.58870782063
"244.3.160.239",50703,"117.246.95.43",80,10,1674,6,1132,4,542,17.036471,0.243506,37190.048705165376,17806.542754593316
"244.3.160.239",50704,"117.246.95.43",80,12,2348,7,1584,5,764,17.053786,0.34129700000000085,37128.95220291994,17908.156239287146
"244.3.160.239",50705,"40.248.176.156",80,27,17409,12,2251,15,15158,17.176889,0.5250160000000008,34299.907050451744,230972.0084721224
"244.3.160.239",50706,"40.248.176.156",80,70,58565,26,3048,44,55517,17.177452,0.6066780000000023,40192.65574159589,732078.6314980901
"244.3.160.239",50707,"94.2.202.203",80,10,2131,6,1565,4,566,17.350161,0.11947299999999927,104793.55168113361,37899.77651854417
"244.3.160.239",50708,"94.2.202.197",80,33,28744,11,1822,22,26922,17.38529,0.33063499999999735,44084.86699835201,651401.0918384374
"244.3.160.239",50709,"94.2.202.197",80,10,1886,6,1543,4,343,17.385542,0.12118699999999905,101859.1103006106,22642.692698061852
"244.3.160.239",50710,"94.2.202.197",80,10,1885,6,1542,4,343,17.385573,0.12013100000000065,102687.89904354357,22841.731110204568
"244.3.160.239",50711,"94.2.202.197",80,12,3715,7,1570,5,2145,17.385819,0.12232599999999749,102676.45471935857,140280.88877262684
"244.3.160.239",50712,"94.2.202.197",80,10,1892,6,1549,4,343,17.482328,0.11758800000000136,105384.90322141594,23335.714528693134
"244.3.160.239",50713,"188.68.211.254",80,11,2263,6,1187,5,1076,17.527776,0.2661130000000007,35684.089089972964,32347.16079259554
"244.3.160.239",50714,"94.2.202.197",80,10,1891,6,1548,4,343,17.549072,0.1177480000000024,105173.76091313438,23304.00516356918
"244.3.160.239",50715,"94.2.202.197",80,12,4306,7,1554,5,2752,17.554443,0.12068599999999918,103011.11976534216,182423.81054969216
"244.3.160.239",50716,"94.2.202.197",80,31,22403,13,1934,18,20469,17.697142,0.23663000000000167,65384.777923339774,692017.0730676535
"244.3.160.239",50717,"94.2.202.197",80,10,2010,6,1548,4,462,17.924053,0.11782799999999938,105102.35258172985,31367.756390671315
"244.3.160.239",50718,"94.2.202.197",80,84,74825,31,3070,53,71755,17.934288,0.3327540000000013,73808.27878853418,1725118.255528101
"244.3.160.239",50719,"94.2.202.197",80,196,182905,68,5432,128,177473,17.934348,0.5053079999999994,85999.03425237686,2809739.8022592193
"244.3.160.239",50720,"94.2.202.197",80,10,1883,6,1539,4,344,17.937752,0.11781900000000078,104499.27431059437,23357.86248397951
"244.3.160.239",50722,"188.68.211.254",80,11,2021,6,1200,5,821,17.970981,0.30375500000000244,31604.418034270788,21622.68933844693
"244.3.160.239",50723,"188.68.211.254",80,11,2018,6,1200,5,818,17.986597,0.28846599999999967,33279.485277294414,22685.515797355692
"244.3.160.239",50724,"94.2.202.197",80,15,6813,8,1603,7,5210,18.046411,0.15742099999999937,81463.08307023873,264767.7247635333
"244.3.160.239",50725,"94.2.202.197",80,12,3281,7,1530,5,1751,18.046845,0.11922599999999761,102662.17100297121,117491.15125895594
"244.3.160.239",50726,"94.2.202.197",80,10,1883,6,1539,4,344,18.144822,0.11769999999999925,104604.92778249855,23381.47833474951
"244.3.160.239",50727,"94.2.202.197",80,10,1906,6,1562,4,344,18.180338,0.1169140000000013,106881.9816275199,23538.66944933857
"244.3.160.239",50728,"94.2.202.197",80,18,10189,9,1659,9,8530,18.255056,0.1603999999999992,82743.14214463881,425436.4089775582
"244.3.160.239",50729,"177.124.75.164",80,13,3410,7,2335,6,1075,18.261945,0.11842400000000097,157738.29629129102,72620.41478078708
"244.3.160.239",50730,"94.2.202.197",80,12,3285,7,1528,5,1757,18.305594,0.11997399999999914,101888.74256088893,117158.71772217398
"244.3.160.239",50731,"94.2.202.197",80,10,1883,6,1540,4,343,18.306634,0.1189290000000014,103591.21828990284,23072.589528205634
"244.3.160.239",50732,"177.202.64.13",80,21,13113,12,8495,9,4618,18.306826,0.17732299999999768,383255.4152591649,208342.96735336355
"244.3.160.239",50733,"94.2.202.197",80,12,3659,7,1566,5,2093,18.386201,0.13034100000000137,96117.10820079537,128463.03158637592
"244.3.160.239",50734,"94.2.202.197",80,10,1878,6,1535,4,343,18.395863,0.11966200000000171,102622.38638832566,22931.25637211446
"244.3.160.239",50735,"177.202.64.13",80,18,9295,11,8421,7,874,18.466718,0.1329039999999999,506892.1928610128,52609.40227532659
"244.3.160.239",50736,"94.2.202.197",80,12,3996,7,1538,5,2458,18.573062,0.11926100000000162,103168.6804571472,164882.0653859999
"244.3.160.239",50737,"156.224.224.225",80,10,2215,6,1563,4,652,18.574846,0.11041299999999765,113247.5342577438,47240.81403458027
"244.3.160.239",50738,"117.246.95.43",80,72,58491,27,2527,45,55964,18.575377,0.5705349999999996,35433.40899331332,784723.1107644585
"244.3.160.239",50739,"177.202.64.13",80,20,10511,12,8418,8,2093,18.659247,0.15705900000000028,428781.54069489735,106609.61804162747
"244.3.160.239",50740,"177.202.64.13",80,19,11326,12,9568,7,1758,18.796467,0.1866519999999987,410089.36416433,75348.7774039394
"244.3.160.239",50741,"94.2.202.197",80,10,1869,6,1525,4,344,18.866612,0.11740599999999901,103912.91756809791,23440.02861863979
"244.3.160.239",50742,"177.124.75.164",80,16,6562,9,3713,7,2849,18.959871,0.16020200000000173,185415.91241057962,142270.38364065214
"244.3.160.239",50743,"94.2.202.197",80,10,1886,6,1543,4,343,19.000807,0.11712900000000204,105388.07639440092,23427.1615056899
"244.3.160.239",50744,"94.2.202.197",80,10,1878,6,1535,4,343,19.001597,0.11884999999999835,103323.51703828499,23087.92595708909
"244.3.160.239",50745,"94.2.202.197",80,10,1875,6,1532,4,343,19.001915,0.1177810000000008,104057.5305015233,23297.475823774475
"244.3.160.239",50746,"94.2.202.197",80,10,1881,6,1538,4,343,19.04414,0.11721500000000162,104969.5004905501,23409.973126306035
"244.3.160.239",50747,"94.2.202.197",80,10,1876,6,1533,4,343,19.091749,0.11779299999999893,104114.84553411588,23295.10242544145
"244.3.160.239",50748,"94.2.202.197",80,10,1874,6,1531,4,343,19.093951,0.11819999999999808,103620.98138748053,23214.89001692085
"244.3.160.239",50749,"94.2.202.197",80,10,1875,6,1532,4,343,19.095051,0.11787299999999945,103976.31348994304,23279.29211948464
"244.3.160.239",50750,"177.124.75.164",80,428,405882,147,13290,281,392592,19.095981,3.321829000000001,32006.463908888738,945483.9487523286
"244.3.160.239",50751,"94.2.202.197",80,10,2016,6,1457,4,559,19.129934,0.11814800000000147,98655.92307952614,37850.83116091634
"244.3.160.239",50752,"94.2.202.197",80,10,2066,6,1458,4,608,19.180547,0.12600300000000075,92569.22454227225,38602.2555018529
"244.3.160.239",50753,"94.2.202.197",80,10,1876,6,1533,4,343,19.190119,0.11785000000000068,104064.48875689376,23283.83538396253
"244.3.160.239",50754,"94.2.202.197",80,10,2793,6,1448,4,1345,19.193651,0.1524540000000023,75983.57537355415,70578.66635181653
"244.3.160.239",50755,"94.2.202.197",80,10,2793,6,1448,4,1345,19.218169,0.12747500000000045,90872.72014120384,84408.70758972318
"244.3.160.239",50756,"94.2.202.197",80,10,1875,6,1532,4,343,19.280422,0.1188760000000002,103099.02755812762,23082.87627443719
"244.3.160.239",50757,"94.2.202.197",80,10,1874,6,1531,4,343,19.281135,0.11860200000000276,103269.7593632461,23136.203436703734
"244.3.160.239",50758,"117.246.95.43",80,10,1651,6,1109,4,542,19.461613,0.32983700000000127,26898.13453311777,13145.887210955663
"244.3.160.239",50759,"94.2.202.197",80,10,2858,6,1454,4,1404,19.462668999999998,0.12284100000000109,94691.51179166482,91435.26998314814
"244.3.160.239",50760,"94.2.202.197",80,12,3869,7,1524,5,2345,19.463067,0.12347500000000267,98740.63575622383,151933.58979550187
"244.3.160.239",50761,"117.246.95.43",80,12,2132,7,1368,5,764,19.476516,0.17228000000000065,63524.49500812606,35477.130253076255
"244.3.160.239",50762,"94.2.202.197",80,10,1874,6,1530,4,344,19.491274,0.12490199999999874,97996.82951434024,22033.27408688434
"244.3.160.239",50763,"94.2.202.197",80,10,1879,6,1536,4,343,19.492816,0.1238829999999993,99190.365102557,22149.93179047985
"244.3.160.239",50764,"94.2.202.197",80,12,3744,7,1521,5,2223,19.554275,0.1528710000000011,79596.5225582348,116333.37912357395
"244.3.160.239",50765,"94.2.202.197",80,12,3831,7,1521,5,2310,19.557254,0.15068899999999985,80749.09250177526,122636.68880940227
"244.3.160.239",50766,"244.239.197.117",80,773,970415,100,7181,673,963234,19.576363,1.7365279999999998,33082.10406051616,4437516.6999898655
"244.3.160.239",50767,"94.2.202.197",80,12,3633,7,1520,5,2113,19.584816,0.12312299999999965,98763.02559229417,137293.60070823526
"244.3.160.239",50768,"94.2.202.197",80,12,3479,7,1520,5,1959,19.588667,0.12142700000000062,100142.47243199567,129065.19966728915
"244.3.160.239",47726,"210.153.40.211",80,4,256,4,256,0,0,19.667841,179.997878,11.377911910717081,0
"244.3.160.239",50769,"94.2.202.197",80,12,3588,7,1522,5,2066,19.68419,0.12803399999999954,95099.73913179347,129090.71028008232
"244.3.160.239",50770,"94.2.202.197",80,12,3885,7,1524,5,2361,19.68441,0.126730000000002,96204.5293142887,149041.26883926222
"244.3.160.239",50771,"94.2.202.197",80,12,3786,7,1522,5,2264,19.687063,0.1252020000000016,97250.84263829527,144662.22584303582
"244.3.160.239",50772,"94.2.202.197",80,12,3414,7,1523,5,1891,19.688135,0.12456700000000254,97810.81666893922,121444.68438671311
"244.3.160.239",50773,"128.71.90.164",80,10,2910,6,1495,4,1415,19.768315,0.2470189999999981,48417.32822171611,45826.434403831634
"244.3.160.239",50774,"94.2.202.197",80,10,2004,6,1459,4,545,19.773918,0.13432200000000094,86895.66861720283,32459.314185315656
"244.3.160.239",50775,"94.2.202.197",80,10,2076,6,1459,4,617,19.785807,0.12242000000000175,95343.89805587186,40320.20911615691
"244.3.160.239",50776,"94.2.202.197",80,10,2466,6,1465,4,1001,19.78816,0.16894999999999882,69369.63598697887,47398.63865048864
"244.3.160.239",50777,"94.2.202.197",80,10,1875,6,1532,4,343,19.915699,0.11802000000000135,103846.80562616387,23250.296559904837
"244.3.160.239",50778,"128.71.90.164",80,114,99897,47,4311,67,95586,20.36327,2.543175999999999,13560.996171716002,300682.2964670948
"244.3.160.239",50779,"177.124.75.164",80,13,3391,7,2361,6,1030,20.745673,0.14254999999999995,132500.87688530344,57804.27920028062
"244.3.160.239",50780,"177.124.75.164",80,16,7274,8,2424,8,4850,20.749196,0.14103099999999813,137501.68402691788,275116.81828818144
"244.3.160.239",50781,"177.124.75.164",80,15,5187,8,2424,7,2763,20.760425,0.1304799999999986,148620.47823421375,169405.27283875106
"244.3.160.239",50782,"177.124.75.164",80,16,6881,8,2424,8,4457,20.762775,0.13257499999999922,146271.9215538383,268949.65114086523
"244.3.160.239",50783,"177.124.75.164",80,13,3819,7,2361,6,1458,20.765498,0.14962299999999829,126237.2763545726,77955.9292354794
"244.3.160.239",50784,"177.124.75.164",80,21,12160,10,2552,11,9608,20.769747,0.19728500000000082,103484.80624477236,389608.94137922133
"244.3.160.239",50785,"117.246.95.43",80,88,78282,33,2929,55,75353,20.838673,1.0929220000000015,21439.773378155045,551570.9263790089
"244.3.160.239",50786,"177.124.75.164",80,15,4423,8,2425,7,1998,20.849197,0.13588299999999975,142769.88291397772,117630.6086854134
"244.3.160.239",50787,"177.124.75.164",80,15,4422,8,2425,7,1997,20.863489,0.1554499999999983,124798.97073013967,102772.59568993357
"244.3.160.239",50788,"177.124.75.164",80,13,3814,7,2361,6,1453,20.864648,0.15479400000000254,122020.2333423756,75093.34987144082
"244.3.160.239",50789,"177.124.75.164",80,13,3581,7,2361,6,1220,20.866335,0.15259900000000215,123775.38515979616,63958.47941336354
"244.3.160.239",50790,"177.124.75.164",80,15,4458,8,2425,7,2033,20.881461,0.15595299999999668,124396.45277744201,104287.83030785139
"244.3.160.239",50791,"177.124.75.164",80,14,3951,8,2882,6,1069,20.936676,4.502600000000001,5120.596988406697,1899.3470439301732
"244.3.160.239",50792,"177.124.75.164",80,13,3710,7,2361,6,1349,20.95212,0.14719699999999847,128317.8325645237,73316.71161776471
"244.3.160.239",50793,"188.68.211.254",80,47,40950,18,2007,29,38943,20.962645,1.3351570000000024,12025.552051181974,233338.8507868359
"244.3.160.239",50794,"177.124.75.164",80,13,3245,7,2361,6,884,20.984827,0.14036000000000115,134568.25306354975,50384.72499287505
"244.3.160.239",50795,"177.124.75.164",80,13,3225,7,2361,6,864,20.985743,0.16566800000000015,114011.15483979999,41721.99821329402
"244.3.160.239",50796,"177.124.75.164",80,13,3352,7,2361,6,991,20.986811,0.14045499999999933,134477.23470150647,56445.12477305926
"244.3.160.239",50797,"177.124.75.164",80,13,3355,7,2361,6,994,20.993187,0.15297699999999992,123469.54117285612,51981.670447191435
"244.3.160.239",50798,"177.124.75.164",80,15,5589,8,2425,7,3164,21.061401,0.14279900000000012,135855.29310429332,177256.14325030273
"244.3.160.239",50799,"177.124.75.164",80,13,3352,7,2361,6,991,21.088834,0.2310980000000029,81731.55977117829,34305.792347834686
"244.3.160.239",50800,"177.124.75.164",80,13,3536,7,2361,6,1175,21.098827,0.22207999999999828,85050.43227665772,42327.08933717612
"244.3.160.239",50801,"177.124.75.164",80,13,3949,7,2361,6,1588,21.099442,0.22039399999999887,85701.06264235913,57642.2225650429
"244.3.160.239",50802,"177.124.75.164",80,16,7833,8,2424,8,5409,21.10163,0.2190349999999981,88533.79596868157,197557.4679845704
"244.3.160.239",50803,"177.124.75.164",80,16,7878,8,2424,8,5454,21.175622,0.2732059999999983,70979.40748007043,159703.66683015847
"244.3.160.239",50804,"177.124.75.164",80,13,3586,7,2361,6,1225,21.292969,0.1799420000000005,104967.15608362666,54461.99330895496
"244.3.160.239",50805,"177.124.75.164",80,16,8283,8,2424,8,5859,21.293597,0.18862900000000238,102804.97696536458,248487.7722937587
"244.3.160.239",50806,"177.124.75.164",80,20,12146,10,3008,10,9138,21.294531,4.4249030000000005,5438.311303095231,16521.040122235445
"244.3.160.239",50807,"177.124.75.164",80,22,14298,10,2552,12,11746,21.294958,0.31536299999999784,64738.09546459204,297967.73876453686
"244.3.160.239",50808,"177.124.75.164",80,16,7179,8,2424,8,4755,21.315015,0.1582019999999993,122577.46425456117,240452.080251831
"244.3.160.239",50809,"177.124.75.164",80,16,8667,8,2424,8,6243,21.421774,0.18860400000000155,102818.604059298,264808.8057517316
"244.3.160.239",50810,"177.124.75.164",80,19,10967,9,2488,10,8479,21.446235,0.2924239999999969,68065.54865537785,231964.54463382185
"244.3.160.239",50811,"177.124.75.164",80,15,5048,8,2425,7,2623,21.447324,0.1630490000000009,118982.63712135551,128697.50811105793
"244.3.160.239",50812,"177.124.75.164",80,13,4181,7,2361,6,1820,21.478007,0.1313949999999977,143749.7621675127,110810.91365729483
"244.3.160.239",50813,"177.124.75.164",80,13,3690,7,2361,6,1329,21.56664,0.172937000000001,109218.96413144608,61479.03571820916
"244.3.160.239",50814,"177.124.75.164",80,15,5761,8,2425,7,3336,21.583331,0.15697299999999714,123588.13299102618,170016.49965280964
"244.3.160.239",50815,"177.124.75.164",80,15,5027,8,2425,7,2602,21.584099,0.1562090000000005,124192.58813512627,133257.36673303033
"244.3.160.239",50816,"177.124.75.164",80,15,4739,8,2425,7,2314,21.584468,0.15583099999999916,124493.84268855429,118795.36164177924
"244.3.160.239",50817,"128.71.90.164",80,10,2975,6,1483,4,1492,21.641217,0.2600750000000005,45617.6103047197,45894.453523022115
"244.3.160.239",50818,"177.124.75.164",80,15,5121,8,2425,7,2696,21.713239,0.136257999999998,142376.96135273002,158287.95373482892
"244.3.160.239",50819,"177.124.75.164",80,15,5329,8,2425,7,2904,21.713825,0.13673800000000114,141877.16655209113,169901.56357413306
"244.3.160.239",50820,"177.124.75.164",80,15,5421,8,2425,7,2996,21.714867,0.13477499999999765,143943.60971990606,177837.1359673561
"244.3.160.239",50821,"177.124.75.164",80,13,3983,7,2361,6,1622,21.71588,0.13492100000000207,139993.03296002632,96174.79858583765
"244.3.160.239",50822,"177.124.75.164",80,13,3658,7,2361,6,1297,21.822188,0.24657299999999793,76602.06105291398,42080.84421246481
"244.3.160.239",50823,"117.246.95.43",80,10,1765,6,1049,4,716,21.884438,0.2868719999999989,29253.464959982262,19967.09333779533
"244.3.160.239",50824,"117.246.95.43",80,10,1759,6,1048,4,711,21.895989,0.27664100000000147,30306.426017835227,20560.943605611497
"244.3.160.239",50825,"188.68.211.254",80,52,41300,22,2293,30,39007,22.170104,1.3246029999999998,13848.677679274471,235584.54872893996
"244.3.160.239",50826,"177.124.75.164",80,16,6130,8,2424,8,3706,22.26066,0.22826999999999842,84952.03049020955,129881.28093923951
"244.3.160.239",50827,"117.246.95.43",80,10,1691,6,1149,4,542,22.379031,0.20921599999999785,43935.4542673605,20724.992352401558
"244.3.160.239",50828,"117.246.95.43",80,12,2160,7,1396,5,764,22.394569,0.16213799999999878,68879.59639319644,37696.28341289547
"244.3.160.239",50829,"177.124.75.164",80,58,46573,22,3487,36,43086,22.61259,0.3511539999999975,79440.92905107218,981586.4264681662
"244.3.160.239",50830,"128.71.90.164",80,16,7934,8,1612,8,6322,22.614654,0.3777759999999972,34136.63123120605,133878.27707424603
"244.3.160.239",50831,"177.124.75.164",80,1454,1397779,490,33439,964,1364340,22.927759000000002,2.069635999999999,129255.57924195372,5273738.956995338
"244.3.160.239",50832,"188.68.211.254",80,11,2277,6,1201,5,1076,23.223478,0.2449760000000012,39220.16850630247,35138.13598066732
"244.3.160.239",50833,"188.68.211.254",80,11,1923,6,1207,5,716,23.674432,0.24899600000000177,38779.73943356492,23004.38561262012
"244.3.160.239",50834,"188.68.211.254",80,11,1923,6,1207,5,716,23.690666,0.24238799999999827,39836.955624866205,23631.532914170835
"244.3.160.239",50835,"82.242.98.77",80,53,45445,20,2564,33,42881,23.821738,0.3430029999999995,59801.226228342115,1000131.1941878074
"244.3.160.239",50836,"128.71.90.164",80,16,7018,8,1417,8,5601,24.406656,0.3826450000000001,29625.37077447764,117100.7069215591
"244.3.160.239",50837,"82.242.98.106",80,10,2549,6,1304,4,1245,24.433708,0.2310769999999991,45145.12478524492,43102.515611679395
"244.3.160.239",50838,"82.242.98.106",80,10,2549,6,1304,4,1245,24.527531,0.22833200000000176,45687.858031287426,43620.69267557733
"244.3.160.239",50839,"82.242.98.106",80,10,2550,6,1305,4,1245,24.558648,0.22986299999999815,45418.35789144005,43330.15752861522
"244.3.160.239",50840,"188.68.193.209",80,11,2396,6,1388,5,1008,32.521021,0.447414000000002,24818.1773480489,18023.575480427444
"244.3.160.239",50841,"244.3.31.75",80,13,3383,7,852,6,2531,32.971861,0.2734670000000037,24924.396727941243,74041.84051457663
"244.3.160.239",50842,"188.68.193.209",80,16,5962,8,1500,8,4462,33.085136,1.0834820000000036,11075.403190823623,32945.63269163667
"244.3.160.239",50843,"244.3.31.75",80,11,1511,6,886,5,625,33.280037,0.008119000000000653,873013.9179701231,615839.3890872764
"244.3.160.239",50844,"244.3.31.75",80,11,2761,6,1000,5,1761,33.352105,0.5611779999999982,14255.726347077089,25104.33409720275
"244.3.160.239",50845,"244.3.31.75",80,11,2281,6,1076,5,1205,33.978395,0.014737000000003775,584108.0274138424,654135.8485443123
"244.3.160.239",50846,"244.3.31.75",80,14,5612,7,1081,7,4531,34.026467,0.0590570000000028,146434.80027769087,613779.9075469171
"244.3.160.239",50847,"244.3.31.75",80,13,3521,7,980,6,2541,34.159933,0.27923799999999943,28076.40793874765,72798.11486975283
"244.3.160.239",50848,"188.68.193.209",80,14,4444,7,1425,7,3019,34.279427,0.5475540000000052,20819.864342146877,44108.89154311679
"244.3.160.239",50849,"188.68.193.209",80,22,12949,10,1651,12,11298,34.280602,0.8081789999999955,16342.914131646668,111836.61045387284
"244.3.160.239",50850,"188.68.193.209",80,20,12208,9,1585,11,10623,34.281601,0.6543399999999977,19378.30485680234,129877.43375003866
"244.3.160.239",50851,"188.68.193.209",80,23,15157,10,1647,13,13510,34.281777,0.854727000000004,15415.448441432105,126449.7319027005
"244.3.160.239",50852,"188.68.193.209",80,26,18035,11,1713,15,16322,34.28281,0.9072010000000006,15105.803454802179,143932.82194353832
"244.3.160.239",50853,"244.3.31.75",80,11,2775,6,1008,5,1767,34.520186,0.2744769999999974,29379.510851547035,51501.58301059882
"244.3.160.239",50854,"244.3.31.75",80,11,2295,6,1084,5,1211,34.860153,0.010457999999999856,829221.6484987683,926372.1552878306
"244.3.160.239",50855,"244.3.31.75",80,43,35493,17,1729,26,33764,34.902116,0.22606900000000252,61184.85948980111,1194821.0502103206
"244.3.160.239",50856,"244.3.31.75",80,11,1488,6,868,5,620,35.177353,0.011377000000003079,610354.2234330773,435967.3024521981
"244.3.160.239",50857,"244.3.31.75",80,11,1476,6,855,5,621,35.177474,0.011328000000006,603813.5593217141,438559.322033666
"244.3.160.239",50858,"244.3.31.75",80,11,1477,6,855,5,622,35.191842,0.006399999999999295,1068750.0000001178,777500.0000000857
"244.3.160.239",50859,"244.3.31.75",80,11,1479,6,857,5,622,35.195776,0.012125999999994974,565396.6683162495,410357.9086262628
"244.3.160.239",50860,"128.71.90.164",80,104,98312,38,4239,66,94073,35.206196,1.551363000000002,21859.487431374833,485111.4793894137
"244.3.160.239",50861,"188.68.193.209",80,11,2759,6,1249,5,1510,35.265469,0.38738599999999934,25793.394701925256,31183.367493920847
"244.3.160.239",50862,"244.3.31.75",80,13,3383,7,852,6,2531,35.681795,0.2657689999999988,25646.33196497722,76186.46267999688
"244.3.160.239",50863,"244.3.31.75",80,11,1511,6,886,5,625,35.988106,0.009958999999994944,711718.0439806806,502058.43960262457
"244.3.160.239",50864,"244.3.31.75",80,11,2761,6,1000,5,1761,36.060736,0.5770949999999999,13862.535631048617,24411.925246276613
"244.3.160.239",50865,"244.3.31.75",80,11,1335,6,781,5,554,36.355933,0.020834000000000685,299894.403379082,212729.1926658277
"244.3.160.239",50866,"128.71.90.164",80,10,1751,6,1260,4,491,36.462111,3.1219269999999995,3228.7750482314295,1258.197260858438
"244.3.160.239",50867,"41.43.180.128",80,11,2873,6,1793,5,1080,36.863191,0.19886600000000243,72128.97126708349,43446.340752063676
"244.3.160.239",50868,"244.3.31.75",80,11,2281,6,1076,5,1205,37.004313,0.0063529999999971665,1354950.4171263718,1517393.3574695892
"244.3.160.239",50869,"244.3.31.75",80,14,5612,7,1081,7,4531,37.042182,0.04855600000000493,178103.63291867374,746519.4826591219
"244.3.160.239",50870,"244.3.31.75",80,13,3521,7,980,6,2541,37.153922,0.264088000000001,29687.074005634375,76974.3418860377
"244.3.160.239",50871,"244.3.31.75",80,11,2775,6,1008,5,1767,37.470506,0.2698120000000017,29887.477206350897,52392.035936132976
"244.3.160.239",50872,"244.3.31.75",80,14,5383,7,852,7,4531,37.501789,0.045786999999997136,148863.21444952555,791665.7566558688
"244.3.160.239",50873,"244.3.31.75",80,11,1511,6,886,5,625,37.576376,0.01213899999999768,583903.1221683298,411895.54329030035
"244.3.160.239",50874,"244.3.31.75",80,13,3504,7,963,6,2541,37.634412,0.2742500000000021,28091.157702825672,74122.15132178612
"244.3.160.239",50875,"244.3.31.75",80,11,2295,6,1084,5,1211,37.782589,0.008100999999996361,1070485.1252936546,1195901.7405263982
"244.3.160.239",50876,"244.3.31.75",80,43,35493,17,1729,26,33764,37.821253,0.22234500000000423,62209.62917987693,1214832.8048752833
"244.3.160.239",50877,"244.3.31.75",80,11,2775,6,1008,5,1767,37.966609,0.578158000000002,13947.744388212172,24450.063823383836
"244.3.160.239",50886,"244.3.31.108",80,11,1913,6,1488,5,425,38.492537,0.011067000000004157,1075630.2521004362,307219.66205825633
"244.3.160.239",50899,"244.3.31.75",80,11,2295,6,1084,5,1211,38.588206,0.012957000000000107,669290.7308790559,747703.9438141483
"244.3.160.239",50910,"244.3.31.75",80,43,35493,17,1729,26,33764,38.631583,0.22397699999999787,61756.34105287655,1205980.9712604533
"244.3.160.239",50911,"43.106.84.108",80,10,2082,6,1226,4,856,39.200285,0.12188499999999891,80469.29482709183,56184.10797062855
"244.3.160.239",50914,"82.242.98.77",80,78,90456,16,2464,62,87992,39.589531,1.632832999999998,12072.269484999399,431113.2859269753
"244.3.160.239",50915,"128.71.90.164",80,10,1752,6,1261,4,491,39.667538,0.24387800000000226,41364.94476746532,16106.413862668891
"244.3.160.239",50916,"41.43.180.128",80,13,3566,7,2106,6,1460,39.696656,0.24528100000000563,68688.56535972869,47618.85347825446
"244.3.160.239",50917,"244.3.31.75",80,11,1335,6,781,5,554,40.012731,0.005463999999996361,1143484.6266479066,811127.3792099106
"244.3.160.239",50918,"128.71.90.164",80,10,1758,6,1265,4,493,40.191411,0.23945899999999654,42261.932105287946,16470.460496369138
"244.3.160.239",50919,"41.43.180.128",80,88,82704,32,3395,56,79309,40.356967,0.8399750000000026,32334.295663561315,755346.2900681545
"244.3.160.239",50920,"128.71.90.164",80,10,1755,6,1262,4,493,40.600085,0.23314899999999739,43302.78062526587,16916.22095741369
"244.3.160.239",50921,"128.71.90.164",80,10,2975,6,1483,4,1492,41.072319,0.25521499999999975,46486.29586818961,46768.41094763244
"244.3.160.239",50922,"128.71.90.164",80,10,1758,6,1263,4,495,41.111,0.23557900000000132,42890.07084672209,16809.6477190241
"244.3.160.239",50923,"117.203.39.40",80,10,2582,6,1391,4,1191,41.179589,0.13210000000000122,84239.21271763738,72127.17638152848
"244.3.160.239",50924,"41.43.180.128",80,73,66133,27,3250,46,62883,41.307753,6.7542860000000005,3849.4076205834335,74480.70750927633
"244.3.160.239",50925,"41.43.180.128",80,91,83389,34,3644,57,79745,41.311573,0.41051399999999916,71013.41245365581,1554051.7497576242
"244.3.160.239",50926,"117.203.39.40",80,12,4899,7,1727,5,3172,41.355872,0.3041990000000041,45417.63779631035,83419.07764325214
"244.3.160.239",50927,"244.3.31.75",80,14,5383,7,852,7,4531,41.416162,0.054923000000002276,124101.0141470735,659978.5153760446
"244.3.160.239",50928,"82.242.98.106",80,12,3453,7,1432,5,2021,41.433776,0.37113899999999944,30867.1414214082,43563.193304934335
"244.3.160.239",50929,"82.242.98.77",80,11,2344,6,1825,5,519,41.450256,0.2523129999999938,57864.63638417505,16455.75138815718
"244.3.160.239",50930,"244.3.31.75",80,11,1511,6,886,5,625,41.511791,0.006333999999995399,1119040.1010428085,789390.590464735
"244.3.160.239",50931,"128.71.90.164",80,10,1756,6,1265,4,491,41.520888,0.2364730000000037,42795.58342812854,16610.77586024594
"244.3.160.239",50932,"244.3.31.75",80,13,3504,7,963,6,2541,41.577952,0.6116039999999998,12596.385896756728,33237.19269331137
"244.3.160.239",50933,"82.242.98.77",80,21,13519,10,1879,11,11640,42.012582,0.12955799999999584,116025.2550981065,718751.4472282915
"244.3.160.239",50934,"82.242.98.77",80,11,2223,6,1596,5,627,42.026632,0.3110330000000019,41050.30655911084,16126.906148222117
"244.3.160.239",50935,"82.242.98.77",80,10,2077,6,1609,4,468,42.044264,0.11891400000000374,108246.29564222544,31484.938695190493
"244.3.160.239",50936,"82.242.98.77",80,10,2064,6,1623,4,441,42.044519,0.18172799999999967,71447.43792921302,19413.62916006343
"244.3.160.239",50937,"82.242.98.77",80,10,2051,6,1596,4,455,42.045459,0.11893799999999999,107350.04792412855,30604.180329247174
"244.3.160.239",50938,"48.151.224.224",80,10,2159,6,1245,4,914,42.045656,0.2871469999999974,34686.0667184407,25464.309221409476
"244.3.160.239",50939,"128.71.90.164",80,10,1750,6,1259,4,491,42.058045,0.23471099999999723,42912.34752525497,16735.474690151063
"244.3.160.239",50940,"244.3.31.75",80,11,2775,6,1008,5,1767,42.258956,0.26050200000000245,30955.616463596918,54264.458622198166
"244.3.160.239",50941,"128.71.90.164",80,16,7932,8,1612,8,6320,42.502521,0.3879930000000016,33237.71305152399,130311.62933351837
"244.3.160.239",50942,"244.3.31.75",80,11,2295,6,1084,5,1211,42.566252,0.01614500000000163,537132.2390832533,600061.9386806455
"244.3.160.239",50943,"244.3.31.75",80,43,35493,17,1729,26,33764,42.612122,0.2199060000000017,62899.60255745588,1228306.6401098557
"244.3.160.239",50955,"244.3.31.75",80,13,4451,7,1396,6,3055,43.57216,0.055210000000002424,202282.195254474,442673.4287266605
"244.3.160.239",50956,"244.3.31.108",80,57,47043,22,4777,35,42266,43.661,2.343207999999997,16309.2649052069,144301.31682718752
"244.3.160.239",50957,"244.3.31.75",80,11,1335,6,781,5,554,44.580761,0.006979999999998654,895128.9398282529,634957.0200574291
"244.3.160.239",50958,"94.2.202.203",80,20,10886,13,9753,7,1133,45.168759,0.9981200000000001,78170.96140744598,9081.072416142346
"244.3.160.239",50959,"244.3.31.108",80,13,3455,7,1093,6,2362,45.994967,0.18307000000000073,47763.1507073795,103217.34855519705
"244.3.160.239",50960,"244.3.31.108",80,15,4777,8,1150,7,3627,46.000939,0.17754000000000048,51819.3083248844,163433.59242987452
"244.3.160.239",50961,"244.3.31.108",80,16,7335,8,1140,8,6195,46.000992,0.1778150000000025,51289.261310912305,278716.6437027208
"244.3.160.239",50962,"244.3.31.108",80,18,8662,9,1203,9,7459,46.004536,0.17493899999999485,55013.46183526991,341101.7554690593
"244.3.160.239",50964,"244.3.31.108",80,24,14459,11,1333,13,13126,46.131826,0.1561050000000037,68312.99445885619,672675.4428109125
"244.3.160.239",50965,"94.2.202.203",80,113,103073,40,3852,73,99221,46.135646,1.1364289999999997,27116.520257754783,698475.6636798254
"244.3.160.239",50966,"244.3.31.108",80,11,2351,6,1015,5,1336,46.301262,0.20689000000000135,39247.90951713445,51660.30257624791
"244.3.160.239",50967,"244.3.31.108",80,13,3128,7,1024,6,2104,46.440323,0.17766800000000416,46108.47198144747,94738.50102438034
"244.3.160.239",50968,"128.71.90.164",80,16,7018,8,1417,8,5601,46.503116,0.4759030000000024,23819.98012199953,94153.64055280125
"244.3.160.239",50969,"198.123.241.156",80,33,27863,12,1890,21,25973,46.583021,0.9835459999999969,15372.946461070502,211260.07324517678
"244.3.160.239",50970,"244.3.31.75",80,13,3383,7,852,6,2531,46.619618,0.6446479999999966,10573.21204750505,31409.38931013531
"244.3.160.239",50971,"94.2.202.197",80,10,1887,6,1543,4,344,47.103183,0.11745499999999964,105095.56851560203,23430.24988293396
"244.3.160.239",50972,"94.2.202.197",80,10,1885,6,1542,4,343,47.105008,0.11757300000000015,104922.04842948623,23338.691706429167
"244.3.160.239",50973,"94.2.202.197",80,10,1892,6,1549,4,343,47.112909,0.12010099999999824,103179.82364843076,22847.436740743542
"244.3.160.239",50974,"94.2.202.197",80,10,2009,6,1548,4,461,47.113104,0.12012700000000365,103090.89546895889,30700.841609295894
"244.3.160.239",50975,"94.2.202.197",80,10,1892,6,1548,4,344,47.265934,0.11713900000000166,105720.55421336895,23493.456491859764
"244.3.160.239",50976,"244.3.31.75",80,11,1511,6,886,5,625,47.303934,0.004184999999999661,0,0
"244.3.160.239",50978,"94.2.202.197",80,10,1869,6,1525,4,344,47.334499,0.11700799999999845,104266.37494872283,23519.759332695514
"244.3.160.239",50979,"94.2.202.197",80,10,2041,6,1578,4,463,47.336102,0.11837900000000445,106640.53590585767,31289.33341217497
"244.3.160.239",50980,"94.2.202.197",80,10,1878,6,1535,4,343,47.336345,0.11753799999999615,104476.85003999049,23345.641409587453
"244.3.160.239",50981,"244.3.31.75",80,11,2761,6,1000,5,1761,47.358278,0.2669520000000034,29967.93431028761,52773.53232041648
"244.3.160.239",50982,"94.2.202.197",80,10,1883,6,1539,4,344,47.378602,0.11897799999999847,103481.31587352416,23130.326615004753
"244.3.160.239",50983,"94.2.202.197",80,10,1893,6,1549,4,344,47.466066,0.11707400000000234,105847.58357961419,23506.500162290045
"244.3.160.239",50984,"198.123.241.156",80,11,1985,6,1541,5,444,47.542853,0.39132399999999734,31503.306722818135,9076.877472375894
"244.3.160.239",50985,"94.2.202.197",80,10,2002,6,1540,4,462,47.559423,0.11990399999999823,102748.8657592756,30824.65972778268
"244.3.160.239",50986,"94.2.202.197",80,10,1887,6,1543,4,344,47.649272,0.11789099999999308,104706.89026304573,23343.597051515055
"244.3.160.239",50987,"244.3.31.75",80,11,2281,6,1076,5,1205,47.676486,0.060725000000005025,141753.80815149096,158748.45615478308
"244.3.160.239",49651,"85.224.40.142",80,44,36258,17,1088,27,35170,47.689597,161.494439,53.89659268700887,1742.2271735313436
"244.3.160.239",50989,"94.2.202.197",80,16,7856,8,1595,8,6261,47.735385,0.15883300000000133,80335.95033777547,315350.0846801331
"244.3.160.239",50990,"188.68.211.254",80,13,4484,7,1307,6,3177,47.760595,1.0425199999999961,10029.543797720944,24379.3884050187
"244.3.160.239",50991,"244.3.31.75",80,14,5612,7,1081,7,4531,47.764337,0.043237000000004855,200013.8770034699,838356.037652842
"244.3.160.239",50993,"244.3.31.75",80,13,3521,7,980,6,2541,47.859949,0.6267589999999998,12508.79524665781,32433.519103834176
"244.3.160.239",50994,"94.2.202.197",80,12,3914,7,1534,5,2380,47.86421,0.11921900000000107,102936.61245271214,159706.08711698494
"244.3.160.239",50995,"94.2.202.197",80,12,3253,7,1557,5,1696,48.078938,0.11988099999999946,103903.03717853584,113178.90241155864
"244.3.160.239",50996,"94.2.202.197",80,10,1869,6,1525,4,344,48.08397,0.11694500000000119,104322.54478600946,23532.429774680168
"244.3.160.239",50997,"94.2.202.197",80,10,1878,6,1535,4,343,48.084504,0.11896199999999624,103226.24031203568,23066.189203275724
"244.3.160.239",50998,"94.2.202.197",80,10,1886,6,1543,4,343,48.085056,0.11751999999999896,105037.44043567145,23349.217154527098
"244.3.160.239",50999,"94.2.202.197",80,10,1875,6,1532,4,343,48.174719,0.12527799999999445,97830.4251345052,21903.287089513895
"244.3.160.239",51000,"94.2.202.197",80,10,2557,6,1474,4,1083,48.177347,0.12407400000000024,95040.0567403322,69829.29542047474
"244.3.160.239",51001,"94.2.202.197",80,10,1881,6,1538,4,343,48.178031,0.12240500000000054,100518.76965810175,22417.384910747012
"244.3.160.239",51002,"94.2.202.197",80,10,1876,6,1533,4,343,48.181461,0.11995500000000447,102238.33937726266,22875.244883497126
"244.3.160.239",51003,"94.2.202.197",80,10,2793,6,1448,4,1345,48.271777,0.28448099999999954,40719.76687371044,37823.264119572195
"244.3.160.239",51004,"94.2.202.197",80,10,1875,6,1532,4,343,48.2751,0.11764799999999553,104175.16659867116,23323.81340949361
"244.3.160.239",51005,"94.2.202.197",80,10,1878,6,1534,4,344,48.280906,0.11720899999999546,104701.85736590599,23479.425641376572
"244.3.160.239",51006,"94.2.202.197",80,10,1875,6,1532,4,343,48.281462,0.1185390000000055,103392.13254708941,23148.499649903177
"244.3.160.239",51007,"94.2.202.197",80,10,2233,6,1470,4,763,48.361525,0.12040600000000268,97669.55135125939,50695.14808232035
"244.3.160.239",51008,"244.3.31.75",80,13,3383,7,852,6,2531,48.475549,0.617053999999996,11046.034868909437,32813.9838652697
"244.3.160.239",51009,"244.3.31.75",80,11,2775,6,1008,5,1767,48.558032,0.25876800000000344,31163.049526989013,54628.08384344205
"244.3.160.239",51010,"94.2.202.197",80,10,2913,6,1475,4,1438,48.64779,0.11848899999999674,99587.30346277144,97089.18127421378
"244.3.160.239",51011,"244.3.31.75",80,11,2295,6,1084,5,1211,48.872141,0.05807099999999821,149334.43543249244,166830.25950991543
"244.3.160.239",51012,"188.68.211.254",80,31,21770,13,1688,18,20082,48.892256,1.160415999999998,11637.20596751512,138446.9018007338
"244.3.160.239",51013,"188.68.211.254",80,32,24637,13,1772,19,22865,48.909238,1.2250999999999976,11571.300302016185,149310.26038690747
"244.3.160.239",51014,"244.3.31.75",80,43,35493,17,1729,26,33764,48.96012,0.22164899999999932,62404.97362947743,1218647.501229425
"244.3.160.239",51015,"244.3.31.75",80,11,1511,6,886,5,625,49.131202,0.0074509999999961,951281.7071539002,671050.865655968
"244.3.160.239",51016,"244.3.31.75",80,11,2761,6,1000,5,1761,49.196288,0.5777730000000005,13846.268344142063,24383.278554034176
"244.3.160.239",51017,"244.3.31.75",80,11,2281,6,1076,5,1205,49.828541,0.011725999999995906,734095.1731198196,822104.724544036
"244.3.160.239",51018,"244.3.31.75",80,14,5612,7,1081,7,4531,49.874326,0.04738699999999341,182497.30938867628,764935.5308418985
"244.3.160.239",51019,"244.3.31.75",80,13,3521,7,980,6,2541,49.970329,0.5850960000000001,13399.51050767737,34743.01653062061
"244.3.160.239",51020,"188.68.211.254",80,11,2274,6,1198,5,1076,49.973716,0.4190619999999967,22870.124229827747,20541.113248159145
"244.3.160.239",51021,"188.68.211.254",80,11,2358,6,1282,5,1076,50.084334,0.4185580000000044,24503.175187190045,20565.847505005062
"244.3.160.239",51022,"244.3.31.75",80,11,1335,6,781,5,554,50.358315,0.00963000000000136,648805.8151608637,460228.4527517523
"244.3.160.239",51023,"188.68.211.254",80,13,3436,7,1360,6,2076,50.621031,0.42387499999999534,25667.944559127383,39181.36242996209
"244.3.160.239",51024,"188.68.211.254",80,11,2046,6,1306,5,740,50.638274,0.4074229999999943,25644.109439084554,14530.352974672718
"244.3.160.239",51025,"188.68.211.254",80,11,2013,6,1306,5,707,50.653295,0.39236100000000107,26628.538514276323,14415.296117605942
"244.3.160.239",51026,"188.68.211.254",80,11,2031,6,1299,5,732,50.667664,0.37802899999999795,27489.954474392325,15490.875038687593
"244.3.160.239",51027,"188.68.211.254",80,11,2052,6,1312,5,740,50.681409,0.3643039999999971,28811.10281523147,16250.16469761531
"244.3.160.239",51028,"188.68.211.254",80,11,2928,6,1311,5,1617,50.705453,0.44983299999999815,23315.319240696088,28757.338834634305
"244.3.160.239",51029,"188.68.211.254",80,11,2836,6,1312,5,1524,51.020375,0.2751269999999977,38149.65452318416,44314.080406503555
"244.3.160.239",51030,"244.3.31.75",80,11,2775,6,1008,5,1767,51.258049,0.5558130000000006,14508.476771863903,25433.014341154285
"244.3.160.239",51031,"41.43.180.128",80,17,5025,9,2866,8,2159,51.49799,0.28381900000000115,80783.87986709808,60855.68619437011
"244.3.160.239",51032,"41.43.180.128",80,11,2853,6,1783,5,1070,51.811576,0.19044499999999687,74898.26459082798,44947.36013022206
"244.3.160.239",51033,"188.68.211.254",80,3380,3408344,1170,76437,2210,3331907,52.056181,20.387442,29993.757922156197,1307435.0377060545
"244.3.160.239",51034,"244.3.31.75",80,11,2295,6,1084,5,1211,52.096283,0.016691000000001566,519561.4402971174,580432.5684500085
"244.3.160.239",51035,"244.3.31.75",80,43,35493,17,1729,26,33764,52.141974,0.2205900000000014,62704.56503014603,1224497.9373498268
"244.3.160.239",51036,"82.242.98.77",80,97,90579,35,3680,62,86899,52.436367,0.7944620000000029,37056.52378590781,875047.5164325008
"244.3.160.239",51037,"198.123.241.156",80,192,177495,70,5263,122,172232,52.438813,4.855964999999998,8670.573202236841,283745.04346715857
"244.3.160.239",51038,"117.203.39.40",80,10,2582,6,1391,4,1191,53.183647,0.13307900000000217,83619.50420426828,71596.57045814775
"244.3.160.239",51039,"117.203.39.40",80,12,4913,7,1727,5,3186,53.356049,0.14353600000000455,96254.59814959008,177572.17701481993
"244.3.160.239",51040,"82.242.98.106",80,12,3453,7,1432,5,2021,53.433765,0.2985929999999968,38366.606049037066,54147.28409574295
"244.3.160.239",51041,"82.242.98.77",80,12,2408,7,1889,5,519,53.527803,5.0135350000000045,3014.2404510988727,828.1581758180598
"244.3.160.239",51042,"82.242.98.77",80,11,2223,6,1596,5,627,53.699728,0.8868769999999984,14396.584870280798,5655.801199038885
"244.3.160.239",51043,"82.242.98.77",80,10,2077,6,1609,4,468,53.736467,0.11354899999999901,113360.75174594327,32972.54929589897
"244.3.160.239",51044,"82.242.98.77",80,10,2064,6,1623,4,441,53.758446,0.19800500000000198,65574.10166409874,17817.731875457514
"244.3.160.239",51045,"82.242.98.77",80,10,2051,6,1596,4,455,53.759656,0.11372800000000183,112267.86719189465,32006.19020821558
"244.3.160.239",51046,"48.151.224.224",80,10,2159,6,1245,4,914,53.759689,0.3326050000000009,29945.430766224115,21984.035116729992
"244.3.160.239",51047,"244.3.31.75",80,11,1335,6,781,5,554,54.341575,0.006664000000000669,937575.0300119106,665066.0264104974
"244.3.160.239",51048,"244.3.31.108",80,11,2193,6,1235,5,958,54.645614,1.3044259999999994,7574.212718851054,5875.381202153287
"244.3.160.239",51049,"188.68.193.209",80,25,15863,11,1787,14,14076,55.617331,0.7509680000000003,19036.763217607135,149950.4639345484
"244.3.160.239",51050,"94.2.202.203",80,14,4029,8,2603,6,1426,55.698576,0.29209900000000033,71290.89794898297,39055.25181530915
"244.3.160.239",51051,"94.2.202.98",80,10,1862,6,1060,4,802,56.153899,0.1210839999999962,70034.02596544768,52988.008324800976
"244.3.160.239",51052,"43.106.84.231",80,11,2282,6,1436,5,846,56.168185,0.7532819999999987,15250.59672207755,8984.683027073543
"244.3.160.239",51053,"94.2.202.98",80,10,2139,6,1146,4,993,56.314116,0.1359860000000026,67418.70486667615,58417.778300706304
"244.3.160.239",51054,"94.2.202.203",80,10,2169,6,1191,4,978,56.554542,0.27120800000000145,35131.707029290985,28848.706527830884
"244.3.160.239",51055,"43.106.84.231",80,114,107325,41,3676,73,103649,56.893926,1.0904319999999998,26969.127831905156,760425.225965489
"244.3.160.239",51056,"94.2.202.203",80,41,31142,16,1913,25,29229,56.921872,0.3702469999999991,41334.56854478236,631556.7715606084
"244.3.160.239",51057,"94.2.202.197",80,130,119247,46,3782,84,115465,57.380695,0.4035699999999949,74970.8848526907,2288871.8190153176
"244.3.160.239",51058,"94.2.202.197",80,15,6564,8,1349,7,5215,57.384566,0.15804899999999833,68282.62121240953,263968.76917918137
"244.3.160.239",51059,"94.2.202.197",80,102,91979,37,3211,65,88768,57.390084,0.37362199999999746,68753.98129660505,1900701.7788031884
"244.3.160.239",51060,"94.2.202.197",80,12,3376,7,1292,5,2084,57.39012,0.11899899999999519,86857.87275523675,140102.01766401963
"244.3.160.239",51061,"94.2.202.197",80,144,133531,51,4107,93,129424,57.504599,0.4391460000000009,74817.94209670572,2357739.7949656784
"244.3.160.239",51062,"43.106.84.231",80,11,1639,6,1203,5,436,57.558534,0.1055729999999997,91159.67150691965,33038.75043808559
"244.3.160.239",51063,"94.2.202.197",80,18,9699,9,1410,9,8289,57.835327,0.16850399999999865,66942.03104970856,393533.68466030795
"244.3.160.239",51064,"94.2.202.197",80,37,28043,15,1804,22,26239,57.835571,0.2463199999999972,58590.4514452751,852192.2702176127
"244.3.160.239",51065,"94.2.202.197",80,11,2976,7,1283,4,1693,57.855526,0.12054600000000448,85145.91940005988,112355.44937201978
"244.3.160.239",51067,"43.106.84.231",80,11,1632,6,1196,5,436,57.981638,0.10528200000000254,90879.73252787531,33130.069717519764
"244.3.160.239",51068,"94.2.202.197",80,18,9944,9,1414,9,8530,57.981778,0.1625190000000032,69604.16935865824,419889.3667817219
"244.3.160.239",51069,"94.2.202.197",80,16,7611,8,1350,8,6261,57.985521,0.15922199999999975,67829.82251196454,314579.64351659996
"244.3.160.239",51070,"43.106.84.231",80,11,1635,6,1199,5,436,57.987702,0.10607699999999909,90424.88003997174,32881.774559989724
"244.3.160.239",51071,"94.2.202.197",80,12,3669,7,1289,5,2380,58.00987,0.12055000000000149,85541.2691829106,157942.76233927635
"244.3.160.239",51072,"43.106.84.231",80,11,1634,6,1198,5,436,58.059098,0.10389599999999888,92246.09224609325,33572.033572033935
"244.3.160.239",51073,"94.2.202.197",80,12,3361,7,1268,5,2093,58.089965,0.17778200000000055,57058.64485718447,94182.76315937468
"244.3.160.239",51074,"94.2.202.197",80,12,3414,7,1321,5,2093,58.134777,0.1324210000000008,79806.07305487753,126445.20128982488
"244.3.160.239",51075,"94.2.202.197",80,10,2302,6,1214,4,1088,58.138439,0.1287810000000036,75414.85156971704,67587.60997351905
"244.3.160.239",51076,"43.106.84.231",80,11,1636,6,1200,5,436,58.140347,0.1054680000000019,91022.86949595922,33071.64258353185
"244.3.160.239",51077,"94.2.202.197",80,12,3008,7,1312,5,1696,58.180443,0.11917800000000511,88069.94579536114,113846.51529644245
"244.3.160.239",51078,"43.106.84.231",80,11,1643,6,1207,5,436,58.287578,0.10447999999999524,92419.60183767648,33384.37978560642
"244.3.160.239",51079,"94.2.202.197",80,10,1764,6,1204,4,560,58.287751,0.13091500000000167,73574.45670855041,34220.677538860655
"244.3.160.239",51080,"94.2.202.197",80,10,1764,6,1222,4,542,58.2932,0.1256750000000011,77787.94509647833,34501.69086930545
"244.3.160.239",51081,"94.2.202.197",80,10,2538,6,1214,4,1324,58.293241,0.1260289999999955,77061.62867276854,84044.14856898315
"244.3.160.239",51082,"94.2.202.197",80,10,1952,6,1211,4,741,58.334524,0.1597889999999964,60629.95575415215,37098.92420629789
"244.3.160.239",51083,"43.106.84.231",80,11,1640,6,1204,5,436,58.366237,0.1040180000000035,92599.35780345398,33532.6578092242
"244.3.160.239",51084,"94.2.202.197",80,10,2312,6,1229,4,1083,58.432509,0.11807599999999496,83268.40340120278,73376.46939259773
"244.3.160.239",51085,"94.2.202.197",80,10,2294,6,1217,4,1077,58.437568,0.13236600000000465,73553.63159723538,65092.244231900164
"244.3.160.239",51086,"94.2.202.197",80,16,7463,8,1340,8,6123,58.438217,0.20676799999999673,51845.54669968355,236903.19585236002
"244.3.160.239",51087,"43.106.84.231",80,11,1641,6,1205,5,436,58.447782,0.10336200000000417,93264.44921731015,33745.47706120101
"244.3.160.239",51088,"94.2.202.197",80,10,1770,6,1211,4,559,58.510386,0.13536100000000317,71571.57526909356,33037.58098713732
"244.3.160.239",51089,"94.2.202.197",80,10,2547,6,1213,4,1334,58.556574,0.16518900000000514,58744.831677652255,64604.78603296629
"244.3.160.239",51090,"94.2.202.197",80,10,1988,6,1225,4,763,58.578501,0.11833499999999475,82815.73498965171,51582.372079268775
"244.3.160.239",51091,"94.2.202.197",80,10,1860,6,1211,4,649,58.609765,0.18759399999999715,51643.44275403343,27676.7913685943
"244.3.160.239",51092,"43.106.84.26",80,21,11360,9,1398,12,9962,58.69944,0.21697400000000044,51545.34644703963,367306.68190658715
"244.3.160.239",51093,"43.106.84.231",80,11,1646,6,1210,5,436,58.895444,0.103352000000001,93660.50003870178,33748.74216270576
"244.3.160.239",51094,"94.2.202.197",80,10,2668,6,1230,4,1438,58.920456,0.11867000000000161,82919.01912867503,96941.09716019081
"244.3.160.239",51095,"43.106.84.231",80,11,1641,6,1205,5,436,58.972436,0.10504099999999994,91773.68836930346,33206.081434868305
"244.3.160.239",51096,"43.106.84.231",80,11,1641,6,1205,5,436,59.053678,0.10346200000000039,93174.30554213106,33712.860760472315
"244.3.160.239",51097,"43.106.84.231",80,14,4313,7,1213,7,3100,59.133258,0.11315600000000359,85757.71501289982,219166.4604616566
"244.3.160.239",51098,"43.106.84.231",80,11,1627,6,1191,5,436,59.135146,0.108823000000001,87555.02053793694,32052.04782077289
"244.3.160.239",51099,"43.106.84.231",80,11,1626,6,1190,5,436,59.218068,0.1044729999999987,91124.02247470751,33386.616637791994
"244.3.160.239",51100,"43.106.84.231",80,11,1630,6,1194,5,436,59.219917,0.10403600000000068,91814.37194817119,33526.856088276916
"244.3.160.239",51101,"43.106.84.231",80,11,1637,6,1201,5,436,59.298191,0.10416999999999632,92233.84851685072,33483.72852068852
"244.3.160.239",51102,"43.106.84.231",80,11,1640,6,1204,5,436,59.383101,0.10656599999999372,90385.30112794481,32730.889777229186
"244.3.160.239",51103,"43.106.84.231",80,11,1630,6,1194,5,436,59.470243,0.10389699999999635,91937.2070415925,33571.7104439986
"244.3.160.239",51104,"43.106.84.231",80,11,1629,6,1193,5,436,59.57087,0.10413799999999895,91647.6214254172,33494.01755363109
"244.3.160.239",51105,"43.106.84.231",80,11,1647,6,1211,5,436,59.573149,0.10501999999999612,92249.09541040142,33212.72138640382
"244.3.160.239",51106,"43.106.84.231",80,16,5538,8,1331,8,4207,59.649065,0.28648299999999693,37167.99949735277,117479.92027450271
"244.3.160.239",51107,"43.106.84.231",80,14,4890,7,1267,7,3623,59.655165,0.5075479999999999,19970.52495527517,57105.92889736538
"244.3.160.239",51108,"43.106.84.231",80,28,18310,12,1618,16,16692,59.907812,0.3368159999999989,38430.47836207318,396465.72609377356
"244.3.160.239",51109,"43.106.84.231",80,11,1652,6,1216,5,436,60.134504,0.10421000000000191,93349.96641397008,33470.87611553532
"244.3.160.239",51110,"43.106.84.231",80,11,1654,6,1218,5,436,60.210741,0.10597700000000287,91944.47851892143,32912.801834359394
"244.3.160.239",51111,"43.106.84.231",80,11,1660,6,1224,5,436,60.289618,0.10452100000000542,93684.52272748531,33371.284239529086
"244.3.160.239",51112,"188.68.193.209",80,11,2353,6,1445,5,908,60.358649,1.0303960000000032,11218.987651349544,7049.7168079068415
"244.3.160.239",51113,"43.106.84.231",80,14,4160,7,1267,7,2893,60.366159,0.25250299999999726,40142.09732161642,91658.31693088895
"244.3.160.239",51114,"198.123.241.156",80,37,28501,15,2082,22,26419,60.386716,0.8692660000000032,19160.9932977937,243138.46394544272
"244.3.160.239",51115,"43.106.84.108",80,13,5334,7,1135,6,4199,60.38927,0.14235299999999995,63785.09760946382,235976.76199307363
"244.3.160.239",51116,"43.106.84.231",80,13,3155,7,1267,6,1888,60.405643,0.2890440000000041,35067.32538990554,52255.01999695475
"244.3.160.239",51117,"43.106.84.231",80,11,1654,6,1218,5,436,60.590801,0.10562399999999883,92251.76096341843,33022.797848974085
"244.3.160.239",51118,"43.106.84.231",80,14,3515,7,1267,7,2248,60.67092,0.2500569999999982,40534.75807515916,71919.60233066912
"244.3.160.239",51119,"43.106.84.231",80,16,6360,8,1331,8,5029,60.672375,0.5517690000000002,19297.93083699881,72914.57113393465
"244.3.160.239",51120,"43.106.84.231",80,11,1654,6,1218,5,436,60.895704,0.10480099999999481,92976.21205904984,33282.125170563
"244.3.160.239",51121,"43.106.84.231",80,11,1652,6,1216,5,436,60.974048,0.10387099999999805,93654.62929980633,33580.113794996345
"244.3.160.239",51122,"43.106.84.231",80,13,3251,7,1267,6,1984,61.051321,0.4084099999999964,24818.197399672117,38862.907372493675
"244.3.160.239",51123,"43.106.84.231",80,11,1640,6,1204,5,436,61.198321,0.10399900000000173,92616.27515649034,33538.78402676893
"244.3.160.239",51124,"198.123.241.156",80,11,1985,6,1541,5,444,61.231659,0.22093000000000274,55800.47978997804,16077.49060788465
"244.3.160.239",51125,"43.106.84.231",80,11,1629,6,1193,5,436,61.274467,0.10488199999999637,90997.50195458067,33256.42150226083
"244.3.160.239",51126,"43.106.84.231",80,11,1638,6,1202,5,436,61.352234,0.10426999999999964,92222.11566126434,33451.61599693116
"244.3.160.239",51127,"43.106.84.231",80,11,1645,6,1209,5,436,61.431336,0.1033040000000014,93626.57786726428,33764.42344923675
"244.3.160.239",51128,"43.106.84.231",80,11,1638,6,1202,5,436,61.454203,0.10476299999999839,91788.13130590139,33294.1973788461
"244.3.160.239",51129,"43.106.84.231",80,11,1632,6,1196,5,436,61.506783,0.10438299999999856,91662.4354540503,33415.40289127586
"244.3.160.239",51130,"43.106.84.231",80,11,1637,6,1201,5,436,61.531073,0.10348300000000421,92846.16796961443,33706.01934617143
"244.3.160.239",51131,"188.68.193.209",80,14,5639,7,1441,7,4198,61.555632,0.7168509999999984,16081.445098074812,46849.345261428214
"244.3.160.239",51132,"43.106.84.231",80,11,1640,6,1204,5,436,61.582525,0.10480700000000098,91902.2584369356,33280.219832644456
"244.3.160.239",51133,"43.106.84.231",80,11,1637,6,1201,5,436,61.607031,0.10398200000000202,92400.60779750162,33544.26727702806
"244.3.160.239",51134,"43.106.84.231",80,11,1640,6,1204,5,436,61.660397,0.10349999999999682,93062.80193237001,33700.483091788476
"244.3.160.239",51135,"43.106.84.231",80,11,1653,6,1217,5,436,61.683035,0.10308000000000561,94450.91191307208,33837.79588668811
"244.3.160.239",51136,"43.106.84.231",80,11,1641,6,1205,5,436,61.738018,0.10414700000000465,92561.4756065904,33491.12312404432
"244.3.160.239",51137,"43.106.84.231",80,14,4314,7,1214,7,3100,61.758355,0.14715699999999998,65997.54004226779,168527.49104697705
"244.3.160.239",51138,"43.106.84.231",80,11,1646,6,1210,5,436,61.814494,0.10411799999999971,92971.4362550186,33500.451410899266
"244.3.160.239",51139,"43.106.84.231",80,11,1643,6,1207,5,436,61.878569,0.10407200000000216,92781.92020908408,33515.25866707594
"244.3.160.239",51140,"43.106.84.231",80,11,1650,6,1214,5,436,61.892194,0.10413499999999942,93263.55211984496,33494.982474672484
"244.3.160.239",51141,"43.106.84.231",80,11,1639,6,1203,5,436,61.956556,0.10540999999999912,91300.63561332019,33089.83967365553
"244.3.160.239",51142,"43.106.84.231",80,11,1635,6,1199,5,436,61.969758,0.10395499999999913,92270.694050311,33552.97965465855
"244.3.160.239",51143,"43.106.84.231",80,11,1638,6,1202,5,436,62.034243,0.103190000000005,93187.32435313048,33801.72497334849
"244.3.160.239",51144,"43.106.84.231",80,11,1640,6,1204,5,436,62.046854,0.10365899999999328,92920.0551809358,33648.790746584724
"244.3.160.239",51145,"43.106.84.231",80,11,1639,6,1203,5,436,62.110506,0.10347600000000057,93007.07410413958,33708.29950906472
"244.3.160.239",51146,"43.106.84.231",80,11,1641,6,1205,5,436,62.122888,0.10545499999999919,91413.39908017709,33075.7195012093
"244.3.160.239",51147,"43.106.84.108",80,10,1455,6,1055,4,400,62.218151,0.10217300000000051,82604.99349143078,31319.428811916885
"244.3.160.239",51148,"43.106.84.108",80,10,1440,6,1050,4,390,62.364138,0.10167600000000476,82615.36645815735,30685.7075416013
"244.3.160.239",51149,"43.106.84.108",80,10,1443,6,1053,4,390,62.370238,0.10202799999999712,82565.57023562392,30579.840828008862
"244.3.160.239",51150,"188.68.193.209",80,14,4379,7,1366,7,3013,62.391644,0.6821899999999985,16018.997639953714,35333.26492619366
"244.3.160.239",51151,"188.68.193.209",80,11,2153,6,1232,5,921,62.392554,0.6797160000000062,14500.173601915962,10839.821337146592
"244.3.160.239",51152,"188.68.193.209",80,14,4349,7,1392,7,2957,62.393117,0.6653400000000005,16737.307241410395,35554.75396038113
"244.3.160.239",51153,"188.68.193.209",80,19,10362,9,1518,10,8844,62.394193,0.7524579999999972,16139.106767420966,94027.83942758302
"244.3.160.239",51154,"188.68.193.209",80,19,10369,9,1520,10,8849,62.394348,0.7614389999999958,15969.762515447814,92971.33453894586
"244.3.160.239",51155,"43.106.84.108",80,36,28737,15,1628,21,27109,63.227125,0.21433299999999633,60765.25779977989,1011846.0526377353
"244.3.160.239",51156,"41.177.254.197",80,46,43029,13,2138,33,40891,63.329991,0.1381239999999977,123830.76076569087,2368364.6578437164
"244.3.160.239",51157,"43.106.84.108",80,10,2436,6,1282,4,1154,63.458453,0.13509400000000227,75917.50928982654,68337.60196603731
"244.3.160.239",51158,"43.106.84.108",80,10,1448,6,1058,4,390,63.588191,0.10143000000000058,83446.71201814011,30760.13013901195
"244.3.160.239",51159,"43.106.84.108",80,10,1438,6,1048,4,390,63.594374,0.10179199999999611,82364.03646652312,30650.73876139696
"244.3.160.239",51160,"43.106.84.108",80,10,1451,6,1051,4,400,63.662873,0.10231000000000279,82181.60492620243,31277.489981428138
"244.3.160.239",51161,"43.106.84.108",80,10,1447,6,1047,4,400,63.668411,0.10179200000000321,82285.44482866763,31436.655139892122
"244.3.160.239",51162,"43.106.84.108",80,10,1443,6,1053,4,390,63.737962,0.1043899999999951,80697.38480697764,29887.920298880606
"244.3.160.239",51163,"43.106.84.108",80,10,1451,6,1061,4,390,63.742835,0.10352199999999812,81992.23353490229,30138.52128050131
"244.3.160.239",51164,"43.106.84.108",80,10,1441,6,1051,4,390,63.814114000000004,0.10308999999999457,81559.80211466139,30264.817150064646
"244.3.160.239",51165,"43.106.84.108",80,10,1453,6,1053,4,400,63.818088,0.1033909999999949,81477.1111605499,30950.469576657135
"244.3.160.239",51166,"43.106.84.108",80,10,1570,6,1007,4,563,63.951933,0.10501600000000622,76712.1200578914,42888.70267387573
"244.3.160.239",51167,"43.106.84.108",80,10,2436,6,1282,4,1154,64.707038,0.13596200000000636,75432.8415292473,67901.32537032089
"244.3.160.239",51168,"82.242.98.77",80,97,91672,35,3680,62,87992,65.05008,0.7681820000000101,38324.25128420037,916366.1736411302
"244.3.160.239",51169,"43.106.84.108",80,12,2575,7,1671,5,904,65.207227,0.12105599999999583,110428.23156225598,59740.94633888654
"244.3.160.239",51170,"43.106.84.231",80,14,4569,7,1469,7,3100,65.422059,0.10601299999999014,110854.32918605352,233933.5741843199
"244.3.160.239",51171,"43.106.84.231",80,11,1572,6,1136,5,436,65.558286,0.1033040000000085,87973.36017965667,33764.423449234426
"244.3.160.239",51172,"43.106.84.231",80,11,1581,6,1145,5,436,65.564433,0.10322200000000237,88740.77231597711,33791.2460521974
"244.3.160.239",51173,"43.106.84.108",80,22,11379,12,10190,10,1189,65.770496,0.1826640000000026,446283.88735601347,52073.75290150147
"244.3.160.239",51174,"117.203.39.40",80,10,2582,6,1391,4,1191,65.774343,0.13252299999999195,83970.32967862692,71896.95373633693
"244.3.160.239",51175,"117.203.39.40",80,12,4714,7,1727,5,2987,65.949789,0.25026100000000895,55206.364555402186,95484.31437578826
"244.3.160.239",51176,"43.106.84.231",80,14,4569,7,1469,7,3100,65.95943,0.10623300000000313,110624.75878493174,233449.1165645258
"244.3.160.239",51177,"82.242.98.77",80,11,2344,6,1825,5,519,66.027908,0.22975100000000737,63547.057466559585,18071.738534325712
"244.3.160.239",51178,"43.106.84.231",80,11,1572,6,1136,5,436,66.042217,0.10379600000000266,87556.36055339094,33604.377818026805
"244.3.160.239",51179,"43.106.84.231",80,11,1581,6,1145,5,436,66.043147,0.10353899999999783,88469.07928413634,33687.78914225628
"244.3.160.239",51180,"82.242.98.77",80,21,13519,10,1879,11,11640,66.293416,0.12985300000001132,115761.66896412628,717118.587941687
"244.3.160.239",51181,"82.242.98.77",80,10,2159,6,1596,4,563,66.333115,0.2586519999999979,49363.62371062317,17413.358489399026
"244.3.160.239",51182,"48.151.224.224",80,10,2159,6,1245,4,914,66.369565,0.21693900000001065,45911.523515824774,33705.327303987026
"244.3.160.239",51183,"82.242.98.77",80,10,2077,6,1609,4,468,66.370057,0.11704199999999787,109977.61487329534,31988.516942636557
"244.3.160.239",51184,"82.242.98.77",80,10,2064,6,1623,4,441,66.370791,0.15248200000000622,85151.0342204291,23137.157172648942
"244.3.160.239",51185,"82.242.98.77",80,10,2051,6,1596,4,455,66.371256,0.11629899999999793,109785.98268257016,31298.635413890617
"244.3.160.239",51186,"43.106.84.231",80,79,71494,29,2956,50,68538,66.900713,0.5403919999999971,43760.82547484072,1014641.223408198
"244.3.160.239",51187,"43.106.84.231",80,11,1653,6,1217,5,436,67.240004,0.10649600000000703,91421.2740384555,32752.403846151683
"244.3.160.239",51188,"176.41.89.121",80,10,2205,6,1394,4,811,67.387778,0.7898710000000051,14118.761164797705,8213.999501184318
"244.3.160.239",51189,"43.106.84.231",80,11,1646,6,1210,5,436,67.484294,0.10389699999998925,93169.19641569056,33571.71044400089
"244.3.160.239",51190,"43.106.84.231",80,11,1649,6,1213,5,436,67.489311,0.11420099999999422,84972.98622604435,30542.639731702668
"244.3.160.239",51191,"43.106.84.231",80,11,1648,6,1212,5,436,67.560306,0.10393600000000447,93288.17733989746,33559.11330049117
"244.3.160.239",51192,"43.106.84.231",80,11,1650,6,1214,5,436,67.641433,0.10525799999999208,92268.52115754366,33137.62374356593
"244.3.160.239",51193,"43.106.84.231",80,11,1657,6,1221,5,436,67.787998,0.10388799999999776,94024.33389804607,33574.618820268704
"244.3.160.239",51194,"43.106.84.231",80,11,1654,6,1218,5,436,67.866631,0.10317299999999818,94443.31365764466,33807.29454411582
"244.3.160.239",51195,"176.41.89.121",80,13,5942,7,1465,6,4477,67.902336,1.0144710000000003,11552.819154022141,35305.0998993564
"244.3.160.239",51196,"198.123.241.156",80,35,27884,14,2018,21,25866,67.927355,0.5696089999999998,28342.24880575975,363280.7768135687
"244.3.160.239",51197,"43.106.84.231",80,11,1655,6,1219,5,436,67.948064,0.10369699999999682,94043.2220797159,33636.46007116992
"244.3.160.239",51198,"43.106.84.26",80,22,11438,10,1476,12,9962,68.032253,0.21706500000000517,54398.452076565634,367152.6961969829
"244.3.160.239",51199,"43.106.84.231",80,11,1660,6,1224,5,436,68.228306,0.10399799999999004,94155.65683956363,33539.10652128247
"244.3.160.239",51200,"43.106.84.231",80,11,1655,6,1219,5,436,68.30619,0.10566599999999937,92290.80309655005,33009.67198531241
"244.3.160.239",51201,"198.123.241.156",80,64,56154,24,2424,40,53730,68.377126,0.6765019999999993,28665.103724748813,635386.1481562515
"244.3.160.239",51202,"43.106.84.231",80,11,1655,6,1219,5,436,68.388173,0.11334700000000453,86036.68381165457,30772.759755440027
"244.3.160.239",51203,"43.106.84.231",80,14,4327,7,1227,7,3100,68.476811,0.1057739999999967,92801.6336717937,234462.15516101095
"244.3.160.239",51204,"43.106.84.231",80,11,1641,6,1205,5,436,68.479103,0.10347699999999804,93160.79901814106,33707.97375262199
"244.3.160.239",51205,"43.106.84.231",80,11,1640,6,1204,5,436,68.555565,0.10368599999999617,92895.85865015871,33640.02854773189
"244.3.160.239",51206,"43.106.84.231",80,11,1644,6,1208,5,436,68.556873,0.10490000000000066,92125.83412774012,33250.71496663468
"244.3.160.239",51207,"94.2.202.203",80,13,5666,8,4459,5,1207,68.568321,0.7964850000000041,44786.781923074275,12123.266602635267
"244.3.160.239",51208,"43.106.84.231",80,11,1651,6,1215,5,436,68.633073,0.1079950000000025,90004.16685957475,32297.79156442353
"244.3.160.239",51209,"176.41.89.121",80,2099,1858321,761,50137,1338,1808184,68.705187,143.890342,2787.5116177012073,100531.22258893512
"244.3.160.239",51210,"43.106.84.231",80,11,1654,6,1218,5,436,68.724779,0.10443100000000527,93305.6276392978,33400.04404822154
"244.3.160.239",51211,"43.106.84.231",80,11,1644,6,1208,5,436,68.811297,0.10459099999999921,92398.00747674344,33348.94971842727
"244.3.160.239",51212,"43.106.84.231",80,11,1643,6,1207,5,436,68.915034,0.10350199999999177,93292.883229317,33699.83188730921
"244.3.160.239",51213,"43.106.84.231",80,11,1661,6,1225,5,436,68.91599,0.10518900000000997,93165.63518998252,33159.360769659084
"244.3.160.239",51214,"198.123.241.156",80,11,1985,6,1541,5,444,68.941492,0.3279100000000028,37595.681741941065,10832.240553810403
"244.3.160.239",51215,"43.106.84.231",80,11,1668,6,1232,5,436,68.991177,0.10406100000000151,94713.67755450992,33518.80147221292
"244.3.160.239",51216,"43.106.84.231",80,11,1666,6,1230,5,436,68.995977,0.10339299999999696,95170.85295910061,33735.359260299076
"244.3.160.239",51217,"43.106.84.231",80,11,1666,6,1230,5,436,69.067092,0.10408999999999935,94533.57671246096,33509.46296474226
"244.3.160.239",51218,"43.106.84.231",80,11,1668,6,1232,5,436,69.07137,0.10367399999999805,95067.22997087202,33643.92229488653
"244.3.160.239",51219,"43.106.84.231",80,11,1674,6,1238,5,436,69.144329,0.10425499999999488,94997.84183013272,33456.428948253524
"244.3.160.239",51220,"43.106.84.231",80,161,154663,57,4484,104,150179,69.147862,1.0131799999999913,35405.35738960531,1185803.1149450347
"244.3.160.239",51221,"43.106.84.231",80,11,1668,6,1232,5,436,69.222112,0.10468699999999842,94147.3153304627,33318.36808772868
"244.3.160.239",51222,"43.106.84.231",80,11,1643,6,1207,5,436,69.299248,0.10372900000000129,93088.7215725581,33626.08335181055
"244.3.160.239",51223,"94.2.202.203",80,201,187423,70,5856,131,181567,69.333543,2.318509999999989,20206.08062936982,626495.4647596977
"244.3.160.239",51224,"43.106.84.231",80,11,1654,6,1218,5,436,69.376316,0.10432199999999625,93403.11727152806,33434.94181476702
"244.3.160.239",51225,"43.106.84.108",80,13,5348,7,1149,6,4199,69.391567,0.14023800000001074,65545.71514139745,239535.64654371445
"244.3.160.239",51226,"43.106.84.231",80,11,1652,6,1216,5,436,69.454865,0.10335999999999501,94117.64705882808,33746.13003096138
"244.3.160.239",51227,"43.106.84.231",80,11,1659,6,1223,5,436,69.530546,0.1043070000000057,93800.03259608142,33439.74996884015
"244.3.160.239",51228,"43.106.84.231",80,11,1652,6,1216,5,436,69.607603,0.10413499999999942,93417.19882844437,33494.982474672484
"244.3.160.239",51229,"43.106.84.231",80,11,1646,6,1210,5,436,69.68587,0.10551500000001113,91740.5108278347,33056.911339616476
"244.3.160.239",51230,"43.106.84.231",80,11,1651,6,1215,5,436,69.764232,0.10362199999998722,93802.47437803939,33660.80562043224
"244.3.160.239",51231,"43.106.84.231",80,11,1651,6,1215,5,436,69.841865,0.10487600000000441,92680.88027765734,33258.32411609761
"244.3.160.239",51232,"43.106.84.231",80,11,1654,6,1218,5,436,69.921188,0.10283699999999385,94751.88891158419,33917.75333780846
"244.3.160.239",51233,"43.106.84.231",80,11,1654,6,1218,5,436,69.998269,0.10415000000000418,93557.36917906489,33490.15842534671
"244.3.160.239",51234,"43.106.84.231",80,11,1667,6,1231,5,436,70.028832,0.10278000000000986,95816.30667444109,33936.56353375818
"244.3.160.239",51235,"43.106.84.231",80,11,1655,6,1219,5,436,70.075238,0.10456299999999885,93264.3478094556,33357.879938410704
"244.3.160.239",51236,"43.106.84.231",80,14,4328,7,1228,7,3100,70.10477,0.12210699999999974,80454.02802460155,203100.55934549248
"244.3.160.239",51237,"43.106.84.231",80,11,1660,6,1224,5,436,70.152148,0.1052310000000034,93052.42751660332,33146.12614153517
"244.3.160.239",51238,"43.106.84.231",80,11,1657,6,1221,5,436,70.195294,0.10462499999999864,93362.00716846,33338.11230585467
"244.3.160.239",51239,"43.106.84.231",80,11,1664,6,1228,5,436,70.229343,0.10283300000000395,95533.53495472876,33919.072671222915
"244.3.160.239",51240,"43.106.84.231",80,11,1653,6,1217,5,436,70.271698,0.10415000000000418,93480.5568890985,33490.15842534671
"244.3.160.239",51241,"43.106.84.231",80,11,1649,6,1213,5,436,70.304262,0.10418400000000361,93142.90102126684,33479.229056283875
"244.3.160.239",51242,"43.106.84.231",80,11,1652,6,1216,5,436,70.347014,0.10578099999999324,91963.58514289543,32973.78546241974
"244.3.160.239",51243,"43.106.84.231",80,11,1654,6,1218,5,436,70.380874,0.10414799999999502,93559.16580251628,33490.801551639655
"244.3.160.239",51244,"43.106.84.231",80,11,1653,6,1217,5,436,70.425075,0.10531699999999944,92444.71452851915,33119.059601014254
"244.3.160.239",51245,"43.106.84.108",80,10,1459,6,1069,4,390,70.520749,0.10285000000000366,83150.21876518907,30335.43996110733
"244.3.160.239",51246,"43.106.84.231",80,11,1655,6,1219,5,436,70.560788,0.10531199999999785,92601.03312063392,33120.63202674027
"244.3.160.239",51247,"43.106.84.108",80,10,1464,6,1064,4,400,70.630613,0.10300800000000265,82634.35849642534,31065.548306926816
"244.3.160.239",51248,"43.106.84.108",80,10,1467,6,1067,4,400,70.636883,0.1023270000000025,83418.84351148564,31272.293725018048
"244.3.160.239",51249,"43.106.84.108",80,36,28751,15,1642,21,27109,71.265828,0.21096699999999657,62265.66240217765,1027990.1595984373
"244.3.160.239",51250,"94.2.202.197",80,10,1974,6,1631,4,343,71.327796,0.12032699999998897,108437.84021874721,22804.52433784813
"244.3.160.239",51251,"94.2.202.197",80,10,1973,6,1630,4,343,71.334617,0.11739500000000191,111077.98458196505,23374.078964180375
"244.3.160.239",51252,"94.2.202.197",80,10,1980,6,1637,4,343,71.338514,0.11823699999999349,110760.59101635462,23207.625362620423
"244.3.160.239",51253,"94.2.202.197",80,10,2097,6,1636,4,461,71.344043,0.11924299999999732,109759.06342510918,30928.440243872454
"244.3.160.239",51254,"94.2.202.203",80,10,2219,6,1653,4,566,71.344599,0.12056099999999503,109687.21228258347,37557.750848119926
"244.3.160.239",51255,"43.106.84.108",80,10,2450,6,1296,4,1154,71.465221,0.13929699999999912,74430.89226616557,66275.65561354558
"244.3.160.239",51256,"94.2.202.197",80,10,2098,6,1636,4,462,71.55744,0.1176630000000074,111232.92793825737,31411.74370872549
"244.3.160.239",51258,"244.3.31.75",80,13,4057,7,1282,6,2775,71.571344,0.2752440000000007,37261.48435569885,80655.70911627481
"244.3.160.239",51259,"94.2.202.197",80,10,1971,6,1628,4,343,71.589973,0.11760400000000004,110744.53249889455,23332.53970953368
"244.3.160.239",51260,"94.2.202.197",80,10,1957,6,1613,4,344,71.595826,0.11667299999999159,110599.71030144875,23587.290975634452
"244.3.160.239",51261,"94.2.202.197",80,10,1962,6,1619,4,343,71.59583,0.1179209999999955,109836.2463004935,23269.816232902576
"244.3.160.239",51262,"43.106.84.108",80,10,1462,6,1072,4,390,71.670029,0.10282600000000741,83403.0303619647,30342.52037422223
"244.3.160.239",51263,"94.2.202.197",80,10,1984,6,1640,4,344,71.670935,0.11787599999999543,111303.40357664418,23346.567579491217
"244.3.160.239",51264,"43.106.84.108",80,10,1452,6,1062,4,390,71.674605,0.1024320000000074,82942.83036550478,30459.231490157123
"244.3.160.239",51265,"94.2.202.197",80,10,1955,6,1611,4,344,71.675933,0.11730000000000018,109872.12276214817,23461.210571184958
"244.3.160.239",51266,"94.2.202.197",80,10,1966,6,1623,4,343,71.683371,0.11693400000000054,111036.99522807686,23466.22881283448
"244.3.160.239",51267,"43.106.84.108",80,10,1455,6,1065,4,390,71.745366,0.1035710000000023,82262.40936169209,30124.262583154847
"244.3.160.239",51268,"43.106.84.108",80,10,1451,6,1061,4,390,71.752536,0.10292199999999241,82470.22016673429,30314.218534426363
"244.3.160.239",51269,"94.2.202.197",80,10,1978,6,1634,4,344,71.763836,0.11837099999999623,110432.4538949609,23248.937662097032
"244.3.160.239",51270,"43.106.84.108",80,10,1457,6,1067,4,390,71.822574,0.10240000000000293,83359.37499999761,30468.749999999127
"244.3.160.239",51271,"43.106.84.108",80,10,1465,6,1075,4,390,71.82781,0.1029620000000051,83525.9610341638,30302.44167751059
"244.3.160.239",51272,"94.2.202.197",80,10,1971,6,1627,4,344,71.85201,0.11694699999999614,111298.28041762876,23532.027328619723
"244.3.160.239",51273,"43.106.84.108",80,10,1455,6,1065,4,390,71.898086,0.10266299999999262,82989.97691476591,30390.695771604416
"244.3.160.239",51274,"43.106.84.108",80,10,1457,6,1067,4,390,71.902958,0.10491500000000542,81361.10184434599,29738.35962445636
"244.3.160.239",51275,"244.3.31.75",80,50,40834,19,2033,31,38801,71.908899,0.09811499999999285,165764.66391480595,3163716.047495517
"244.3.160.239",51276,"94.2.202.197",80,10,1981,6,1637,4,344,71.940921,0.11956099999999026,109534.0453827006,23017.539164110574
"244.3.160.239",51277,"43.106.84.108",80,10,1584,6,1021,4,563,71.973424,0.1615280000000041,50567.08434450864,27883.710564112014
"244.3.160.239",51278,"94.2.202.197",80,10,1974,6,1630,4,344,72.035202,0.11735400000000595,111116.79192868873,23450.41498372327
"244.3.160.239",51279,"94.2.202.197",80,10,1981,6,1637,4,344,72.121951,0.11840100000000575,110607.17392589053,23243.046933724094
"244.3.160.239",51280,"244.3.31.75",80,13,3540,7,1577,6,1963,72.135913,0.2691959999999938,46865.4809135362,58336.67662223942
"244.3.160.239",51281,"244.3.31.75",80,11,2647,6,1076,5,1571,72.143447,0.038437999999999306,223945.0543732805,326968.10447994765
"244.3.160.239",51282,"94.2.202.197",80,10,1993,6,1649,4,344,72.209326,0.11713999999999203,112617.38091173721,23493.25593307314
"244.3.160.239",51283,"43.106.84.108",80,10,2450,6,1296,4,1154,72.263733,0.2074659999999966,49974.453645417416,44498.85764414483
"244.3.160.239",51284,"94.2.202.197",80,10,1994,6,1650,4,344,72.296358,0.11690099999999859,112916.05717658668,23541.287071967163
"244.3.160.239",51285,"94.2.202.197",80,10,1977,6,1633,4,344,72.382609,0.1196159999999935,109216.15837346767,23006.955591226502
"244.3.160.239",51286,"43.106.84.108",80,12,2750,7,1685,5,1065,72.62004,0.1275309999999905,105699.79063914658,66807.28607162678
"244.3.160.239",51287,"94.2.202.197",80,10,1999,6,1655,4,344,72.701711,0.11749999999999261,112680.85106383688,23421.276595746152
"244.3.160.239",51288,"94.2.202.197",80,10,1957,6,1613,4,344,72.710362,0.11762999999999124,109699.9064864487,23395.392331889867
"244.3.160.239",51289,"94.2.202.197",80,10,1974,6,1631,4,343,72.713251,0.11728700000000458,111248.47596067331,23395.60224065662
"244.3.160.239",51290,"94.2.202.197",80,10,1966,6,1623,4,343,72.714079,0.11706100000000674,110916.53069766406,23440.770196733687
"244.3.160.239",51291,"94.2.202.197",80,10,1963,6,1620,4,343,72.788426,0.11768399999999701,110125.42061792877,23316.678562931833
"244.3.160.239",51292,"94.2.202.197",80,10,1969,6,1626,4,343,72.799461,0.11702900000000227,111151.9366994484,23447.179758862734
"244.3.160.239",51293,"94.2.202.197",80,10,1964,6,1621,4,343,72.803373,0.11711800000000494,110725.93452756581,23429.36184019437
"244.3.160.239",51294,"43.106.84.231",80,14,4583,7,1483,7,3100,72.804951,0.10631499999999505,111592.90786813293,233269.05892866626
"244.3.160.239",51295,"94.2.202.197",80,10,1962,6,1619,4,343,72.807397,0.11686800000001085,110825.88903719408,23479.48112400097
"244.3.160.239",51296,"94.2.202.197",80,10,1964,6,1621,4,343,72.875057,0.11651000000000522,111303.7507510035,23551.626469829862
"244.3.160.239",51297,"43.106.84.231",80,11,1572,6,1136,5,436,72.886856,0.1042630000000031,87164.19055657068,33453.861868542976
"244.3.160.239",51298,"43.106.84.231",80,11,1581,6,1145,5,436,72.888527,0.10408700000000692,88003.30492760277,33510.428775925604
"244.3.160.239",51299,"94.2.202.197",80,10,1961,6,1618,4,343,72.888655,0.1176980000000043,109976.38022735754,23313.9050790999
"244.3.160.239",51300,"94.2.202.197",80,10,1963,6,1620,4,343,72.904724,0.11736299999999744,110426.62508627321,23380.45210159982
"244.3.160.239",51301,"94.2.202.197",80,10,1966,6,1622,4,344,72.911592,0.11748900000000617,110444.38202724782,23423.46943117956
"244.3.160.239",51302,"94.2.202.197",80,10,1956,6,1612,4,344,72.961355,0.11781299999999817,109461.60440698564,23359.05205707386
"244.3.160.239",51303,"94.2.202.197",80,10,1964,6,1621,4,343,72.975313,0.11856699999999876,109372.75970548412,23143.03305304198
"244.3.160.239",51304,"94.2.202.197",80,10,1964,6,1621,4,343,72.991324,0.11686599999998748,110964.69460751108,23479.882942860146
"244.3.160.239",51305,"94.2.202.197",80,10,1964,6,1621,4,343,72.998217,0.11815599999999904,109753.20762382024,23223.534987643645
"244.3.160.239",51306,"94.2.202.197",80,10,1968,6,1625,4,343,73.047845,0.126142999999999,103057.64093132479,21753.0897473504
"244.3.160.239",51307,"94.2.202.197",80,10,1965,6,1621,4,344,73.064679,0.1178639999999973,110025.1136903575,23348.944546257237
"244.3.160.239",51308,"43.106.84.108",80,14,3517,8,2584,6,933,73.066586,0.10794500000000085,191504.9330677645,69146.32451711466
"244.3.160.239",51309,"94.2.202.197",80,10,1963,6,1620,4,343,73.077401,0.11885300000000143,109042.26229039102,23087.343188644518
"244.3.160.239",51310,"94.2.202.197",80,10,1963,6,1620,4,343,73.090147,0.12376600000000337,104713.73398186616,22170.870836901293
"244.3.160.239",51311,"94.2.202.197",80,10,1969,6,1625,4,344,73.136979,0.11710300000000018,111013.38138220183,23500.67888952457
"244.3.160.239",51312,"94.2.202.197",80,10,1968,6,1625,4,343,73.152435,0.12096300000000326,107470.87952514115,22684.622570537485
"244.3.160.239",51313,"94.2.202.197",80,10,1965,6,1621,4,344,73.165221,0.11839899999999659,109527.95209419314,23243.439556078
"244.3.160.239",51314,"43.106.84.231",80,14,4583,7,1483,7,3100,73.175583,0.10526399999999114,112707.09834322274,235598.1152150981
"244.3.160.239",51315,"94.2.202.197",80,10,1965,6,1622,4,343,73.184677,0.1180090000000007,109957.71508952642,23252.463795134132
"244.3.160.239",51316,"198.123.241.156",80,37,28666,15,2082,22,26584,73.190547,0.6750470000000064,24673.837525386887,315047.6929754491
"244.3.160.239",51317,"94.2.202.197",80,10,1962,6,1619,4,343,73.224156,0.11783499999999947,109916.40853736206,23286.799338057557
"244.3.160.239",51318,"94.2.202.197",80,10,1967,6,1624,4,343,73.245748,0.11918299999999249,109008.83515267126,23023.41776931419
"244.3.160.239",51319,"94.2.202.197",80,10,1968,6,1625,4,343,73.252714,0.11794400000000849,110221.80017634695,23265.278437222772
"244.3.160.239",51320,"43.106.84.231",80,11,1572,6,1136,5,436,73.256172,0.1037589999999966,87587.58276390769,33616.36099037302
"244.3.160.239",51321,"43.106.84.231",80,11,1581,6,1145,5,436,73.259673,0.10347199999999646,88526.36462038342,33709.602597805395
"244.3.160.239",51322,"81.67.210.81",80,11,2653,6,1264,5,1389,73.25997,0.8984570000000076,11254.851372964888,12367.87069386727
"244.3.160.239",51323,"94.2.202.197",80,10,1962,6,1618,4,344,73.272033,0.11992600000000664,107933.22548904561,22947.484281972615
"244.3.160.239",51324,"94.2.202.197",80,10,1967,6,1624,4,343,73.311431,0.11679700000000537,111235.73379452727,23493.75412039585
"244.3.160.239",51325,"94.2.202.197",80,10,1970,6,1626,4,344,73.334156,0.11757400000000473,110636.70539404526,23406.5354585188
"244.3.160.239",51326,"94.2.202.197",80,10,1963,6,1620,4,343,73.338763,0.12564999999999316,103143.65300438285,21838.4401114218
"244.3.160.239",51327,"198.123.241.156",80,73,65367,27,2616,46,62751,73.764387,0.7000320000000073,29895.776193088004,717121.5030169975
"244.3.160.239",51328,"244.3.31.75",443,21,6170,11,2117,10,4053,73.897423,0.11045500000000175,153329.41016703393,293549.4092616856
"244.3.160.239",51329,"244.3.31.75",80,11,3010,6,1645,5,1365,74.065416,0.015292000000002304,860580.6957885181,714098.8752287703
"244.3.160.239",51330,"244.3.31.75",80,215,212649,75,6002,140,206647,74.118717,1.2801529999999985,37508.01661988845,1291389.388612144
"244.3.160.239",51331,"81.67.210.81",80,15,4829,8,2111,7,2718,74.203504,0.1296260000000018,130282.50505299683,167744.12540693764
"244.3.160.239",51332,"81.67.210.26",80,14,3248,7,2047,7,1201,74.305626,4.029711999999989,4063.8139896846333,2384.2894976117464
"244.3.160.239",51333,"198.123.241.156",80,11,1985,6,1541,5,444,74.355813,0.6647820000000024,18544.425089728597,5343.104957715442
"244.3.160.239",51334,"244.3.31.75",80,11,2385,6,1249,5,1136,75.150153,0.008766999999991754,1139728.527433489,1036614.5773934696
"244.3.160.239",51335,"244.3.31.75",80,52,42561,20,2170,32,40391,75.183228,0.10317200000000071,168262.70693598923,3131935.0211297423
"244.3.160.239",51336,"244.3.31.75",80,11,2099,6,1262,5,837,75.184389,0.004334999999997535,0,0
"244.3.160.239",51337,"244.3.31.75",80,14,4887,7,1322,7,3565,75.18476,0.007891000000000759,1340261.0569001373,3614244.075528736
"244.3.160.239",51338,"244.3.31.75",80,19,8772,9,1443,10,7329,75.185964,0.026279000000002384,439286.1219985141,2231135.126907214
"244.3.160.239",51339,"244.3.31.75",80,11,2491,6,1253,5,1238,75.196542,0.019665000000003374,509738.11339935317,503635.90134748543
"244.3.160.239",51347,"244.3.31.75",80,11,1710,6,1156,5,554,75.565298,0.012476000000006593,741263.2253923623,355242.06476415985
"244.3.160.239",51349,"244.3.31.75",80,11,2112,6,1291,5,821,75.619995,0.02865099999999643,360476.074133583,229241.56224916474
"244.3.160.239",51350,"244.3.31.75",80,11,2272,6,1295,5,977,75.62626,0.02312299999999823,448038.74929727084,338018.42321500665
"244.3.160.239",51351,"244.3.31.75",80,11,2888,6,1295,5,1593,75.635087,0.013568000000006464,763561.3207543532,939268.8679240808
"244.3.160.239",51352,"244.3.31.75",80,11,2313,6,1308,5,1005,75.641365,0.007496000000003278,1395944.503734715,1072572.038420022
"244.3.160.239",51353,"244.3.31.75",80,11,2889,6,1287,5,1602,75.654864,0.04235400000000311,243093.92265191584,302592.43518909806
"244.3.160.239",51354,"244.3.31.75",80,13,3204,7,1359,6,1845,75.662074,0.03525199999999984,308408.03358674824,418699.6482469099
"244.3.160.239",51359,"244.3.31.75",80,11,2048,6,1291,5,757,75.71422,0.02402600000000632,429867.6433862184,252060.26804288715
"244.3.160.239",51360,"244.3.31.75",80,11,2097,6,1298,5,799,75.730464,0.01129099999999994,919670.534053676,566114.6045523013
"244.3.160.239",51361,"244.3.31.75",80,11,2904,6,1295,5,1609,75.741818,0.0261950000000013,395495.32353500614,491391.48692496127
"244.3.160.239",51362,"244.3.31.75",80,11,2899,6,1299,5,1600,75.750526,0.01751200000001063,593421.653722801,730927.3640927495
"244.3.160.239",51363,"244.3.31.75",80,16,6936,8,1418,8,5518,75.774369,0.16525300000000698,68646.25755659214,267129.79492050456
"244.3.160.239",51364,"244.3.31.75",80,11,3015,6,1292,5,1723,75.779749,0.16032700000000943,64468.24302830709,85974.29004471604
"244.3.160.239",51365,"244.3.31.75",80,11,2892,6,1294,5,1598,75.785558,0.15478099999999984,66881.59399409495,82594.11684896734
"244.3.160.239",51366,"244.3.31.75",80,11,2379,6,1287,5,1092,75.83428,0.21378099999999733,48161.43623614881,40864.24892764141
"244.3.160.239",51367,"244.3.31.75",80,13,3224,7,1358,6,1866,75.857752,0.1899749999999898,57186.471904201,78578.7603632099
"244.3.160.239",51368,"244.3.31.75",80,11,2344,6,1299,5,1045,76.362517,0.1152930000000083,90135.56764070023,72510.90699348094
"244.3.160.239",51369,"81.67.210.26",80,17,7460,9,1793,8,5667,78.197081,0.2877629999999982,49846.57513300907,157546.31415435715
"244.3.160.239",51370,"81.67.210.26",80,11,2156,6,1478,5,678,78.419756,0.12448899999999696,94980.2793821164,43570.11462860279
"244.3.160.239",51371,"81.67.210.26",80,15,4873,8,1612,7,3261,78.421262,0.12594699999999648,102392.27611614695,207134.74715555535
"244.3.160.239",51372,"81.67.210.26",80,13,3035,7,1552,6,1483,78.421553,0.12326999999999089,100721.99237447,96244.01719802772
"244.3.160.239",51373,"81.67.210.26",80,15,5204,8,1608,7,3596,78.42244,0.12620000000001141,101933.43898572771,227955.62599047067
"244.3.160.239",51374,"81.67.210.26",80,17,6471,9,1669,8,4802,78.514368,0.12984699999999805,102828.71379392824,295855.89193435793
"244.3.160.239",51375,"81.67.210.26",80,162,147064,58,4801,104,142263,78.517444,0.4617190000000022,83184.79421466263,2464927.8024079464
"244.3.160.239",51376,"81.67.210.26",80,32,21107,14,1992,18,19115,78.51855,0.23809099999999717,66932.39139656766,642275.4325027062
"244.3.160.239",51377,"81.67.210.26",80,75,63213,28,2878,47,60335,78.521182,0.32571200000001,70688.21535589507,1481922.6801591136
"244.3.160.239",51378,"81.67.210.26",80,35,23376,15,2049,20,21327,78.614787,0.2451729999999941,66858.91187039517,695900.4458076709
"244.3.160.239",51379,"81.67.210.26",80,13,4754,7,1539,6,3215,78.731338,0.12471200000000238,98723.45884918665,206235.16582205007
"244.3.160.239",51380,"81.67.210.26",80,212,206063,75,5896,137,200167,78.818789,0.5513470000000069,85550.47909936828,2904406.843602994
"244.3.160.239",51381,"81.67.210.26",80,21,11037,10,1725,11,9312,78.830529,0.16488700000000733,83693.68112707118,451800.3238581373
"244.3.160.239",51382,"81.67.210.26",80,17,7916,9,1665,8,6251,78.831676,0.16310199999999497,81666.68710377807,306605.6823337638
"244.3.160.239",51383,"81.67.210.26",80,20,9348,10,1726,10,7622,79.008545,0.16647500000000548,82943.38489262378,366277.2188016098
"244.3.160.239",51384,"81.67.210.26",80,21,8743,11,1793,10,6950,79.011149,0.16574500000000114,86542.5804699985,335455.06651784136
"244.3.160.239",51385,"81.67.210.26",80,18,7491,9,1655,9,5836,79.011719,0.1625099999999975,81471.90942095997,287293.0896560256
"244.3.160.239",51386,"81.67.210.26",80,281,261462,98,7348,183,254114,79.151411,0.6347020000000043,92616.69255808175,3202939.332159007
"244.3.160.239",51387,"43.106.84.231",80,14,4313,7,1213,7,3100,79.205035,0.10791500000000553,89922.62428762918,229810.49900383383
"244.3.160.239",51388,"244.3.31.75",80,11,1710,6,1156,5,554,79.34792,0.009557000000000926,967667.6781415825,463743.85267338814
"244.3.160.239",51389,"43.106.84.231",80,14,4314,7,1214,7,3100,79.538025,0.2522919999999971,38495.07713284651,98298.79663247462
"244.3.160.239",51390,"81.67.210.26",80,17,6200,9,1659,8,4541,79.78308,0.3319620000000043,39980.47969345837,109434.21234960486
"244.3.160.239",51391,"81.67.217.159",80,687,827033,108,8083,579,818950,79.786589,2.108976999999996,30661.311147537468,3106529.8483577645
"244.3.160.239",51392,"177.124.75.164",80,15,4384,8,2468,7,1916,79.948768,0.1869180000000057,105629.20638996457,82003.87335622858
"244.3.160.239",51393,"41.43.180.211",80,15,6706,8,1042,7,5664,80.00269,0.5370329999999939,15522.323581605031,84374.7032305287
"244.3.160.239",51394,"43.106.84.108",80,13,5173,7,1135,6,4038,80.101589,0.13757900000000234,65998.4445300507,234803.2766628588
"244.3.160.239",51395,"177.124.75.164",80,13,2925,7,2454,6,471,80.13101,0.09553499999999815,205495.36818967268,39441.042549851605
"244.3.160.239",51396,"81.67.210.26",80,11,2134,6,1545,5,589,80.138356,0.31513900000000206,39220.78828707307,14952.132233712646
"244.3.160.239",51397,"81.67.210.26",80,11,2201,6,1462,5,739,80.156605,0.16065299999999638,72802.87327345436,36799.81077228644
"244.3.160.239",51398,"81.67.210.26",80,15,4850,8,1587,7,3263,80.157423,0.15912700000001223,79785.32869971171,164045.0709181848
"244.3.160.239",51399,"48.151.224.205",80,17,9504,8,1670,9,7834,80.371399,0.160648000000009,83163.18908420429,390120.0139435068
"244.3.160.239",51400,"81.67.210.26",80,13,2531,7,1511,6,1020,81.872193,0.26304700000000025,45953.76491653579,31021.0722798587
"244.3.160.239",51401,"41.177.254.197",80,82,66716,31,3855,51,62861,81.928404,3.076457000000005,10024.518463934308,163463.36061254854
"244.3.160.239",51402,"43.106.84.108",80,10,2436,6,1282,4,1154,82.371029,0.1291130000000038,79434.29399053309,71503.25683703212
"244.3.160.239",51403,"43.106.84.108",80,10,1570,6,1007,4,563,83.023904,0.2464169999999939,32692.549621171427,18277.959718688693
"244.3.160.239",51404,"43.106.84.108",80,10,2275,6,1282,4,993,83.559125,0.12716100000000097,80653.659533976,62471.984334819164
"244.3.160.239",51405,"43.106.84.108",80,12,2735,7,1671,5,1064,83.733676,0.1239089999999976,107885.62574147365,68695.5749784129
"244.3.160.239",51406,"43.106.84.231",80,14,4569,7,1469,7,3100,83.881167,0.10526499999998862,111642.04626420245,235595.87707217672
"244.3.160.239",51407,"43.106.84.231",80,11,1572,6,1136,5,436,83.962684,0.10575800000000868,85932.03351046024,32980.95652338087
"244.3.160.239",51408,"43.106.84.231",80,11,1581,6,1145,5,436,83.963574,0.10395900000000324,88111.65940418544,33551.68864648459
"244.3.160.239",51409,"43.106.84.108",80,22,11379,12,10190,10,1189,84.66884,0.18288499999999885,445744.593597072,52010.82647565442
"244.3.160.239",51410,"43.106.84.231",80,14,4569,7,1469,7,3100,84.89594,0.10598400000000652,110884.66183574198,233997.58454104842
"244.3.160.239",51411,"43.106.84.231",80,11,1572,6,1136,5,436,84.977133,0.1041969999999992,87219.40171022265,33475.05206483897
"244.3.160.239",51412,"43.106.84.231",80,11,1581,6,1145,5,436,84.980525,0.10347099999999898,88527.22018729972,33709.9283857316
"244.3.160.239",51413,"43.106.84.231",80,95,87596,34,3228,61,84368,85.691939,0.563683999999995,45812.902264389675,1197380.092392202
"244.3.160.239",51414,"177.202.64.15",80,55,57346,14,2013,41,55333,85.985012,0.43805000000000405,36762.926606551424,1010533.0441730303
"244.3.160.239",51415,"43.106.84.231",80,11,1605,6,1169,5,436,86.025417,0.10379299999999603,90102.41538447062,33605.349108322655
"244.3.160.239",51416,"43.106.84.231",80,11,1598,6,1162,5,436,86.230035,0.10458099999999604,88888.03893633024,33352.13853376935
"244.3.160.239",51417,"43.106.84.231",80,11,1601,6,1165,5,436,86.25244,0.10369899999999177,89875.5050675584,33635.811338588384
"244.3.160.239",51418,"43.106.84.231",80,11,1600,6,1164,5,436,86.306936,0.10548400000000413,88278.79109627655,33066.626218192934
"244.3.160.239",51419,"43.106.84.231",80,11,1602,6,1166,5,436,86.388492,0.11225100000000054,83099.48240995586,31073.219837685036
"244.3.160.239",51420,"244.3.31.75",80,13,3337,7,1449,6,1888,86.43986,0.03550100000001066,326526.0133516385,425452.8041462343
"244.3.160.239",51421,"244.3.31.108",80,11,2193,6,1235,5,958,86.522495,0.34987199999999063,28238.89879727519,21905.153884849904
"244.3.160.239",51422,"43.106.84.231",80,11,1609,6,1173,5,436,86.542476,0.103580000000008,90596.64027803896,33674.45452789854
"244.3.160.239",51423,"43.106.84.231",80,11,1606,6,1170,5,436,86.620512,0.10413499999999942,89883.32453065782,33494.982474672484
"244.3.160.239",51424,"43.106.84.231",80,11,1607,6,1171,5,436,86.702398,0.10464799999999741,89519.14991208845,33330.78510817298
"244.3.160.239",51425,"43.106.84.26",80,22,11390,10,1428,12,9962,86.784537,0.21286899999999775,53666.80916432229,374389.8829796769
"244.3.160.239",51426,"43.106.84.231",80,11,1612,6,1176,5,436,86.97629,0.10546699999999021,89203.25789110218,33071.95615690523
"244.3.160.239",51427,"94.2.202.98",80,10,2006,6,1204,4,802,86.9775,0.12086299999999994,79693.53731083959,53084.897776821716
"244.3.160.239",51428,"43.106.84.231",80,11,1607,6,1171,5,436,87.055036,0.10399900000000173,90077.78920951013,33538.78402676893
"244.3.160.239",51429,"94.2.202.98",80,10,2283,6,1290,4,993,87.088805,0.13490100000001348,76500.54484398906,58887.62870548925
"244.3.160.239",51430,"43.106.84.231",80,11,1607,6,1171,5,436,87.134862,0.1040789999999987,90008.55119668826,33513.004544625175
"244.3.160.239",51431,"198.123.241.156",80,489,478662,172,11790,317,466872,87.147037,5.847707999999997,16129.396337847245,638707.6782903664
"244.3.160.239",51432,"43.106.84.231",80,14,4279,7,1179,7,3100,87.213877,0.10604299999999967,88945.05059268438,233867.3934158792
"244.3.160.239",51433,"43.106.84.231",80,11,1593,6,1157,5,436,87.217363,0.10468299999999431,88419.32309926639,33319.64120248932
"244.3.160.239",51434,"43.106.84.231",80,11,1592,6,1156,5,436,87.291899,0.10306799999999328,89727.17041177284,33841.735553229206
"244.3.160.239",51435,"43.106.84.231",80,11,1596,6,1160,5,436,87.295356,0.10319800000000612,89924.22333765625,33799.104633808725
"244.3.160.239",51436,"94.2.202.203",80,11,2213,6,1210,5,1003,87.326722,0.3319669999999917,29159.524892535228,24171.07724563044
"244.3.160.239",51437,"77.91.159.163",80,12,2349,7,1859,5,490,87.339553,0.24012600000000361,61934.15123726617,16324.762832845843
"244.3.160.239",51438,"43.106.84.231",80,11,1603,6,1167,5,436,87.366993,0.10357500000000641,90137.5814627026,33676.08013516567
"244.3.160.239",51439,"43.106.84.231",80,11,1606,6,1170,5,436,87.453102,0.10395300000000418,90040.69146633212,33553.62519600069
"244.3.160.239",51440,"43.106.84.231",80,11,1596,6,1160,5,436,87.537948,0.10422900000000368,89034.7216225779,33464.774678831
"244.3.160.239",51441,"43.106.84.231",80,11,1595,6,1159,5,436,87.639574,0.1049250000000086,88367.88182034063,33242.79247080976
"244.3.160.239",51442,"43.106.84.231",80,11,1613,6,1177,5,436,87.642405,0.10422400000000209,90343.87473134605,33466.38010438987
"244.3.160.239",51443,"43.106.84.231",80,11,1620,6,1184,5,436,87.717864,0.10363299999998787,91399.45770170803,33657.23273475059
"244.3.160.239",51444,"43.106.84.231",80,11,1618,6,1182,5,436,87.719278,0.10512699999999597,89948.34818838512,33178.916929048995
"244.3.160.239",51445,"94.2.202.203",80,41,31142,16,1913,25,29229,87.754136,0.3770140000000026,40592.657036608434,620220.9997506681
"244.3.160.239",51446,"43.106.84.231",80,11,1618,6,1182,5,436,87.79458,0.1031899999999979,91636.78651032264,33801.72497335082
"244.3.160.239",51447,"43.106.84.231",80,11,1620,6,1184,5,436,87.797147,0.10401000000000238,91068.16652244769,33535.23699644188
"244.3.160.239",51448,"43.106.84.231",80,28,18013,12,1540,16,16473,87.86985,0.35016500000000406,35183.41353361946,376348.29294760607
"244.3.160.239",51449,"43.106.84.231",80,11,1626,6,1190,5,436,87.873654,0.10354599999999436,91939.81418886792,33685.511753232284
"244.3.160.239",51450,"43.106.84.231",80,16,5805,8,1297,8,4508,87.949613,0.4962450000000018,20909.02679120185,72673.7800884641
"244.3.160.239",51451,"94.2.202.98",80,10,2666,6,1705,4,961,88.160269,0.1315349999999995,103698.63534420535,58448.32173946119
"244.3.160.239",51452,"43.106.84.108",80,13,5139,7,1101,6,4038,88.21579,0.13661899999999605,64471.266807693326,236453.2019704502
"244.3.160.239",51453,"43.106.84.231",80,11,1606,6,1170,5,436,88.22715,0.1052400000000091,88939.56670466733,33143.291524132444
"244.3.160.239",51454,"43.106.84.231",80,11,1620,6,1184,5,436,88.304317,0.10350400000000093,91513.37146390395,33699.18070799166
"244.3.160.239",51455,"43.106.84.231",80,11,1595,6,1159,5,436,88.327296,0.10516299999999035,88167.89174900726,33167.55893232715
"244.3.160.239",51456,"43.106.84.231",80,11,1604,6,1168,5,436,88.379695,0.10502599999999518,88968.44590863623,33210.82398644298
"244.3.160.239",51457,"94.2.202.203",80,11,2962,6,1726,5,1236,88.382851,1.549869000000001,8909.140062805302,6379.894042657795
"244.3.160.239",51458,"43.106.84.231",80,11,1611,6,1175,5,436,88.404644,0.1059009999999887,88762.14577766974,32936.4217523949
"244.3.160.239",51459,"43.106.84.231",80,11,1604,6,1168,5,436,88.456695,0.10352600000000223,90257.51985008402,33692.01939609301
"244.3.160.239",51460,"43.106.84.231",80,11,1598,6,1162,5,436,88.482857,0.10489800000000571,88619.42077064858,33251.3489294344
"244.3.160.239",51461,"43.106.84.231",80,11,1603,6,1167,5,436,88.533798,0.10497099999999193,88938.84977756445,33228.224938318854
"244.3.160.239",51462,"43.106.84.231",80,11,1606,6,1170,5,436,88.562261,0.1024099999999919,91397.32448003849,34059.173908800665
"244.3.160.239",51463,"43.106.84.231",80,11,1606,6,1170,5,436,88.610893,0.10402799999999957,89975.77575268234,33529.43438305086
"244.3.160.239",51464,"43.106.84.231",80,11,1619,6,1183,5,436,88.638037,0.10482199999999864,90286.39026158748,33275.45744214044
"244.3.160.239",51465,"48.151.224.205",80,41,32058,17,2347,24,29711,88.654902,0.4892379999999861,38378.049129463645,485833.07102066226
"244.3.160.239",51466,"43.106.84.231",80,11,1607,6,1171,5,436,88.688903,0.10484800000000405,89348.39005035517,33267.20585991021
"244.3.160.239",51467,"43.106.84.231",80,14,4280,7,1180,7,3100,88.713855,0.27633800000000974,34161.0636249798,89745.16715037066
"244.3.160.239",51468,"43.106.84.231",80,11,1612,6,1176,5,436,88.766047,0.10325000000000273,91118.6440677942,33782.08232445431
"244.3.160.239",51469,"43.106.84.231",80,11,1609,6,1173,5,436,88.841317,0.10307299999999486,91042.27101181171,33840.09391402379
"244.3.160.239",51470,"43.106.84.231",80,11,1616,6,1180,5,436,88.854575,0.10380500000000836,90939.74278694899,33601.46428399132
"244.3.160.239",51471,"43.106.84.231",80,11,1605,6,1169,5,436,88.917402,0.10376600000000735,90125.86010831426,33614.09324826777
"244.3.160.239",51472,"43.106.84.231",80,11,1601,6,1165,5,436,88.931956,0.10333099999999718,90195.58506160064,33755.60093292521
"244.3.160.239",51473,"43.106.84.231",80,11,1604,6,1168,5,436,88.993642,0.10540200000001221,88651.0692396626,33092.351188778164
"244.3.160.239",51474,"43.106.84.231",80,11,1606,6,1170,5,436,89.007577,0.10314400000000035,90746.91693166805,33816.79981385236
"244.3.160.239",51475,"43.106.84.231",80,11,1605,6,1169,5,436,89.071263,0.10494900000000484,89109.9486417171,33235.190425824345
"244.3.160.239",51476,"43.106.84.231",80,11,1603,6,1167,5,436,89.083048,0.10409999999998831,89682.99711816569,33506.243996161305
"244.3.160.239",51477,"43.106.84.108",80,10,1421,6,1021,4,400,89.337611,0.10164900000000898,80354.9469251963,31480.88028411216
"244.3.160.239",51478,"94.2.202.203",80,19,10866,13,9797,6,1069,89.557987,0.8724240000000094,89837.05170880117,9802.57306080519
"244.3.160.239",51479,"244.3.31.75",80,11,1710,6,1156,5,554,89.640564,0.015909000000007723,581306.1788921687,278584.44905385934
"244.3.160.239",51480,"43.106.84.108",80,10,1416,6,1016,4,400,89.692882,0.10239400000000387,79379.65115143165,31251.831161980965
"244.3.160.239",51481,"43.106.84.108",80,10,1409,6,1019,4,390,89.702908,0.10256500000001267,79481.30453857547,30419.733827325254
"244.3.160.239",51482,"43.106.84.231",80,11,1607,6,1171,5,436,89.720206,0.10418799999999351,89914.38553384827,33477.943717128815
"244.3.160.239",51483,"94.2.202.203",80,78,67186,29,3414,49,63772,89.931081,0.36898399999999754,74019.46967890256,1382650.738243402
"244.3.160.239",51484,"94.2.202.197",80,105,118384,20,2854,85,115530,90.199985,0.6807820000000078,33537.902000933835,1357615.2130931627
"244.3.160.239",51485,"94.2.202.197",80,17,7428,9,2149,8,5279,90.205162,0.15681999999999618,109628.87386813173,269302.3848998918
"244.3.160.239",51486,"94.2.202.203",80,21,11910,13,10509,8,1401,90.20837,0.25902599999999154,324569.7343123962,43269.787588892104
"244.3.160.239",51487,"94.2.202.197",80,14,4239,8,2092,6,2147,90.211603,0.11998300000000484,139486.42724385392,143153.6134285633
"244.3.160.239",51488,"94.2.202.197",80,104,92843,38,4011,66,88832,90.217721,0.37095500000000925,86501.05807981885,1915747.1930557138
"244.3.160.239",51489,"94.2.202.197",80,14,3762,8,1988,6,1774,90.221998,0.25346700000000055,62745.84068142979,55991.50974288554
"244.3.160.239",51490,"94.2.202.197",80,146,134395,52,4907,94,129488,90.244602,0.4341139999999939,90427.85996305245,2386248.7733637122
"244.3.160.239",51491,"94.2.202.197",80,20,10563,10,2210,10,8353,90.333664,0.16226199999999835,108959.58388285723,411827.7846938943
"244.3.160.239",51492,"94.2.202.197",80,14,4013,8,2082,6,1931,90.363342,0.12194699999999159,136583.92580384223,126677.98305822255
"244.3.160.239",51493,"43.106.84.108",80,36,28703,15,1594,21,27109,90.370056,0.21358599999999228,59704.287734216945,1015384.903504948
"244.3.160.239",51494,"94.2.202.197",80,39,28907,16,2604,23,26303,90.371505,0.2420720000000074,86057.0408803966,869262.0377408109
"244.3.160.239",51495,"94.2.202.203",80,212,200266,73,5964,139,194302,90.398723,1.4293989999999894,33379.06350850977,1087461.2337073213
"244.3.160.239",51496,"94.2.202.203",80,93,82826,34,4071,59,78755,90.450007,1.036839999999998,31410.825199645136,607654.0256934543
"244.3.160.239",51497,"94.2.202.197",80,18,8759,9,2149,9,6610,90.496115,0.16108199999999329,106728.25020797306,328280.0064563527
"244.3.160.239",51498,"43.106.84.108",80,10,2402,6,1248,4,1154,90.577174,0.12834300000000098,77791.54297468443,71932.24406473224
"244.3.160.239",51499,"43.106.84.108",80,10,1414,6,1024,4,390,90.688936,0.10255999999999688,79875.19500780274,30421.216848674874
"244.3.160.239",51500,"43.106.84.108",80,10,1404,6,1014,4,390,90.693512,0.10243599999999731,79190.9094459,30458.042094576926
"244.3.160.239",51501,"43.106.84.108",80,10,1417,6,1017,4,400,90.765662,0.10261299999999096,79288.19935096642,31185.132488089053
"244.3.160.239",51502,"43.106.84.108",80,10,1403,6,1013,4,390,90.770179,0.10257099999999753,79008.68666582362,30417.954392567834
"244.3.160.239",51503,"43.106.84.108",80,10,1409,6,1019,4,390,90.840819,0.103225000000009,78973.1169774695,30225.236134654664
"244.3.160.239",51504,"43.106.84.108",80,10,1417,6,1027,4,390,90.844814,0.10172400000000437,80767.56714246045,30671.22802878245
"244.3.160.239",51505,"43.106.84.108",80,10,1407,6,1017,4,390,90.91668,0.1019019999999955,79841.41626268729,30617.65225412787
"244.3.160.239",51506,"43.106.84.108",80,10,1419,6,1019,4,400,90.91995,0.10270300000000532,79374.5070737912,31157.80454319576
"244.3.160.239",51507,"43.106.84.108",80,10,1536,6,973,4,563,90.991414,0.11869499999998823,65579.84750832614,37945.996040275044
"244.3.160.239",51508,"94.2.202.197",80,12,3140,7,2017,5,1123,91.09333,0.1637010000000032,98569.95375715288,54880.544407180314
"244.3.160.239",51509,"94.2.202.197",80,12,3410,7,2012,5,1398,91.101826,0.15564299999999776,103416.15106365357,71856.74909890044
"244.3.160.239",51510,"94.2.202.197",80,12,2397,7,1990,5,407,91.217976,0.11798200000001202,134935.83767013933,27597.43011645563
"244.3.160.239",51511,"94.2.202.197",80,12,2396,7,1989,5,407,91.332143,0.11793199999999615,134925.21113862665,27609.130685480668
"244.3.160.239",51512,"43.106.84.108",80,10,2241,6,1248,4,993,91.348089,0.12636000000000536,79012.345679009,62867.99620132687
"244.3.160.239",51513,"94.2.202.197",80,12,2403,7,1996,5,407,91.418831,0.11728899999999953,136142.3492399122,27760.489048418975
"244.3.160.239",51514,"94.2.202.197",80,10,1921,6,1578,4,343,91.488108,0.11772899999999709,107229.31478225681,23307.766140883454
"244.3.160.239",51515,"94.2.202.197",80,10,1926,6,1582,4,344,91.493623,0.11690400000000523,108259.7686990987,23540.682953533473
"244.3.160.239",51516,"94.2.202.197",80,10,1886,6,1543,4,343,91.497336,0.1166070000000019,105859.85403963568,23532.03495501947
"244.3.160.239",51517,"94.2.202.197",80,10,1885,6,1542,4,343,91.50157,0.11916399999999783,103521.19767715271,23027.088718069634
"244.3.160.239",51518,"94.2.202.197",80,12,2402,7,1995,5,407,91.505132,0.11730599999999924,136054.42176870836,27756.46599491945
"244.3.160.239",51519,"94.2.202.203",80,10,2131,6,1565,4,566,91.50986,0.12024199999999041,104123.35124167096,37657.39092829761
"244.3.160.239",51520,"94.2.202.197",80,10,1893,6,1549,4,344,91.581558,0.11775400000000502,105236.3401667839,23370.755982810628
"244.3.160.239",51521,"94.2.202.197",80,10,1891,6,1548,4,343,91.59368,0.11776700000000062,105156.79264989287,23300.245399814765
"244.3.160.239",51522,"94.2.202.197",80,12,2401,7,1994,5,407,91.616251,0.11823799999999096,134914.32534380842,27537.67824219159
"244.3.160.239",51523,"94.2.202.197",80,10,2024,6,1562,4,462,91.655648,0.1185040000000015,105447.91736987648,31188.820630526847
"244.3.160.239",51524,"94.2.202.197",80,10,1911,6,1566,4,345,91.664797,0.11830500000000654,105895.7778622992,23329.52960567894
"244.3.160.239",51525,"94.2.202.197",80,12,2418,7,2010,5,408,91.720107,0.11701800000000162,137414.7567040949,27893.144644413293
"244.3.160.239",51526,"43.106.84.108",80,12,2540,7,1637,5,903,91.750894,0.11790700000000243,111070.58953242582,61268.62696871137
"244.3.160.239",51527,"94.2.202.197",80,10,1892,6,1548,4,344,91.784174,0.116572000000005,106234.77335894956,23607.727413099903
"244.3.160.239",51528,"94.2.202.197",80,10,1878,6,1535,4,343,91.806644,0.11762499999998965,104399.57492030674,23328.374070140202
"244.3.160.239",51529,"94.2.202.197",80,12,2422,7,2014,5,408,91.863739,0.11739200000000949,137249.55703965088,27804.2796783404
"244.3.160.239",51530,"94.2.202.197",80,10,1890,6,1546,4,344,91.900842,0.1170670000000058,105648.90191086632,23507.905729196646
"244.3.160.239",51531,"43.106.84.231",80,14,4535,7,1435,7,3100,91.912589,0.1049640000000096,109370.83190426193,236271.48355624528
"244.3.160.239",51532,"94.2.202.197",80,10,1883,6,1540,4,343,91.995443,0.11761700000000985,104746.76279788608,23329.96080498372
"244.3.160.239",51533,"43.106.84.231",80,11,1572,6,1136,5,436,91.997541,0.10437600000000202,87069.82448072184,33417.64390281226
"244.3.160.239",51534,"94.2.202.197",80,12,2416,7,2008,5,408,92.002257,0.11738599999999622,136847.66496856965,27805.70085018746
"244.3.160.239",51535,"43.106.84.231",80,11,1581,6,1145,5,436,92.004369,0.1047360000000026,87457.98961197461,33302.78032386107
"244.3.160.239",51536,"94.2.202.197",80,12,2410,7,2001,5,409,92.091483,0.11775000000000091,135949.0445859862,27787.685774946705
"244.3.160.239",51537,"94.2.202.197",80,10,1894,6,1550,4,344,92.115411,0.11730200000000934,105710.04756951299,23460.81055736288
"244.3.160.239",51538,"94.2.202.197",80,10,1883,6,1539,4,344,92.122083,0.11804300000000012,104300.97506840716,23313.53828689543
"244.3.160.239",51539,"94.2.202.197",80,12,2419,7,2011,5,408,92.178861,0.11866399999999544,135576.08036136164,27506.236095194206
"244.3.160.239",51540,"43.106.84.108",80,36,25743,17,10466,19,15277,92.191298,1.0387229999999903,80606.66799522181,117659.85734406684
"244.3.160.239",51541,"94.2.202.197",80,10,1895,6,1551,4,344,92.210227,0.1170319999999947,106022.2845033885,23514.936085857924
"244.3.160.239",51542,"94.2.202.197",80,12,2412,7,2004,5,408,92.283393,0.11707299999999066,136940.19970446883,27880.040658394853
"244.3.160.239",51543,"94.2.202.197",80,10,2004,6,1542,4,462,92.29613,0.11781499999999312,104706.53142639494,31371.21758689654
"244.3.160.239",51544,"94.2.202.197",80,12,2419,7,2011,5,408,92.371245,0.11775699999999745,136620.32830320363,27718.09743794484
"244.3.160.239",51545,"94.2.202.197",80,10,1883,6,1539,4,344,92.383149,0.11816799999999716,104190.64382912713,23288.876853294176
"244.3.160.239",51546,"94.2.202.197",80,12,2431,7,2023,5,408,92.459648,0.11809800000000337,137038.73054581397,27638.06330335744
"244.3.160.239",51547,"94.2.202.197",80,10,1907,6,1562,4,345,92.47037,0.11780600000000163,106072.69578798895,23428.348301444425
"244.3.160.239",51548,"94.2.202.197",80,12,2432,7,2024,5,408,92.547962,0.11872599999999522,136381.24757846346,27491.872041508443
"244.3.160.239",51549,"94.2.202.197",80,10,1887,6,1543,4,344,92.558045,0.11742899999998713,105118.83776581043,23435.4375835637
"244.3.160.239",51550,"94.2.202.197",80,12,2415,7,2007,5,408,92.635331,0.11783600000001115,136257.17098338777,27699.514579582563
"244.3.160.239",51551,"94.2.202.197",80,10,2002,6,1540,4,462,92.644739,0.11806699999999637,104347.53148636266,31304.259445908796
"244.3.160.239",51552,"94.2.202.197",80,12,2395,7,1987,5,408,92.723966,0.11754399999999521,135234.46539168863,27768.32505274734
"244.3.160.239",51553,"94.2.202.197",80,12,2412,7,2005,5,407,92.732853,0.1176320000000004,136357.45375408005,27679.542981501538
"244.3.160.239",51554,"94.2.202.197",80,12,2404,7,1997,5,407,92.746834,0.11864899999999068,134649.25958079085,27442.28775632543
"244.3.160.239",51555,"94.2.202.197",80,12,2402,7,1995,5,407,92.749406,0.11737600000000725,135973.2824427397,27739.912758995015
"244.3.160.239",51556,"94.2.202.197",80,12,2407,7,2000,5,407,92.752634,0.11730299999999261,136398.89857890256,27757.175860806674
"244.3.160.239",51558,"94.2.202.197",80,12,2402,7,1995,5,407,92.768973,0.1167689999999908,136680.11201604243,27884.113077959533
"244.3.160.239",51560,"94.2.202.197",80,12,2409,7,2002,5,407,92.788626,0.1173339999999996,136499.22443622525,27749.8423304414
"244.3.160.239",51561,"94.2.202.197",80,12,2399,7,1992,5,407,92.79782,0.11727700000000141,135883.42130170288,27763.32955310897
"244.3.160.239",51562,"94.2.202.197",80,12,2400,7,1993,5,407,92.827559,0.11722200000001237,136015.4237259074,27776.355974131617
"244.3.160.239",51563,"94.2.202.197",80,12,2402,7,1995,5,407,92.832042,0.11782200000000387,135458.57310179318,27634.906893448533
"244.3.160.239",51564,"94.2.202.197",80,12,2401,7,1994,5,407,92.835785,0.11697599999999397,136369.8536451992,27834.76952537416
"244.3.160.239",51565,"94.2.202.197",80,12,2404,7,1996,5,408,92.837597,0.11830899999999644,134968.59917673617,27588.77177560539
"244.3.160.239",51566,"94.2.202.197",80,12,2402,7,1995,5,407,92.839774,0.11732200000000148,136035.8671007978,27752.680656653985
"244.3.160.239",51567,"94.2.202.197",80,12,2402,7,1995,5,407,92.847519,0.11751900000000148,135807.8268194913,27706.158153149354
"244.3.160.239",51568,"94.2.202.197",80,12,2406,7,1999,5,407,92.859295,0.119852999999992,133430.1185619139,27166.612433566264
"244.3.160.239",51569,"94.2.202.197",80,12,2403,7,1995,5,408,92.86119,0.11803400000000863,135215.27695408807,27653.04912143756
"244.3.160.239",51570,"177.202.64.15",80,198,193507,69,5937,129,187570,92.862282,1.3221520000000027,35923.252394580886,1134937.5866012357
"244.3.160.239",51571,"94.2.202.197",80,12,2400,7,1993,5,407,92.872265,0.11840399999999818,134657.61291848455,27499.07097733227
"244.3.160.239",51572,"94.2.202.197",80,12,2395,7,1987,5,408,92.88126,0.11785299999999665,134879.8927477489,27695.518994001788
"244.3.160.239",51573,"94.2.202.197",80,12,2393,7,1985,5,408,92.911546,0.1172949999999986,135385.140031546,27827.27311479636
"244.3.160.239",51574,"94.2.202.197",80,12,2410,7,2003,5,407,92.916248,0.11764999999999759,136200.59498512815,27675.308117297634
"244.3.160.239",51575,"94.2.202.197",80,12,2401,7,1994,5,407,92.922868,0.12180899999999895,130959.12453102921,26730.372960947287
"244.3.160.239",51576,"94.2.202.197",80,12,2401,7,1994,5,407,92.923499,0.12133199999999533,131473.97224145825,26835.45973032774
"244.3.160.239",51577,"94.2.202.197",80,12,2407,7,1999,5,408,92.925328,0.11758100000000127,136008.36869902303,27759.58700810475
"244.3.160.239",51578,"94.2.202.197",80,12,2406,7,1999,5,407,92.931304,0.11825299999999572,135235.46971324683,27534.18517923535
"244.3.160.239",51579,"94.2.202.197",80,12,2404,7,1997,5,407,92.949843,0.11672899999999231,136864.01836733846,27893.668240113548
"244.3.160.239",51580,"94.2.202.197",80,10,1869,6,1525,4,344,93.024598,0.11979300000000137,101842.34471129248,22972.961692252207
"244.3.160.239",51581,"94.2.202.197",80,10,1878,6,1535,4,343,93.02525,0.12112700000000132,101381.19494414843,22653.908707389517
"244.3.160.239",51582,"94.2.202.197",80,10,1886,6,1543,4,343,93.0257,0.11875600000000475,103944.22176563294,23106.20094984582
"244.3.160.239",51583,"94.2.202.197",80,10,1875,6,1532,4,343,93.026298,0.11844299999999919,103475.93357142324,23167.26188968549
"244.3.160.239",51584,"94.2.202.197",80,12,2402,7,1994,5,408,93.04937,0.11786899999999889,135336.68733933562,27691.7594957116
"244.3.160.239",51585,"94.2.202.197",80,12,2406,7,1999,5,407,93.053206,0.11698499999999967,136701.2864897213,27832.62811471564
"244.3.160.239",51586,"94.2.202.197",80,12,2401,7,1994,5,407,93.061583,0.11819400000000257,134964.54980793994,27547.9296749406
"244.3.160.239",51587,"94.2.202.197",80,10,1881,6,1538,4,343,93.167098,0.11982300000001089,102684.79340359432,22900.444822778187
"244.3.160.239",51588,"94.2.202.197",80,10,1876,6,1533,4,343,93.167438,0.1262660000000011,97128.28473223111,21731.899323649883
"244.3.160.239",51589,"94.2.202.197",80,12,2437,7,2029,5,408,93.174866,0.11789000000000271,137687.67495122255,27686.82670285796
"244.3.160.239",51590,"94.2.202.197",80,10,1874,6,1531,4,343,93.177638,0.11915899999999624,102787.03245244075,23028.054951787835
"244.3.160.239",51591,"94.2.202.197",80,10,1883,6,1540,4,343,93.178127,0.1192219999999935,103336.6325007186,23015.886329705503
"244.3.160.239",51592,"43.106.84.231",80,91,83186,33,3130,58,80056,93.201999,0.7265100000000047,34466.14637100637,881540.5156157464
"244.3.160.239",51593,"43.106.84.231",80,14,4535,7,1435,7,3100,93.248258,0.10658999999999708,107702.41110798682,232667.22957126072
"244.3.160.239",51594,"94.2.202.197",80,10,1875,6,1532,4,343,93.256424,0.11678299999999808,104946.78163774009,23496.57056249664
"244.3.160.239",51595,"94.2.202.197",80,10,1876,6,1533,4,343,93.26502,0.11773399999999867,104167.02057179861,23306.77629232024
"244.3.160.239",51596,"94.2.202.197",80,10,1877,6,1534,4,343,93.278325,0.11780600000000163,104171.26462149492,23292.53178955199
"244.3.160.239",51597,"94.2.202.197",80,10,1876,6,1533,4,343,93.278899,0.11733500000001129,104521.2425959758,23386.031448414677
"244.3.160.239",51598,"43.106.84.231",80,11,1572,6,1136,5,436,93.329866,0.1036150000000049,87709.30849780023,33663.07966993037
"244.3.160.239",51599,"94.2.202.197",80,10,1867,6,1524,4,343,93.342273,0.11798599999998771,103334.29389928695,23256.99659281852
"244.3.160.239",51600,"94.2.202.197",80,10,1867,6,1524,4,343,93.352177,0.11824800000000835,103105.3379338267,23205.46647723265
"244.3.160.239",51601,"94.2.202.197",80,10,1875,6,1532,4,343,93.366386,0.11699399999999116,104757.5089320899,23454.194232184618
"244.3.160.239",51602,"94.2.202.197",80,10,1874,6,1531,4,343,93.370013,0.11751099999999326,104228.54030687087,23351.005437790143
"244.3.160.239",51603,"43.106.84.231",80,11,1581,6,1145,5,436,93.40551,0.1065489999999869,85969.83547476865,32736.11202358003
"244.3.160.239",51604,"94.2.202.197",80,10,1874,6,1530,4,344,93.431114,0.1175010000000043,104169.32621849646,23421.077267426655
"244.3.160.239",51605,"94.2.202.197",80,10,1879,6,1536,4,343,93.459654,0.1171149999999983,104922.51206079646,23429.962003159628
"244.3.160.239",51606,"94.2.202.197",80,10,1874,6,1530,4,344,93.462367,0.11767299999999636,104017.06423733888,23386.843201074887
"244.3.160.239",51607,"94.2.202.197",80,10,1879,6,1536,4,343,93.463342,0.1173780000000022,104687.42012983497,23377.46426076393
"244.3.160.239",51608,"43.106.84.108",80,10,1404,6,1014,4,390,93.537568,0.10295000000000698,78795.53181155366,30305.973773674486
"244.3.160.239",51609,"43.106.84.108",80,10,1412,6,1022,4,390,93.58309,0.10301300000000424,79368.62337762868,30287.439449388636
"244.3.160.239",51610,"43.106.84.108",80,10,1409,6,1019,4,390,93.612824,0.10664299999999116,76441.96056000558,29256.491284006064
"244.3.160.239",51611,"94.2.202.197",80,10,1876,6,1533,4,343,93.638874,0.11801300000000481,103920.75449314482,23251.675662849757
"244.3.160.239",51612,"94.2.202.197",80,10,1875,6,1532,4,343,93.64366,0.1199579999999969,102169.09251571647,22874.67280214801
"244.3.160.239",51613,"94.2.202.197",80,10,1876,6,1533,4,343,93.643684,0.11958700000000988,102552.95308017582,22945.637903783634
"244.3.160.239",51614,"94.2.202.197",80,10,1875,6,1532,4,343,93.645087,0.119497999999993,102562.38598136135,22962.727409665105
"244.3.160.239",51615,"94.2.202.197",80,10,1877,6,1534,4,343,93.725956,0.11703900000000544,104853.93757635856,23445.176394192298
"244.3.160.239",51616,"94.2.202.197",80,10,1879,6,1536,4,343,93.752335,0.11782399999999882,104291.14611624222,23288.97338403065
"244.3.160.239",51617,"94.2.202.197",80,10,1877,6,1534,4,343,93.758219,0.12233299999999758,100316.34963583206,22430.57882991551
"244.3.160.239",51618,"94.2.202.197",80,10,1878,6,1535,4,343,93.758416,0.1216050000000024,100982.68985650061,22564.861642201766
"244.3.160.239",51619,"43.106.84.231",80,11,1605,6,1169,5,436,93.774226,0.10336399999999912,90476.3747532998,33744.82411671404
"244.3.160.239",51620,"94.2.202.197",80,10,1878,6,1535,4,343,93.811702,0.1167429999999996,105188.31964229155,23504.6212620886
"244.3.160.239",51621,"94.2.202.197",80,10,1875,6,1532,4,343,93.838532,0.11808399999999608,103790.52200129066,23237.69520002787
"244.3.160.239",51622,"43.106.84.231",80,11,1601,6,1165,5,436,94.073073,0.10360500000000172,89957.04840499826,33666.3288451324
"244.3.160.239",51623,"43.106.84.231",80,11,1598,6,1162,5,436,94.100645,0.10247400000000084,90715.69373694716,34037.902297167784
"244.3.160.239",51624,"43.106.84.231",80,11,1600,6,1164,5,436,94.15007,0.10454400000000419,89072.5436179946,33363.94245485021
"244.3.160.239",51625,"43.106.84.231",80,11,1602,6,1166,5,436,94.236158,0.1057349999999957,88220.5513784497,32988.13070412013
"244.3.160.239",51626,"43.106.84.231",80,11,1609,6,1173,5,436,94.418993,0.103675999999993,90512.75126355795,33643.273274434156
"244.3.160.239",51627,"43.106.84.231",80,11,1606,6,1170,5,436,94.498953,0.10350200000000598,90433.03511042743,33699.83188730458
"244.3.160.239",51628,"43.106.84.231",80,11,1607,6,1171,5,436,94.581071,0.1032160000000033,90761.12230661622,33793.21035498264
"244.3.160.239",51629,"43.106.84.26",80,22,11390,10,1428,12,9962,94.668696,0.2582969999999989,44228.15595999973,308544.04038761713
"244.3.160.239",51630,"40.248.176.156",80,165,196997,26,2954,139,194043,94.866479,1.7641449999999992,13395.724274365208,879941.2746684658
"244.3.160.239",51631,"43.106.84.231",80,11,1612,6,1176,5,436,94.906516,0.10314000000001045,91215.82315298669,33818.11130501887
"244.3.160.239",51632,"43.106.84.231",80,11,1607,6,1171,5,436,94.984036,0.10456800000000044,89587.63675311721,33356.28490551589
"244.3.160.239",51633,"43.106.84.231",80,11,1607,6,1171,5,436,95.064979,0.1054420000000107,88845.05225620768,33079.79742417297
"244.3.160.239",51634,"43.106.84.231",80,14,4279,7,1179,7,3100,95.145831,0.10653499999999383,88534.284507444,232787.3468813201
"244.3.160.239",51635,"43.106.84.231",80,11,1593,6,1157,5,436,95.146744,0.10504000000000246,88118.81188118605,33206.397562832426
"244.3.160.239",51636,"43.106.84.231",80,11,1592,6,1156,5,436,95.224704,0.1037680000000023,89121.88728702292,33613.445378150514
"244.3.160.239",51637,"43.106.84.231",80,11,1596,6,1160,5,436,95.225848,0.1050599999999946,88330.47782220138,33200.076146965344
"244.3.160.239",51638,"43.106.84.231",80,11,1603,6,1167,5,436,95.300376,0.10273200000000315,90877.2339679916,33952.41988864125
"244.3.160.239",51639,"43.106.84.231",80,11,1606,6,1170,5,436,95.386742,0.1144079999999974,81812.46066708807,30487.378505000343
"244.3.160.239",51640,"43.106.84.231",80,11,1596,6,1160,5,436,95.481649,0.1030099999999976,90088.34093777512,33860.79021454306
"244.3.160.239",51641,"43.106.84.231",80,11,1595,6,1159,5,436,95.582733,0.10473100000000102,88531.57135900459,33304.37024376704
"244.3.160.239",51642,"43.106.84.231",80,11,1613,6,1177,5,436,95.584002,0.10514100000000326,89555.92965636344,33174.499006095546
"244.3.160.239",51643,"43.106.84.231",80,11,1620,6,1184,5,436,95.659535,0.1039779999999979,91096.19342553416,33545.55771413251
"244.3.160.239",51644,"43.106.84.231",80,11,1618,6,1182,5,436,95.66297,0.104818999999992,90212.65228632902,33276.409811200894
"244.3.160.239",51645,"43.106.84.231",80,26,17217,11,1476,15,15741,95.735656,0.3514059999999972,33602.15818739604,358354.7235960712
"244.3.160.239",51646,"43.106.84.231",80,11,1618,6,1182,5,436,95.739973,0.10572799999999916,89437.04600484333,32990.31476997605
"244.3.160.239",51647,"43.106.84.231",80,11,1620,6,1184,5,436,95.817531,0.10655099999999607,88896.39703053326,32735.497555162587
"244.3.160.239",51648,"43.106.84.231",80,11,1626,6,1190,5,436,95.896107,0.10491500000000542,90740.12295667453,33245.9610160589
"244.3.160.239",51649,"43.106.84.231",80,11,1606,6,1170,5,436,95.973586,0.10496700000000203,89170.88227728542,33229.491173415765
"244.3.160.239",51650,"43.106.84.231",80,11,1595,6,1159,5,436,96.05059,0.10310400000000186,89928.61576660298,33829.91930477903
"244.3.160.239",51651,"43.106.84.231",80,11,1620,6,1184,5,436,96.126155,0.1036810000000088,91357.14354606144,33641.65083284019
"244.3.160.239",51652,"43.106.84.108",80,13,5300,7,1101,6,4199,96.136479,0.1372830000000107,64159.43707523374,244691.62241499225
"244.3.160.239",51653,"94.2.202.203",80,15,5497,9,2707,6,2790,96.165174,0.1256050000000073,172413.5185701106,177699.9323275244
"244.3.160.239",51654,"43.106.84.231",80,11,1604,6,1168,5,436,96.169476,0.10344700000000273,90326.44735951505,33717.7491855724
"244.3.160.239",51655,"43.106.84.231",80,11,1611,6,1175,5,436,96.201893,0.10276199999999847,91473.50187812753,33942.507930947744
"244.3.160.239",51656,"43.106.84.231",80,11,1604,6,1168,5,436,96.244874,0.10477699999999857,89179.87726314102,33289.748704391684
"244.3.160.239",51657,"94.2.202.203",80,13,3952,8,2655,5,1297,96.257446,0.14641699999999958,145065.12221941483,70866.08795426782
"244.3.160.239",51658,"43.106.84.231",80,11,1598,6,1162,5,436,96.276424,0.10308999999999457,90173.63468814132,33834.51353186714
"244.3.160.239",51659,"94.2.202.203",80,13,5219,8,4076,5,1143,96.306175,0.15494300000000294,210451.58542173175,59015.25076963675
"244.3.160.239",51660,"43.106.84.231",80,11,1603,6,1167,5,436,96.321914,0.10355500000000006,90154.99010187817,33682.58413403503
"244.3.160.239",51661,"43.106.84.231",80,11,1603,6,1167,5,436,96.351443,0.10381199999999069,89931.79979193963,33599.198551230234
"244.3.160.239",51662,"244.3.31.108",80,49,40800,19,2144,30,38656,96.377111,1.6534110000000055,10373.706235170774,187036.3751057656
"244.3.160.239",51663,"43.106.84.231",80,11,1601,6,1165,5,436,96.398426,0.10371399999999653,89862.5065082854,33630.94664172741
"244.3.160.239",51664,"43.106.84.231",80,11,1606,6,1170,5,436,96.427715,0.10522399999999266,88953.09054969069,33148.33117920098
"244.3.160.239",51665,"43.106.84.231",80,11,1606,6,1170,5,436,96.475094,0.10379299999999603,90179.49187325117,33605.349108322655
"244.3.160.239",51666,"43.106.84.231",80,11,1619,6,1183,5,436,96.505204,0.10319999999998686,91705.42635660083,33798.44961240741
"244.3.160.239",51667,"94.2.202.203",80,208,195212,72,5715,136,189497,96.547107,1.613826000000003,28330.191730706974,939367.6889577917
"244.3.160.239",51668,"43.106.84.231",80,11,1607,6,1171,5,436,96.550802,0.10319599999999696,90778.71235319466,33799.759680608775
"244.3.160.239",51669,"43.106.84.231",80,14,4280,7,1180,7,3100,96.580543,0.2399069999999881,39348.5809084373,103373.39052216579
"244.3.160.239",51670,"43.106.84.231",80,11,1612,6,1176,5,436,96.626405,0.10284000000000049,91481.91365227495,33916.76390509513
"244.3.160.239",51671,"40.248.176.156",80,13,2924,7,1454,6,1470,96.626652,0.33581799999998907,34637.80976600533,35018.968607997136
"244.3.160.239",51672,"43.106.84.231",80,11,1609,6,1173,5,436,96.685122,0.10390299999998831,90315.00534153062,33569.771806400124
"244.3.160.239",51673,"43.106.84.231",80,11,1616,6,1180,5,436,96.703021,0.10389099999999019,90864.46371678867,33573.64930552531
"244.3.160.239",51674,"43.106.84.231",80,11,1605,6,1169,5,436,96.761299,0.10312600000000316,90685.18123460343,33822.70232530975
"244.3.160.239",51675,"43.106.84.231",80,11,1604,6,1168,5,436,96.778244,0.103904,89929.16538343087,33569.44872189713
"244.3.160.239",51676,"43.106.84.231",80,11,1606,6,1170,5,436,96.837061,0.1045999999999907,89483.74760995059,33346.08030593031
"244.3.160.239",51677,"43.106.84.231",80,11,1605,6,1169,5,436,96.854247,0.10315400000000352,90660.56575605096,33813.521530913786
"244.3.160.239",51678,"244.3.85.248",8080,5,330,5,330,0,0,97.03771,50.61857499999999,52.154767296392684,0
"244.3.160.239",51679,"43.106.84.108",80,10,1411,6,1021,4,390,97.247548,0.1037990000000093,78690.54615168998,30058.093045209687
"244.3.160.239",51680,"43.106.84.108",80,10,1406,6,1016,4,390,97.661134,0.10251199999999017,79288.2784454579,30435.461214299783
"244.3.160.239",51681,"43.106.84.108",80,10,1409,6,1019,4,390,97.667718,0.10206300000000113,79872.23577594143,30569.354222391714
"244.3.160.239",51682,"43.106.84.231",80,11,1607,6,1171,5,436,97.686719,0.10304800000000114,90909.09090908991,33848.303703128266
"244.3.160.239",51683,"94.2.202.197",80,10,1702,6,1359,4,343,97.817898,0.11770900000000495,92363.37068533029,23311.726376062023
"244.3.160.239",51684,"94.2.202.197",80,10,1701,6,1358,4,343,97.825388,0.11726500000000328,92644.86419647546,23399.99147230566
"244.3.160.239",51685,"94.2.202.197",80,10,1708,6,1365,4,343,97.830308,0.11781499999999312,92687.68832492159,23290.752450877735
"244.3.160.239",51686,"94.2.202.197",80,10,1825,6,1364,4,461,97.835864,0.11792699999999456,92531.82053304589,31273.584505670202
"244.3.160.239",51687,"94.2.202.203",80,33,24081,14,1817,19,22264,97.844641,0.23936799999999891,60726.57999398444,744092.7776478092
"244.3.160.239",51688,"198.123.241.156",80,35,27884,14,2018,21,25866,97.901839,0.5277540000000016,30590.00973938606,392091.77002921695
"244.3.160.239",51689,"94.2.202.197",80,10,2868,6,1271,4,1597,97.986314,0.2457910000000112,41368.479724642224,51979.12047226879
"244.3.160.239",51690,"94.2.202.197",80,10,1685,6,1341,4,344,97.991059,0.12020899999998846,89244.5657147221,22893.460556200152
"244.3.160.239",51691,"94.2.202.197",80,10,1833,6,1263,4,570,97.994965,0.23769300000000726,42508.614052579134,19184.410142494144
"244.3.160.239",51695,"244.3.31.108",80,11,1849,6,1423,5,426,98.137525,0.005664000000010105,2009887.0056461317,601694.9152531638
"244.3.160.239",51696,"244.3.31.108",80,11,1842,6,1416,5,426,98.149144,0.014046999999990817,806435.5378377879,242614.0812986565
"244.3.160.239",51697,"244.3.31.108",80,11,1848,6,1421,5,427,98.168893,0.005224999999995816,2175693.7799060484,653779.9043067435
"244.3.160.239",51698,"244.3.31.108",80,11,1846,6,1420,5,426,98.180503,0.021840999999994892,520122.70500447124,156036.81150134138
"244.3.160.239",51699,"244.3.31.108",80,11,1848,6,1422,5,426,98.209779,0.021517000000002895,528698.2386019644,158386.3921550189
"244.3.160.239",51702,"94.2.202.197",80,54,44585,21,2252,33,42333,98.275205,0.28168499999999597,63957.96723290292,1202279.1415943513
"244.3.160.239",51704,"94.2.202.197",80,21,12992,10,1542,11,11450,98.284666,0.19929600000000391,61897.88053949782,459617.8548490597
"244.3.160.239",51705,"94.2.202.197",80,12,3210,7,1343,5,1867,98.291011,0.12035400000000607,89269.98687205625,124100.56998520404
"244.3.160.239",51707,"94.2.202.197",80,10,1709,6,1365,4,344,98.295764,0.11834399999999334,92273.3725410719,23254.241871156584
"244.3.160.239",51713,"244.3.31.108",80,11,1849,6,1424,5,425,98.33189,0.009551999999999339,1192629.8157454762,355946.39865999116
"244.3.160.239",51714,"244.3.31.108",80,11,1856,6,1430,5,426,98.335555,0.003632999999993558,0,0
"244.3.160.239",51715,"43.106.84.108",80,36,28703,15,1594,21,27109,98.33705,0.21449099999999532,59452.3779552535,1011100.6988638438
"244.3.160.239",51716,"94.2.202.197",80,16,7956,8,1410,8,6546,98.402642,0.16391899999999282,68814.47544214212,319474.8625845832
"244.3.160.239",51717,"94.2.202.197",80,12,4275,7,1353,5,2922,98.406725,0.12005400000001032,90159.42825727648,194712.3794292401
"244.3.160.239",51718,"198.123.241.156",80,11,1985,6,1541,5,444,98.413275,0.1988580000000013,61993.985658107384,17861.991974172408
"244.3.160.239",51719,"94.2.202.197",80,10,2461,6,1301,4,1160,98.477921,0.12228199999999845,85114.73479334761,75890.15554210855
"244.3.160.239",51720,"43.106.84.108",80,10,2402,6,1248,4,1154,98.548365,0.1576819999999941,63317.309521697935,58548.2172981085
"244.3.160.239",51721,"94.2.202.197",80,12,3843,7,1366,5,2477,98.560495,0.11910499999999047,91750.97602956109,166374.20763193473
"244.3.160.239",51722,"94.2.202.197",80,12,3859,7,1349,5,2510,98.62678,0.12017000000000166,89806.1080136461,167096.61313139487
"244.3.160.239",51723,"94.2.202.197",80,10,2833,6,1280,4,1553,98.645502,0.22979600000000744,44561.263033297655,54065.344914618174
"244.3.160.239",51724,"94.2.202.197",80,10,1694,6,1351,4,343,98.675615,0.11920000000000641,90671.14093959244,23020.134228186682
"244.3.160.239",51725,"43.106.84.108",80,10,1424,6,1024,4,400,98.695034,0.10208199999999579,80249.21141827489,31347.348210263634
"244.3.160.239",51726,"43.106.84.108",80,10,1404,6,1014,4,390,98.700552,0.10292799999999147,78812.37369812561,30312.451422356
"244.3.160.239",51727,"43.106.84.108",80,10,1407,6,1017,4,390,98.769981,0.10455299999999568,77816.99233881703,29841.324495711542
"244.3.160.239",51728,"43.106.84.108",80,10,1403,6,1013,4,390,98.776438,0.10224100000000647,79263.7004724082,30516.13344939704
"244.3.160.239",51729,"43.106.84.108",80,10,1409,6,1019,4,390,98.847021,0.10227899999999579,79703.5559596822,30504.795705864628
"244.3.160.239",51730,"43.106.84.108",80,10,1427,6,1027,4,400,98.861421,0.1018579999999929,80661.31280803248,31416.285416955205
"244.3.160.239",51731,"94.2.202.197",80,11,4055,7,1371,4,2684,98.903814,0.13342199999999593,82205.3334532561,160932.9795685918
"244.3.160.239",51732,"94.2.202.197",80,10,1685,6,1341,4,344,98.910165,0.12066999999998984,88903.62144692884,22805.99983426064
"244.3.160.239",51733,"43.106.84.108",80,10,1407,6,1017,4,390,98.921156,0.10256600000001015,79324.53249614098,30419.437240408042
"244.3.160.239",51734,"94.2.202.197",80,10,1702,6,1359,4,343,98.93593,0.1416499999999985,76752.55912460371,19371.690787151634
"244.3.160.239",51735,"43.106.84.108",80,10,1409,6,1019,4,390,98.936252,0.103194000000002,78996.84090160127,30234.315948601074
"244.3.160.239",51736,"94.2.202.197",80,10,1694,6,1351,4,343,98.941795,0.1345409999999987,80332.3893831628,20395.269843393664
"244.3.160.239",51737,"94.2.202.197",80,10,1691,6,1348,4,343,99.017733,0.11707899999998972,92108.74708530947,23437.166357760496
"244.3.160.239",51738,"94.2.202.197",80,10,1698,6,1354,4,344,99.021028,0.11786100000000488,91904.87099209706,23349.53886357562
"244.3.160.239",51739,"43.106.84.108",80,10,1536,6,973,4,563,99.033267,0.1261259999999993,61716.06171606206,35710.32142460734
"244.3.160.239",51740,"94.2.202.197",80,10,1692,6,1349,4,343,99.06975,0.11709600000000364,92163.6947461883,23433.76374940147
"244.3.160.239",51741,"94.2.202.197",80,10,1831,6,1271,4,560,99.072753,0.3134709999999927,32436.812336708135,14291.593161728211
"244.3.160.239",51742,"94.2.202.197",80,10,1834,6,1273,4,561,99.125614,0.25976199999999494,39205.11853157967,17277.353885480123
"244.3.160.239",51743,"94.2.202.197",80,10,1937,6,1270,4,667,99.130536,0.25494399999999473,39851.88904230031,20930.086607255358
"244.3.160.239",51744,"94.2.202.197",80,10,1894,6,1277,4,617,99.180617,0.3145240000000058,32480.828172094378,15693.555976650141
"244.3.160.239",51745,"94.2.202.197",80,10,1692,6,1348,4,344,99.271721,0.1182940000000059,91162.69633286103,23264.070874261273
"244.3.160.239",51746,"94.2.202.197",80,10,1694,6,1350,4,344,99.2761,0.11816500000000474,91397.62196927657,23289.468116615662
"244.3.160.239",51747,"94.2.202.197",80,10,2604,6,1264,4,1340,99.276145,0.3289999999999935,30735.562310031,32583.58662614046
"244.3.160.239",51748,"94.2.202.197",80,10,1951,6,1273,4,678,99.40736,0.3079180000000008,33073.740411408144,17615.079339304575
"244.3.160.239",51749,"94.2.202.197",80,10,1832,6,1273,4,559,99.411188,0.3045150000000092,33443.34433443243,14685.647669244094
"244.3.160.239",51750,"94.2.202.197",80,10,2609,6,1264,4,1345,99.411577,0.3045500000000061,33203.08652109603,35330.81595797007
"244.3.160.239",51751,"43.106.84.108",80,10,2402,6,1248,4,1154,99.414672,0.13898799999999767,71833.53958615253,66423.00054681092
"244.3.160.239",51752,"94.2.202.197",80,10,1955,6,1273,4,682,99.502591,0.3226270000000113,31565.863985344196,16911.16986488982
"244.3.160.239",51753,"94.2.202.197",80,10,1941,6,1273,4,668,99.606103,0.26846599999998944,37934.040064665176,19905.68638114402
"244.3.160.239",51754,"94.2.202.197",80,10,2863,6,1277,4,1586,99.606242,0.268455000000003,38054.795030824105,47263.042223090866
"244.3.160.239",51755,"94.2.202.197",80,10,2607,6,1273,4,1334,99.708416,0.2687209999999993,37898.04295161162,39714.052865239515
"244.3.160.239",51756,"43.106.84.108",80,12,2701,7,1637,5,1064,99.811873,0.11890599999999552,110137.41947421066,71585.95865642038
"244.3.160.239",51757,"94.2.202.197",80,10,1895,6,1272,4,623,99.816645,0.26894300000000726,37837.01379102533,18531.80785519558
"244.3.160.239",51758,"94.2.202.197",80,10,1892,6,1272,4,620,99.820627,0.26532100000000014,38353.54155909255,18694.33629452624
"244.3.160.239",51759,"94.2.202.197",80,10,2438,6,1277,4,1161,99.824967,0.2616029999999938,39051.53992882437,35504.17999793664
"244.3.160.239",51760,"94.2.202.197",80,10,2067,6,1277,4,790,99.878816,0.2085090000000065,48995.48700535556,30310.442235106413
"244.3.160.239",51761,"43.106.84.231",80,14,4535,7,1435,7,3100,99.954971,0.10585999999999274,108445.11619120336,234271.67957681563
"244.3.160.239",51762,"94.2.202.197",80,12,3602,7,1338,5,2264,99.969582,0.22588899999999512,47386.10556512372,80180.97384113609
"244.3.160.239",51763,"94.2.202.197",80,10,1952,6,1271,4,681,99.974625,0.3141109999999969,32370.722451617738,17344.187245910056
"244.3.160.239",51764,"94.2.202.197",80,12,3701,7,1340,5,2361,99.978585,0.31084200000000806,34486.97408972958,60763.98942227727
"244.3.160.239",51765,"43.106.84.231",80,11,1572,6,1136,5,436,100.035894,0.10362600000000555,87699.99806997774,33659.50630150554
"244.3.160.239",51766,"43.106.84.231",80,11,1581,6,1145,5,436,100.039937,0.10269000000000972,89200.50637841204,33966.30635894118
"244.3.160.239",51767,"94.2.202.197",80,10,2151,6,1277,4,874,100.082597,0.3126829999999927,32672.067237426523,22361.305219663886
"244.3.160.239",51768,"94.2.202.197",80,10,2707,6,1265,4,1442,100.086567,0.30911999999999296,32738.095238095982,37318.840579710995
"244.3.160.239",51769,"94.2.202.197",80,12,3985,7,1335,5,2650,100.200618,0.30487199999998893,35031.09501692641,69537.37962161422
"244.3.160.239",51770,"94.2.202.197",80,10,2800,6,1273,4,1527,100.204598,0.3009649999999908,33837.82167361757,40589.43730998745
"244.3.160.239",51771,"43.106.84.108",80,20,9216,11,8091,9,1125,100.238,0.1847970000000032,350265.4263867859,48702.08931963097
"244.3.160.239",51772,"94.2.202.197",80,10,1692,6,1348,4,344,100.286151,0.11757399999999052,91720.95871536963,23406.535458521626
"244.3.160.239",51773,"94.2.202.197",80,13,2877,7,1103,6,1774,100.404326,0.281526999999997,31343.352502602218,50410.7954121635
"244.3.160.239",51774,"43.106.84.231",80,14,4535,7,1435,7,3100,100.423159,0.10720899999999745,107080.5622662302,231323.8627354102
"244.3.160.239",51775,"43.106.84.231",80,11,1572,6,1136,5,436,100.540226,0.10366899999999646,87663.62171912829,33645.544955580925
"244.3.160.239",51776,"43.106.84.231",80,11,1581,6,1145,5,436,100.545907,0.10291599999999335,89004.6251311807,33891.71751720068
"244.3.160.239",51777,"94.2.202.203",80,19,8896,12,7629,7,1267,102.140247,0.3911909999999921,156015.85926056898,25910.616553039832
"244.3.160.239",51778,"94.2.202.203",80,311,296074,107,8641,204,287433,102.535687,1.8810140000000075,36750.39101250694,1222459.8009371492
"244.3.160.239",51779,"94.2.202.203",80,35,25003,15,2675,20,22328,103.94022,0.9791200000000089,21856.36081379178,182433.20532723097
"244.3.160.239",51780,"94.2.202.197",80,56,45507,22,3110,34,42397,103.948793,0.2814170000000047,88409.72649129081,1205243.4643251628
"244.3.160.239",51781,"94.2.202.197",80,23,13914,11,2400,12,11514,103.964294,0.1990600000000029,96453.33065407275,462734.853812914
"244.3.160.239",51782,"94.2.202.197",80,14,5197,8,2211,6,2986,103.965468,0.1206109999999967,146653.29033007342,198058.22022867444
"244.3.160.239",51783,"94.2.202.197",80,12,3384,7,2159,5,1225,103.97625,0.12011000000001104,143801.51527764893,81591.87411538672
"244.3.160.239",51784,"94.2.202.197",80,14,4765,8,2224,6,2541,103.982374,0.11980700000000866,148505.51303345143,169672.8905656475
"244.3.160.239",51785,"94.2.202.197",80,14,4781,8,2207,6,2574,103.990032,0.1193010000000072,147995.40657663334,172605.42660999284
"244.3.160.239",51786,"198.123.241.156",80,25,15845,11,1436,14,14409,104.85636,0.4609080000000034,24924.71382575246,250097.6333671777
"244.3.160.239",51787,"209.194.122.188",80,10,1671,6,1096,4,575,105.065894,0.265782999999999,32989.31835369468,17307.35223848033
"244.3.160.239",51788,"94.2.202.197",80,12,3820,7,2159,5,1661,105.115167,0.32162700000000655,53701.95910169124,41314.939355214985
"244.3.160.239",51789,"94.2.202.197",80,14,4375,8,2217,6,2158,105.120388,0.31526999999999816,56256.542011609425,54759.41256700638
"244.3.160.239",51790,"94.2.202.197",80,12,2786,7,2151,5,635,105.126188,0.3101170000000053,55488.73489682831,16380.91430008646
"244.3.160.239",51791,"94.2.202.197",80,14,4453,8,2279,6,2174,105.154557,0.2822869999999966,64586.75036399203,61611.05541523417
"244.3.160.239",51792,"94.2.202.197",80,14,4458,8,2288,6,2170,105.160048,0.27681499999999915,66123.5843433342,62713.364521431475
"244.3.160.239",51793,"94.2.202.197",80,14,4559,8,2288,6,2271,105.168697,0.37655300000000125,48609.35910748272,48248.18817005824
"244.3.160.239",51794,"198.123.241.156",80,73,65584,27,2487,46,63097,105.30227,0.7322250000000139,27171.97582710181,689372.8020758516
"244.3.160.239",51795,"94.2.202.197",80,14,4852,8,2288,6,2564,105.337095,0.2543629999999979,71960.15143711999,80640.65921537398
"244.3.160.239",51796,"94.2.202.197",80,14,4753,8,2288,6,2465,105.342615,0.24959200000000692,73335.68383601835,79008.94259431172
"244.3.160.239",51797,"94.2.202.197",80,14,4273,8,2287,6,1986,105.354304,0.23826099999999428,76789.73898372137,66683.17517344585
"244.3.160.239",51798,"94.2.202.197",80,14,4652,8,2287,6,2365,105.360403,0.23247200000000134,78701.95120272503,81386.14542826616
"244.3.160.239",51799,"94.2.202.197",80,14,4266,8,2287,6,1979,105.387997,0.307659000000001,59468.437458354674,51459.57049850629
"244.3.160.239",51800,"94.2.202.197",80,14,4764,8,2287,6,2477,105.422212,0.27301299999999173,67015.12382194458,72582.62427064132
"244.3.160.239",51801,"94.2.202.197",80,14,5162,8,2287,6,2875,105.550063,0.18933200000000738,96634.48334142822,121479.72873047928
"244.3.160.239",51802,"94.2.202.197",80,14,4501,8,2287,6,2214,105.556254,0.19293000000000404,94832.3226040513,91805.31799097927
"244.3.160.239",51803,"94.2.202.197",80,12,2636,7,2011,5,625,105.560109,0.1788450000000097,89954.98895691313,27957.169616146548
"244.3.160.239",51804,"94.2.202.197",80,12,2739,7,2008,5,731,105.565746,0.17405300000000068,92293.72662349937,33598.961235945244
"244.3.160.239",51805,"94.2.202.197",80,12,2753,7,2011,5,742,105.61093,0.13826199999999744,116358.79706644123,42932.98230895047
"244.3.160.239",51806,"94.2.202.197",80,12,2758,7,2011,5,747,105.61681,0.13279799999999398,121146.4028072767,45000.67772105206
"244.3.160.239",51808,"94.2.202.197",80,14,5041,8,2229,6,2812,105.683431,0.11935700000000793,149400.53788214194,188476.5870455734
"244.3.160.239",51809,"94.2.202.197",80,12,2742,7,2011,5,731,105.698422,0.15462700000000495,104043.92505836293,37820.04436482511
"244.3.160.239",51810,"94.2.202.197",80,12,3815,7,2165,5,1650,105.702645,0.15061299999999278,114996.71343111704,87641.83702602453
"244.3.160.239",51811,"94.2.202.197",80,12,3409,7,2011,5,1398,105.744155,0.1214779999999962,132435.50272477735,92066.05311250061
"244.3.160.239",51812,"94.2.202.197",80,12,2696,7,2010,5,686,105.749696,0.1192089999999979,134889.1442760218,46036.7925240552
"244.3.160.239",51813,"94.2.202.197",80,12,3235,7,2010,5,1225,105.753945,0.15576599999999985,103231.77073302271,62914.88514823523
"244.3.160.239",51814,"94.2.202.197",80,12,2869,7,2015,5,854,105.804464,0.3209710000000001,50222.60578058452,21285.41207772664
"244.3.160.239",51815,"94.2.202.197",80,14,3842,8,2074,6,1768,105.861857,0.26327899999999715,63020.597920837514,53722.47691612378
"244.3.160.239",51816,"94.2.202.197",80,14,3846,8,2075,6,1771,105.866031,0.25986299999999574,63879.813594087165,54521.03608439921
"244.3.160.239",51817,"94.2.202.197",80,14,3960,8,2079,6,1881,105.871415,0.25480299999999545,65273.95674305364,59057.38943419139
"244.3.160.239",51818,"94.2.202.197",80,12,3602,7,2011,5,1591,105.875861,0.2505560000000031,64209.198741997,50799.02297290762
"244.3.160.239",51820,"198.123.241.156",80,11,1662,6,1218,5,444,105.922194,0.19955799999999613,48827.909680394616,17799.33653373991
"244.3.160.239",51821,"57.255.139.77",80,17,9803,8,1053,9,8750,106.281352,0.15697000000000116,53666.30566350218,445945.08504809503
"244.3.160.239",51822,"57.255.139.77",80,18,9577,9,1172,9,8405,106.384972,0.14880899999999997,63006.9417844351,451854.3905274547
"244.3.160.239",51823,"57.255.139.77",80,10,2627,6,961,4,1666,106.386061,0.1103650000000016,69659.76532415066,120762.92302813217
"244.3.160.239",51824,"57.255.139.77",80,21,12197,10,1223,11,10974,106.510697,0.18221900000000346,53693.632387400954,481793.88537967135
"244.3.160.239",51825,"57.255.139.77",80,10,2291,6,1202,4,1089,106.877864,0.2064019999999971,46588.69584597114,42208.89332467768
"244.3.160.239",51826,"57.255.139.77",80,13,5248,7,1253,6,3995,106.88049,0.2038000000000011,49185.47595682015,156820.4121687921
"244.3.160.239",51827,"57.255.139.77",80,10,2336,6,1197,4,1139,106.881696,0.20280199999999127,47218.46924586746,44930.52336762159
"244.3.160.239",51828,"57.255.139.77",80,24,16636,11,1515,13,15121,106.88266,0.3101209999999952,39081.519793887506,390067.1028405102
"244.3.160.239",51829,"57.255.139.77",80,12,3189,7,1260,5,1929,106.883902,0.2005319999999955,50266.29166417443,76955.29890491466
"244.3.160.239",51830,"57.255.139.77",80,15,6542,8,1319,7,5223,106.885985,0.19860999999998796,53129.248275518046,210382.15598410217
"244.3.160.239",51831,"57.255.139.77",80,18,9392,9,1386,9,8006,107.061617,0.27110799999999813,40898.829986573895,236245.3339628504
"244.3.160.239",51832,"57.255.139.77",80,18,10342,9,1383,9,8959,107.062501,0.16589700000000107,66691.9835801728,432027.1011531223
"244.3.160.239",51833,"57.255.139.77",80,18,9372,9,1389,9,7983,107.063935,0.16561599999999999,67094.96666988697,385614.9164331949
"244.3.160.239",51834,"57.255.139.77",80,10,2412,6,1199,4,1213,107.067398,0.1276110000000017,75165.93397120837,76043.60125694392
"244.3.160.239",51835,"57.255.139.77",80,10,2277,6,1197,4,1080,107.069014,0.1259990000000073,76000.60317938591,68571.97279343089
"244.3.160.239",51836,"57.255.139.77",80,10,2238,6,1194,4,1044,107.070387,0.12476200000000404,76561.77361696423,66943.46034850138
"244.3.160.239",51837,"57.255.139.77",80,10,2722,6,1199,4,1523,107.167596,0.2756569999999954,34796.86712109673,44199.857068749225
"244.3.160.239",51838,"57.255.139.77",80,10,1882,6,1199,4,683,107.168524,0.27497999999999934,34882.53691177549,19870.5360389847
"244.3.160.239",51839,"57.255.139.77",80,10,1761,6,1214,4,547,107.1695,0.2743650000000031,35398.101069742464,15949.556248063533
"244.3.160.239",51840,"57.255.139.77",80,10,2741,6,1215,4,1526,107.189925,0.2543809999999951,38210.40093403276,47991.00561755884
"244.3.160.239",51841,"57.255.139.77",80,10,2746,6,1216,4,1530,107.201274,0.24146000000000356,40288.24650045497,50691.62594218429
"244.3.160.239",51842,"57.255.139.77",80,10,2697,6,1137,4,1560,107.336514,0.32603800000001115,27898.58850808706,38277.74676571312
"244.3.160.239",51843,"241.161.4.128",80,12,2557,7,1937,5,620,108.822743,0.25085199999999475,61773.475993814376,19772.614928324685
"244.3.160.239",51844,"198.123.241.156",80,83,70984,32,2936,51,68048,109.567236,1.5004870000000068,15653.584469575473,362804.8760169182
"244.3.160.239",51845,"241.161.4.128",80,12,2550,7,1930,5,620,109.656041,0.24938299999999458,61912.80079235688,19889.08626490221
"244.3.160.239",51846,"57.255.139.77",80,24,15920,11,1531,13,14389,109.664909,0.4783350000000013,25605.485695171727,240651.42630164986
"244.3.160.239",51847,"43.106.84.231",80,14,4359,7,1243,7,3116,109.680609,0.2318209999999965,42895.1648038795,107531.24177706237
"244.3.160.239",51848,"43.106.84.231",80,11,1605,6,1169,5,436,109.690556,0.1040789999999987,89854.82181804319,33513.004544625175
"244.3.160.239",51849,"57.255.139.77",80,18,9636,9,1400,9,8236,110.126962,0.1916299999999893,58445.963575643815,343829.2542921446
"244.3.160.239",51850,"57.255.139.77",80,10,2777,6,1227,4,1550,110.138522,0.18016599999999983,54483.08781901141,68825.41656028337
"244.3.160.239",51851,"57.255.139.77",80,10,2782,6,1228,4,1554,110.139215,0.1793530000000061,54774.66225822633,69315.81852547533
"244.3.160.239",51852,"57.255.139.77",80,10,2727,6,1167,4,1560,110.349146,0.13100899999999172,71262.27969071278,95260.6309490248
"244.3.160.239",51853,"177.202.64.15",80,100,93431,36,3436,64,89995,110.372987,0.6511810000000082,42212.53384235666,1105621.939215043
"244.3.160.239",51854,"57.255.139.77",80,10,2727,6,1167,4,1560,110.457097,0.23578700000000197,39595.05825172686,52929.126711819976
"244.3.160.239",51855,"241.161.4.128",80,12,3485,7,1700,5,1785,111.116103,0.19191000000000713,70866.55202959458,74409.8796310743
"244.3.160.239",51856,"241.161.4.128",80,12,2598,7,1978,5,620,111.30361,0.12465699999999913,126940.32424974217,39789.181514074895
"244.3.160.239",51857,"128.71.90.164",80,40,35571,14,2096,26,33475,111.944121,0.7711590000000115,21743.89457945735,347269.49954548414
"244.3.160.239",51858,"198.123.241.156",80,12,1992,7,1548,5,444,111.997588,3.579494000000011,3459.7068747705575,992.3190260969816
"244.3.160.239",51859,"48.151.224.224",80,12,3351,7,1414,5,1937,112.029645,0.09639299999999196,117352.91981783889,160758.56130633233
"244.3.160.239",51860,"48.151.224.224",80,12,3064,7,1327,5,1737,112.162765,0.263969000000003,40216.843644518405,52642.545147346245
"244.3.160.239",51861,"43.106.84.231",80,128,122662,45,3977,83,118685,112.267331,0.7521320000000031,42301.08544776697,1262384.7941584669
"244.3.160.239",51862,"43.106.84.231",80,11,1639,6,1203,5,436,112.749098,0.10456299999999885,92040.20542639466,33357.879938410704
"244.3.160.239",51863,"43.106.84.231",80,11,1632,6,1196,5,436,112.955096,0.10511100000000795,91027.58036741422,33183.9674249102
"244.3.160.239",51864,"128.71.90.164",80,10,1705,6,1210,4,495,112.971899,0.2472580000000022,39149.39051517004,16015.659756205925
"244.3.160.239",51865,"43.106.84.231",80,11,1635,6,1199,5,436,113.008867,0.10372999999999877,92470.83775185687,33625.75918249341
"244.3.160.239",51866,"43.106.84.231",80,11,1634,6,1198,5,436,113.032266,0.10509699999998645,91191.94648754233,33188.38787025747
"244.3.160.239",51867,"43.106.84.231",80,11,1636,6,1200,5,436,113.113958,0.10548200000000918,91010.78857055388,33067.25318063458
"244.3.160.239",51868,"57.255.139.77",80,25,17712,11,1549,14,16163,113.171186,0.5699319999999943,21742.944772359024,226876.1887383079
"244.3.160.239",51869,"43.106.84.231",80,11,1643,6,1207,5,436,113.26041,0.10365200000001096,93157.87442595395,33651.06317292123
"244.3.160.239",51870,"43.106.84.231",80,11,1640,6,1204,5,436,113.338835,0.10436099999999726,92295.01442109843,33422.44708272335
"244.3.160.239",51871,"128.71.90.164",80,10,2928,6,1432,4,1496,113.414903,0.2449799999999982,46763.00106131147,48852.967589191314
"244.3.160.239",51872,"43.106.84.231",80,11,1641,6,1205,5,436,113.421237,0.10512699999999597,91698.61215482578,33178.916929048995
"244.3.160.239",51873,"43.106.84.26",80,22,11424,10,1462,12,9962,113.506726,0.21325299999999459,54845.65281613997,373715.7273285817
"244.3.160.239",51874,"94.2.202.98",80,10,2350,6,1387,4,963,113.640257,0.1335380000000015,83092.45308451435,57691.44363402113
"244.3.160.239",51875,"43.106.84.231",80,11,1646,6,1210,5,436,113.698281,0.10327800000000309,93727.60897770785,33772.923565521174
"244.3.160.239",51876,"57.255.139.77",80,10,2789,6,1239,4,1550,113.741722,0.23295000000000243,42549.903412749074,53230.30693281764
"244.3.160.239",51877,"57.255.139.77",80,10,2794,6,1240,4,1554,113.744716,0.2303399999999982,43066.77086046747,53972.38864287617
"244.3.160.239",51878,"43.106.84.231",80,11,1641,6,1205,5,436,113.775227,0.10318499999999631,93424.43184571735,33803.36289189441
"244.3.160.239",51879,"94.2.202.203",80,11,2737,6,1506,5,1231,113.841512,1.0321070000000105,11673.208301077191,9541.646360309443
"244.3.160.239",51880,"43.106.84.231",80,11,1641,6,1205,5,436,113.854882,0.10401699999999892,92677.15854139323,33532.9801859315
"244.3.160.239",51881,"43.106.84.231",80,14,4313,7,1213,7,3100,113.935128,0.10768600000000106,90113.84952547132,230299.20323904458
"244.3.160.239",51882,"43.106.84.231",80,11,1627,6,1191,5,436,113.935298,0.10404099999999517,91579.2812448981,33525.2448553951
"244.3.160.239",51883,"43.106.84.231",80,11,1626,6,1190,5,436,114.01105,0.10396900000000642,91565.75517701826,33548.461560655436
"244.3.160.239",51884,"43.106.84.231",80,11,1630,6,1194,5,436,114.016844,0.10443999999999676,91459.21103025945,33397.16583684516
"244.3.160.239",51885,"43.106.84.231",80,11,1637,6,1201,5,436,114.086546,0.10373900000000447,92617.04855454156,33622.84193986688
"244.3.160.239",51886,"43.106.84.231",80,11,1640,6,1204,5,436,114.180936,0.1034700000000015,93089.78447859148,33710.25417995505
"244.3.160.239",51887,"43.106.84.231",80,11,1630,6,1194,5,436,114.27291,0.10308100000000309,92664.99160853808,33837.46762254825
"244.3.160.239",51888,"41.177.254.197",80,80,65787,30,3790,50,61997,114.323239,1.480953999999997,20473.28951473176,334903.04222818604
"244.3.160.239",51889,"43.106.84.231",80,11,1647,6,1211,5,436,114.387348,0.11372399999999061,85188.70247266012,30670.746720131967
"244.3.160.239",51890,"241.161.4.128",80,12,2572,7,1952,5,620,114.390882,0.16769499999999482,93121.44071081716,29577.506783148892
"244.3.160.239",51891,"43.106.84.231",80,11,1629,6,1193,5,436,114.396062,0.10634500000000457,89745.63919318811,32798.90921058677
"244.3.160.239",51892,"43.106.84.231",80,11,1652,6,1216,5,436,114.476484,0.10438299999999856,93195.2521004391,33415.40289127586
"244.3.160.239",51893,"43.106.84.231",80,11,1654,6,1218,5,436,114.485003,0.10598299999999483,91939.27327968141,32910.93854674967
"244.3.160.239",51894,"43.106.84.231",80,11,1652,6,1216,5,436,114.552761,0.1046180000000021,92985.91064634963,33340.342962013514
"244.3.160.239",51895,"43.106.84.231",80,11,1654,6,1218,5,436,114.574087,0.10361799999999732,94037.71545484618,33662.105039665796
"244.3.160.239",51896,"43.106.84.231",80,11,1660,6,1224,5,436,114.630208,0.10348100000000215,94626.06662092361,33706.67078980612
"244.3.160.239",51897,"43.106.84.231",80,16,6042,8,1377,8,4665,114.652326,0.44781000000000404,24599.718630669035,83338.91605814891
"244.3.160.239",51898,"128.71.90.164",80,10,1703,6,1212,4,491,114.700042,0.24881000000000597,38969.49479522434,15787.146818857384
"244.3.160.239",51899,"43.106.84.231",80,15,4750,8,1377,7,3373,114.70585,0.5044040000000081,21839.63648186736,53496.80018397865
"244.3.160.239",51900,"94.2.202.203",80,78,67020,29,3250,49,63770,114.870795,0.4113490000000013,63206.66878976227,1240212.0826840429
"244.3.160.239",51901,"43.106.84.231",80,28,18828,12,1619,16,17209,114.965917,0.5065060000000017,25571.26667798596,271807.24413925904
"244.3.160.239",51902,"94.2.202.197",80,10,1977,6,1634,4,343,115.060632,0.11724900000000105,111489.22378868803,23403.184675348835
"244.3.160.239",51903,"43.106.84.231",80,16,5721,8,1376,8,4345,115.0734,0.636817999999991,17285.943550590837,54583.88424950377
"244.3.160.239",51904,"94.2.202.197",80,10,1976,6,1633,4,343,115.074608,0.11711999999999989,111543.71584699464,23428.9617486339
"244.3.160.239",51905,"94.2.202.197",80,10,2100,6,1639,4,461,115.075591,0.1182889999999901,110847.16245805695,31177.877909191124
"244.3.160.239",51906,"94.2.202.197",80,10,1984,6,1640,4,344,115.077282,0.1174129999999991,111742.31132838868,23438.631156686406
"244.3.160.239",51907,"241.161.4.128",80,12,2583,7,1963,5,620,115.094714,0.29188400000001025,53802.19539268836,16993.052034369222
"244.3.160.239",51908,"94.2.202.197",80,10,2101,6,1639,4,462,115.153161,0.12220000000000653,107299.50900163093,30245.49918166778
"244.3.160.239",51909,"244.3.31.75",80,14,5791,7,1260,7,4531,115.298881,0.04973900000000242,202657.87410280685,728764.1488569983
"244.3.160.239",51910,"244.3.31.75",80,11,1919,6,1294,5,625,115.358352,0.009165000000010082,1129514.4571727891,545553.7370424987
"244.3.160.239",51911,"94.2.202.197",80,10,1975,6,1631,4,344,115.381746,0.11702699999999311,111495.63775881437,23515.940765807565
"244.3.160.239",51912,"244.3.31.75",80,13,3912,7,1371,6,2541,115.382284,0.27006500000000244,40612.445152092645,75270.76814840804
"244.3.160.239",51913,"94.2.202.197",80,10,1974,6,1630,4,344,115.385978,0.11796400000000062,110542.19931504468,23329.15126648796
"244.3.160.239",51914,"43.106.84.108",80,13,5334,7,1135,6,4199,115.397264,0.1379879999999929,65802.82343392518,243441.4586775787
"244.3.160.239",51915,"94.2.202.197",80,10,1969,6,1626,4,343,115.399858,0.11726600000000076,110927.29350365764,23399.79192604832
"244.3.160.239",51916,"94.2.202.197",80,10,1974,6,1630,4,344,115.4819,0.11800300000000163,110505.66511020753,23321.440980313735
"244.3.160.239",51917,"43.106.84.231",80,16,5343,8,1377,8,3966,115.57292,0.30446500000000754,36181.49869443032,104209.02238352262
"244.3.160.239",51918,"94.2.202.197",80,10,1984,6,1640,4,344,115.636318,0.11736100000000249,111791.82181474018,23449.01628309184
"244.3.160.239",51919,"244.3.31.75",80,11,3183,6,1416,5,1767,115.676423,0.24981400000000065,45345.737228497885,56586.100058443335
"244.3.160.239",51920,"43.106.84.231",80,16,5347,8,1377,8,3970,115.79295,0.4023299999999921,27380.508537768044,78940.17348942565
"244.3.160.239",51921,"41.43.180.128",80,11,2888,6,1782,5,1106,115.847373,0.123667999999995,115276.38516027248,71546.39842158325
"244.3.160.239",51922,"244.3.31.75",80,11,2703,6,1492,5,1211,115.943131,0.007207000000008179,1656167.6148170466,1344248.64714708
"244.3.160.239",51923,"244.3.31.75",80,43,35901,17,2137,26,33764,115.95778,0.23517800000000477,72693.87442702826,1148542.8058746757
"244.3.160.239",51924,"94.2.202.197",80,10,1977,6,1633,4,344,116.015481,0.117124000000004,111539.90642395712,23496.465284654776
"244.3.160.239",51925,"43.106.84.231",80,15,4945,8,1377,7,3568,116.064105,0.34615800000000263,31823.61811658236,82459.45493098465
"244.3.160.239",51926,"41.43.180.128",80,17,5303,9,2943,8,2360,116.131385,0.16011000000000308,147048.90387858063,117918.93073511733
"244.3.160.239",51927,"43.106.84.231",80,16,5563,8,1377,8,4186,116.274632,0.3561279999999982,30932.69835564756,94033.60589451031
"244.3.160.239",51928,"43.106.84.231",80,11,1640,6,1204,5,436,116.494108,0.10618600000000811,90708.75633321967,32848.0213964151
"244.3.160.239",51929,"94.2.202.197",80,10,1969,6,1626,4,343,116.513268,0.11698100000000977,111197.54490044463,23456.800677031064
"244.3.160.239",51930,"94.2.202.197",80,10,1966,6,1623,4,343,116.536554,0.11744500000000357,110553.87628251186,23364.127889649764
"244.3.160.239",51931,"94.2.202.197",80,10,1967,6,1624,4,343,116.538783,0.1184340000000077,109698.22854922705,23169.022409103985
"244.3.160.239",51932,"94.2.202.197",80,10,1977,6,1634,4,343,116.548433,0.119339999999994,109535.78012402092,22993.128875482973
"244.3.160.239",51933,"94.2.202.197",80,10,1972,6,1629,4,343,116.550555,0.11809699999999168,110349.96655292614,23235.1372177125
"244.3.160.239",51934,"41.43.180.128",80,11,2775,6,1682,5,1093,116.561472,0.27937800000000834,48164.13604507011,31298.097917515835
"244.3.160.239",51935,"94.2.202.197",80,10,1960,6,1616,4,344,116.566779,0.1185700000000054,109032.63894745224,23209.91819178439
"244.3.160.239",51936,"43.106.84.231",80,11,1629,6,1193,5,436,116.572168,0.1029879999999963,92670.9907950474,33868.02345904499
"244.3.160.239",51938,"43.106.84.231",80,11,1638,6,1202,5,436,116.604424,0.10462400000000116,91910.07799357598,33338.4309527447
"244.3.160.239",51939,"94.2.202.197",80,10,1965,6,1622,4,343,116.61528,0.11688499999999635,111015.1003122762,23476.066218933873
"244.3.160.239",51940,"43.106.84.231",80,11,1645,6,1209,5,436,116.647863,0.10487700000000189,92222.31757201128,33258.00699867404
"244.3.160.239",51941,"43.106.84.231",80,11,1638,6,1202,5,436,116.682296,0.10502700000000686,91557.40904719141,33210.50777418923
"244.3.160.239",51942,"94.2.202.197",80,10,1965,6,1622,4,343,116.696526,0.11779799999999341,110154.6715563993,23294.11365218555
"244.3.160.239",51943,"94.2.202.197",80,10,1966,6,1623,4,343,116.706658,0.11746899999999982,110531.28910606219,23359.35438285849
"244.3.160.239",51944,"94.2.202.197",80,10,1965,6,1622,4,343,116.713884,0.11668800000001056,111202.52296721879,23515.699986286094
"244.3.160.239",51945,"94.2.202.197",80,10,1973,6,1630,4,343,116.715229,0.11751900000000148,110960.78080991018,23349.41583914061
"244.3.160.239",51946,"43.106.84.231",80,11,1632,6,1196,5,436,116.724681,0.10357799999999884,92374.82863156372,33675.10475197474
"244.3.160.239",51948,"43.106.84.231",80,11,1637,6,1201,5,436,116.759386,0.10297699999999566,93302.38791186776,33871.64124027838
"244.3.160.239",51949,"43.106.84.231",80,11,1654,6,1218,5,436,116.800533,0.1035969999999935,94056.77770592403,33668.928636931756
"244.3.160.239",51950,"43.106.84.231",80,11,1637,6,1201,5,436,116.834769,0.10661800000001165,90116.11547767685,32714.926185068365
"244.3.160.239",51951,"43.106.84.231",80,11,1640,6,1204,5,436,116.87654,0.10615399999998942,90736.10038247226,32857.92339431719
"244.3.160.239",51952,"94.2.202.197",80,10,1969,6,1625,4,344,116.907488,0.1190339999999992,109212.49390930396,23119.444864492652
"244.3.160.239",51953,"43.106.84.231",80,11,1640,6,1204,5,436,116.91343,0.10434699999998998,92307.39743357188,33426.93129654264
"244.3.160.239",51954,"43.106.84.231",80,11,1653,6,1217,5,436,116.95511,0.10557399999999006,92219.6752988512,33038.43749408309
"244.3.160.239",51955,"43.106.84.231",80,11,1641,6,1205,5,436,116.990877,0.10468199999999683,92088.42016774892,33319.95949638052
"244.3.160.239",51956,"94.2.202.197",80,10,1966,6,1623,4,343,117.009838,0.11715200000000436,110830.37421469131,23422.56214149052
"244.3.160.239",51957,"43.106.84.231",80,14,4314,7,1214,7,3100,117.032224,0.30788099999999474,31544.655240174503,80550.60234311446
"244.3.160.239",51958,"43.106.84.231",80,11,1646,6,1210,5,436,117.068284,0.10569599999999468,91583.40902210573,33000.30275507281
"244.3.160.239",51959,"43.106.84.231",80,11,1643,6,1207,5,436,117.146523,0.10368699999999365,93126.42857832315,33639.704109485414
"244.3.160.239",51960,"43.106.84.231",80,11,1650,6,1214,5,436,117.22289,0.1056819999999874,91898.3365190019,33004.67440056411
"244.3.160.239",51961,"43.106.84.231",80,11,1639,6,1203,5,436,117.225604,0.1032859999999971,93178.16548225578,33770.30768932961
"244.3.160.239",51962,"43.106.84.231",80,11,1635,6,1199,5,436,117.301263,0.10505499999999302,91304.5547570381,33201.65627528658
"244.3.160.239",51963,"43.106.84.231",80,11,1639,6,1203,5,436,117.301993,0.10415900000000988,92397.20043394317,33487.264662675996
"244.3.160.239",51964,"40.248.176.156",80,13,4559,7,1796,6,2763,117.305551,2.3061600000000055,6230.270232767876,9584.76428348421
"244.3.160.239",51965,"43.106.84.231",80,11,1638,6,1202,5,436,117.379018,0.10718199999999456,89716.55688455606,32542.77770521335
"244.3.160.239",51966,"43.106.84.231",80,11,1640,6,1204,5,436,117.379962,0.10581499999999266,91026.79204272237,32963.19047394265
"244.3.160.239",51967,"43.106.84.231",80,11,1641,6,1205,5,436,117.459092,0.10577500000000839,91136.84708106107,32975.655873313386
"244.3.160.239",51968,"43.106.84.231",80,11,1639,6,1203,5,436,117.460422,0.10363399999999956,92865.27587471332,33656.907964567756
"244.3.160.239",51969,"43.106.84.108",80,10,1445,6,1055,4,390,117.551824,0.1028349999999989,82073.22409685506,30339.864832012772
"244.3.160.239",51970,"43.106.84.108",80,10,1440,6,1050,4,390,117.665218,0.10219600000000639,82194.99784726872,30529.570628985526
"244.3.160.239",51971,"43.106.84.108",80,10,1443,6,1053,4,390,117.676048,0.10358800000000201,81322.16086805264,30119.318840019496
"244.3.160.239",51972,"241.161.4.128",80,12,2564,7,1944,5,620,118.013114,0.3198110000000014,48628.72133854036,15509.160097682627
"244.3.160.239",51973,"241.161.4.128",80,12,2608,7,1988,5,620,118.335203,0.31712799999999675,50150.09712166747,15640.372341767523
"244.3.160.239",51974,"244.3.31.75",80,11,1743,6,1189,5,554,118.383731,0.003765999999998826,0,0
"244.3.160.239",51975,"43.106.84.108",80,36,28737,15,1628,21,27109,118.56579,0.21714999999998952,59976.9744416331,998719.7789546879
"244.3.160.239",51976,"241.161.4.128",80,14,2892,8,2208,6,684,118.658947,0.324302000000003,54467.74919673587,16873.161435945352
"244.3.160.239",51977,"43.106.84.108",80,10,2436,6,1282,4,1154,118.825901,0.13432000000000244,76354.97319833096,68731.38773079088
"244.3.160.239",51978,"43.106.84.108",80,10,1448,6,1058,4,390,118.94497,0.10312899999999559,82071.9681176038,30253.37199042106
"244.3.160.239",51979,"43.106.84.108",80,10,1438,6,1048,4,390,118.950717,0.1025330000000082,81768.79638749798,30429.22766328646
"244.3.160.239",51980,"43.106.84.108",80,10,1441,6,1051,4,390,119.020301,0.10238300000000322,82123.00870261407,30473.809128467634
"244.3.160.239",51981,"43.106.84.108",80,10,1447,6,1047,4,400,119.031847,0.10209600000000307,82040.4325340831,31343.049678732797
"244.3.160.239",51982,"43.106.84.108",80,10,1453,6,1053,4,400,119.09505,0.1030669999999958,81733.2414836984,31047.76504603928
"244.3.160.239",51983,"43.106.84.108",80,10,1461,6,1061,4,400,119.105669,0.1016919999999999,83467.72607481423,31467.568736970494
"244.3.160.239",51984,"241.161.4.128",80,12,2653,7,2033,5,620,119.151505,0.2916500000000042,55765.47231270278,17006.68609634812
"244.3.160.239",51985,"43.106.84.108",80,10,1441,6,1051,4,390,119.170176,0.10330700000000093,81388.4828714407,30201.244833360488
"244.3.160.239",51986,"43.106.84.108",80,10,1443,6,1053,4,390,119.180169,0.10247899999998822,82202.20728150127,30445.261956111583
"244.3.160.239",51987,"43.106.84.108",80,10,1570,6,1007,4,563,119.376378,0.3037559999999928,26521.28682231854,14827.690646440256
"244.3.160.239",51988,"41.43.180.128",80,11,2797,6,1693,5,1104,119.487835,0.1834699999999998,73821.33318798721,48138.66027143408
"244.3.160.239",51989,"40.248.176.156",80,27,17408,12,2251,15,15157,119.591351,0.5250949999999932,34294.74666488965,230922.02363382163
"244.3.160.239",51990,"40.248.176.156",80,148,135069,52,4712,96,130357,119.592303,0.7859200000000044,47964.169381107225,1326923.859934846
"244.3.160.239",51991,"41.43.180.128",80,17,5341,9,2962,8,2379,119.77547,0.12562300000000448,188627.87865278774,151500.91941761717
"244.3.160.239",51992,"43.106.84.108",80,10,2275,6,1282,4,993,119.90618,0.17475100000000054,58689.220662542524,45458.96733065891
"244.3.160.239",51993,"41.43.180.128",80,11,2775,6,1682,5,1093,120.197713,0.08317200000000469,161785.2161785125,105131.53465107857
"244.3.160.239",51994,"43.106.84.108",80,12,2574,7,1671,5,903,120.454094,0.12989600000000223,102913.0997105359,55613.72174662712
"244.3.160.239",51995,"57.255.139.77",80,24,14200,11,1570,13,12630,120.617597,0.47247199999999623,26583.585905620017,213853.9426675037
"244.3.160.239",51996,"41.43.180.128",80,11,2795,6,1692,5,1103,120.639317,0.13194199999999512,102590.53220354777,66877.87057949953
"244.3.160.239",51997,"43.106.84.231",80,14,4569,7,1469,7,3100,120.696283,0.1058140000000094,111062.80832403043,234373.5233522766
"244.3.160.239",51998,"43.106.84.231",80,11,1572,6,1136,5,436,120.790884,0.10394399999999848,87431.69398907232,33556.5304394679
"244.3.160.239",51999,"43.106.84.231",80,11,1581,6,1145,5,436,120.795023,0.10513199999999756,87128.56218848888,33177.33896435035
"244.3.160.239",52000,"41.43.180.128",80,17,4690,9,2651,8,2039,120.894042,0.196944000000002,107685.43342269774,82825.5747826785
"244.3.160.239",52001,"43.106.84.108",80,22,11369,12,10180,10,1189,120.988819,0.18657699999999977,436495.38796314714,50981.63224834793
"244.3.160.239",52002,"57.255.139.77",80,10,2798,6,1248,4,1550,121.077216,0.2451729999999941,40722.26550231975,50576.53167355418
"244.3.160.239",52003,"57.255.139.77",80,10,2803,6,1249,4,1554,121.077806,0.24495699999999943,40790.83267675561,50751.76459541891
"244.3.160.239",52004,"43.106.84.231",80,14,4569,7,1469,7,3100,121.177191,0.10545100000000218,111445.12617234314,235180.32071767445
"244.3.160.239",52005,"43.106.84.231",80,11,1572,6,1136,5,436,121.257619,0.1038599999999974,87502.40708646474,33583.67032543893
"244.3.160.239",52006,"43.106.84.231",80,11,1581,6,1145,5,436,121.259256,0.1036590000000075,88366.66377255556,33648.79074658011
"244.3.160.239",52007,"41.43.180.128",80,11,2804,6,1711,5,1093,121.378004,0.2831690000000009,48338.624637583765,30879.086340665723
"244.3.160.239",52008,"41.43.180.128",80,11,2826,6,1722,5,1104,121.8881,0.12313100000000077,111880.84235488962,71728.48429721147
"244.3.160.239",52009,"43.106.84.231",80,79,71734,29,3002,50,68732,122.084474,0.5054489999999987,47514.19035352738,1087856.539433259
"244.3.160.239",52010,"41.43.180.128",80,17,5241,9,2912,8,2329,122.18323,0.2679130000000072,86953.60060915064,69544.96422345874
"244.3.160.239",52011,"43.106.84.231",80,11,1654,6,1218,5,436,122.391424,0.11211299999999369,86912.31168553645,31111.467894001555
"244.3.160.239",52012,"43.106.84.231",80,11,1647,6,1211,5,436,122.633619,0.10429100000000346,92893.92181491862,33444.88019100291
"244.3.160.239",52013,"43.106.84.231",80,11,1650,6,1214,5,436,122.63818,0.10417699999999286,93225.95198556942,33481.478637321474
"244.3.160.239",52014,"41.43.180.128",80,11,2775,6,1682,5,1093,122.639665,0.18127800000000605,74228.53297145573,48235.30709738473
"244.3.160.239",52015,"43.106.84.231",80,11,1649,6,1213,5,436,122.71015,0.10394200000000353,93359.75832675598,33557.17611744897
"244.3.160.239",52016,"43.106.84.231",80,11,1651,6,1215,5,436,122.790275,0.10317500000000734,94208.86842742242,33806.63920523142
"244.3.160.239",52017,"43.106.84.231",80,11,1658,6,1222,5,436,122.928967,0.10601699999999425,92211.62643727449,32900.38390069696
"244.3.160.239",52018,"43.106.84.231",80,11,1655,6,1219,5,436,123.00963,0.10367399999999805,94064.08549877678,33643.92229488653
"244.3.160.239",52019,"43.106.84.231",80,11,1656,6,1220,5,436,123.093867,0.10460700000000145,93301.59549552004,33343.84888200552
"244.3.160.239",52020,"41.43.180.128",80,11,2795,6,1692,5,1103,123.119082,0.14194200000000023,95362.89470347027,62166.23691366886
"244.3.160.239",52021,"43.106.84.26",80,22,11439,10,1477,12,9962,123.178496,0.21781900000000576,54246.87469871631,365881.76421706966
"244.3.160.239",52022,"41.43.180.128",80,15,4535,8,2580,7,1955,123.36752,0.17852700000000254,115612.76445579495,87605.7963221237
"244.3.160.239",52023,"43.106.84.231",80,11,1661,6,1225,5,436,123.374795,0.10449999999998738,93779.90430623142,33377.99043062604
"244.3.160.239",52024,"43.106.84.231",80,11,1656,6,1220,5,436,123.45452,0.10349499999999523,94304.07266051935,33702.111213103635
"244.3.160.239",52025,"43.106.84.231",80,11,1656,6,1220,5,436,123.533902,0.10559100000000399,92432.12016175273,33033.118352888676
"244.3.160.239",52026,"43.106.84.231",80,14,4328,7,1228,7,3100,123.615057,0.1069920000000053,91819.94915507246,231793.03125466176
"244.3.160.239",52027,"43.106.84.231",80,11,1642,6,1206,5,436,123.616782,0.10348799999999869,93228.20037105869,33704.39084724842
"244.3.160.239",52028,"41.43.180.128",80,11,2811,6,1718,5,1093,123.671612,0.2293769999999995,59918.82359608867,38120.64853930437
"244.3.160.239",52029,"43.106.84.231",80,11,1641,6,1205,5,436,123.693374,0.10337199999999314,93255.4270015153,33742.212591419644
"244.3.160.239",52030,"43.106.84.231",80,11,1645,6,1209,5,436,123.695557,0.10296500000001174,93934.83222453161,33875.5887923042
"244.3.160.239",52031,"43.106.84.231",80,11,1652,6,1216,5,436,123.768999,0.10413700000000858,93415.40470725292,33494.33918779792
"244.3.160.239",52032,"43.106.84.231",80,11,1655,6,1219,5,436,123.853322,0.1041969999999992,93591.94602531815,33475.05206483897
"244.3.160.239",52033,"43.106.84.231",80,11,1645,6,1209,5,436,123.9451,0.10310499999999934,93807.28383686593,33829.5911934438
"244.3.160.239",52034,"43.106.84.231",80,11,1644,6,1208,5,436,124.042773,0.1064709999999991,90766.49979806785,32760.094297978132
"244.3.160.239",52035,"43.106.84.231",80,11,1662,6,1226,5,436,124.04518,0.10379199999999855,94496.68567905172,33605.672884230466
"244.3.160.239",52036,"43.106.84.231",80,11,1667,6,1231,5,436,124.124623,0.10336399999999912,95274.95065980499,33744.82411671404
"244.3.160.239",52037,"43.106.84.231",80,11,1669,6,1233,5,436,124.131088,0.10382699999999545,95004.18966165287,33594.34443834602
"244.3.160.239",52038,"43.106.84.231",80,11,1667,6,1231,5,436,124.200553,0.10505700000000218,93739.58898502523,33201.02420590658
"244.3.160.239",52039,"43.106.84.231",80,11,1669,6,1233,5,436,124.213255,0.1034569999999917,95343.9593261045,33714.49007800613
"244.3.160.239",52040,"43.106.84.231",80,11,1675,6,1239,5,436,124.278431,0.10485300000000564,94532.34528339167,33265.619486326694
"244.3.160.239",52041,"43.106.84.231",80,120,113442,43,3629,77,109813,124.294306,0.7055729999999869,41146.69920759516,1245092.9953385636
"244.3.160.239",52042,"43.106.84.231",80,11,1655,6,1219,5,436,124.357191,0.1046050000000065,93226.90119974565,33344.48640122158
"244.3.160.239",52043,"43.106.84.231",80,11,1644,6,1208,5,436,124.434013,0.10374500000000353,93151.47717961995,33620.897392644285
"244.3.160.239",52044,"43.106.84.231",80,11,1653,6,1217,5,436,124.514435,0.10481199999999546,92890.12708468898,33278.63221768644
"244.3.160.239",52045,"43.106.84.231",80,11,1660,6,1224,5,436,124.613003,0.10304999999999609,95021.83406113897,33847.64677341225
"244.3.160.239",52046,"43.106.84.231",80,11,1653,6,1217,5,436,124.696757,0.10550200000000132,92282.61075619304,33060.98462588346
"244.3.160.239",52047,"43.106.84.108",80,13,5188,7,1150,6,4038,124.720048,0.13711299999999937,67097.94111426373,235601.29236469298
"244.3.160.239",52049,"43.106.84.231",80,11,1647,6,1211,5,436,124.774427,0.10339499999999191,93698.92161130381,33734.70670729023
"244.3.160.239",52050,"43.106.84.231",80,11,1652,6,1216,5,436,124.849775,0.10318300000000136,94279.0963627717,33804.01810375696
"244.3.160.239",52051,"43.106.84.231",80,11,1652,6,1216,5,436,124.866956,0.1049380000000042,92702.35758256886,33238.67426480265
"244.3.160.239",52052,"43.106.84.231",80,11,1650,6,1214,5,436,124.926104,0.1036890000000028,93664.70888907924,33639.05525176157
"244.3.160.239",52054,"43.106.84.231",80,11,1655,6,1219,5,436,124.94425,0.10553600000000074,92404.48756822251,33050.33353547582
"244.3.160.239",52057,"85.241.98.37",80,10,1737,6,1033,4,704,124.978488,0.21361100000000022,38687.14626119437,26365.683415179905
"244.3.160.239",52060,"43.106.84.231",80,11,1655,6,1219,5,436,125.002131,0.10317099999998902,94522.6856384162,33807.94990840809
"244.3.160.239",52062,"43.106.84.231",80,11,1668,6,1232,5,436,125.022528,0.10305900000000179,95634.53943857236,33844.69090520905
"244.3.160.239",52063,"244.3.31.108",80,11,1517,6,1092,5,425,125.029112,0.015287000000000717,571465.9514619998,222411.19905801272
"244.3.160.239",52064,"43.106.84.231",80,11,1669,6,1233,5,436,125.077262,0.10524699999999143,93722.38638631793,33141.08715688128
"244.3.160.239",52065,"43.106.84.231",80,11,1656,6,1220,5,436,125.097769,0.10518100000000175,92792.42448731081,33161.88284956353
"244.3.160.239",52066,"43.106.84.231",80,14,4329,7,1229,7,3100,125.154641,0.24546899999999994,40053.937564417516,101031.08742855515
"244.3.160.239",52067,"43.106.84.231",80,11,1661,6,1225,5,436,125.175095,0.10609200000000385,92372.65769331943,32877.12551370389
"244.3.160.239",52068,"85.241.98.37",80,10,1772,6,1028,4,744,125.175986,0.21796000000000504,37731.69388878606,27307.762892273182
"244.3.160.239",52070,"177.202.64.15",80,66,57974,25,2641,41,55333,125.250253,0.3264920000000018,64712.15221199871,1355818.825576117
"244.3.160.239",52071,"43.106.84.231",80,11,1658,6,1222,5,436,125.253177,0.10375600000000418,94221.05709548948,33617.33297351343
"244.3.160.239",52077,"43.106.84.231",80,11,1654,6,1218,5,436,125.332527,0.10316100000000006,94454.29958996127,33811.22711102062
"244.3.160.239",52078,"43.106.84.231",80,11,1665,6,1229,5,436,125.332857,0.10446799999999712,94114.94428916292,33388.214572884484
"244.3.160.239",52080,"85.241.98.37",80,100,71513,36,2985,64,68528,125.40507,1.160373000000007,20579.58949406773,472454.9778390196
"244.3.160.239",52081,"43.106.84.231",80,11,1653,6,1217,5,436,125.40885,0.10425200000000245,93389.095652839,33457.39170471471
"244.3.160.239",52082,"43.106.84.231",80,11,1655,6,1219,5,436,125.410607,0.10440400000000238,93406.38289720487,33408.68165970576
"244.3.160.239",52086,"43.106.84.231",80,11,1654,6,1218,5,436,125.485666,0.10623600000000977,91720.32079520223,32832.56146691968
"244.3.160.239",52088,"244.3.31.75",80,13,3631,7,1747,6,1884,125.572689,0.04678599999999733,298721.83986664383,322147.6510067298
"244.3.160.239",52090,"41.43.180.128",80,11,2833,6,1729,5,1104,125.62831,0.08286400000000071,166924.11662482962,106584.28268005315
"244.3.160.239",52094,"188.68.211.254",80,14,4535,7,1334,7,3201,125.689232,1.1504809999999992,9276.120161914892,22258.516220606874
"244.3.160.239",52096,"43.106.84.108",80,10,1470,6,1070,4,400,125.715752,0.10199200000000985,83928.15122753916,31375.009804687532
"244.3.160.239",52100,"43.106.84.231",80,11,1656,6,1220,5,436,125.819176,0.10251599999999428,95204.65098131554,34023.957235945556
"244.3.160.239",52102,"43.106.84.108",80,10,1455,6,1065,4,390,125.830831,0.1029529999999994,82756.20914397879,30305.09067244294
"244.3.160.239",52103,"43.106.84.108",80,10,1468,6,1068,4,400,125.836438,0.10143899999999917,84227.9596604863,31546.05230729824
"244.3.160.239",52104,"85.241.98.37",80,36,26824,15,1596,21,25228,126.123832,0.29121300000001327,43844.19651595024,693045.9835240556
"244.3.160.239",52105,"85.241.98.37",80,10,1914,6,1002,4,912,126.414309,0.13350400000000207,60043.14477468747,54650.0479386377
"244.3.160.239",52106,"43.106.84.108",80,36,28752,15,1643,21,27109,126.444579,0.21116999999999564,62243.68991807677,1027001.9415636903
"244.3.160.239",52107,"85.241.98.37",80,13,5495,7,1043,6,4452,126.551107,0.1897819999999939,43966.23494325209,187667.95586515657
"244.3.160.239",52108,"43.106.84.108",80,10,2290,6,1297,4,993,126.645931,0.1349000000000018,76916.23424758979,58888.06523350552
"244.3.160.239",52109,"85.241.98.37",80,27,17050,12,1358,15,15692,126.753169,0.2805850000000021,38719.10472762236,447408.0938040133
"244.3.160.239",52110,"43.106.84.108",80,10,1463,6,1073,4,390,126.84403,0.10208000000000084,84090.9090909084,30564.263322883762
"244.3.160.239",52111,"43.106.84.108",80,10,1453,6,1063,4,390,126.852032,0.10331200000000251,82313.7680037149,30199.783181043094
"244.3.160.239",52112,"198.123.241.156",80,160,142689,59,4634,101,138055,126.907257,5.699438999999998,6504.499828842806,193780.47558715873
"244.3.160.239",52113,"41.43.180.128",80,61,54105,23,2990,38,51115,126.91273,0.3973409999999973,60200.18070121171,1029141.2162349287
"244.3.160.239",52114,"43.106.84.108",80,10,1466,6,1066,4,400,126.918715,0.1022129999999919,83433.61411954131,31307.17227750143
"244.3.160.239",52115,"43.106.84.108",80,10,1452,6,1062,4,390,126.926898,0.10206100000000617,83244.33427067622,30569.95326324268
"244.3.160.239",52116,"43.106.84.108",80,10,1458,6,1068,4,390,126.993654,0.10376199999998903,82342.28330218098,30068.811318212156
"244.3.160.239",52117,"43.106.84.108",80,10,1466,6,1076,4,390,127.002446,0.1026859999999914,83828.36998228308,30383.888748225283
"244.3.160.239",52118,"85.241.98.37",80,13,5090,7,1036,6,4054,127.049937,0.1911580000000015,43356.80431894001,169660.69952604518
"244.3.160.239",52119,"43.106.84.108",80,10,1456,6,1066,4,390,127.069679,0.1029400000000038,82844.37536428681,30308.917816202495
"244.3.160.239",52120,"43.106.84.108",80,10,1468,6,1068,4,400,127.077922,0.10245499999999197,83392.70899419911,31233.22434239667
"244.3.160.239",52121,"188.68.211.254",80,29,21636,12,1651,17,19985,127.092841,1.0534860000000066,12537.423373447695,151762.8141237748
"244.3.160.239",52122,"188.68.211.254",80,32,24289,13,1799,19,22490,127.108694,1.209817000000001,11896.014025261662,148716.70674159797
"244.3.160.239",52123,"43.106.84.108",80,10,1585,6,1022,4,563,127.145015,0.31453399999999476,25994.010186498555,14319.596609587756
"244.3.160.239",52124,"41.43.180.128",80,11,2195,6,1721,5,474,127.17374,0.07621900000000892,180637.37388313137,49751.37432922967
"244.3.160.239",52125,"41.43.180.128",80,11,2172,6,1698,5,474,127.23267,0.07566599999999823,179525.81080009934,50114.97898660017
"244.3.160.239",52126,"85.241.98.37",80,16,7526,8,1107,8,6419,127.251667,0.18063000000000784,49028.400597905194,284293.8603775551
"244.3.160.239",52127,"41.43.180.128",80,11,2184,6,1710,5,474,127.300563,0.07853500000000224,174189.85165849124,48284.204494809856
"244.3.160.239",52128,"41.43.180.128",80,11,2180,6,1705,5,475,127.305858,0.07574300000000278,180082.64790144964,50169.65264116632
"244.3.160.239",52129,"41.43.180.128",80,11,2181,6,1707,5,474,127.358643,0.07570900000000336,180374.8563578887,50086.515473719526
"244.3.160.239",52130,"43.106.84.108",80,10,2451,6,1297,4,1154,127.41905,0.1352770000000021,76701.878368088,68245.15623498346
"244.3.160.239",52131,"41.43.180.128",80,14,7507,7,1730,7,5777,127.424071,0.1062079999999952,130310.33443808966,435146.1283519329
"244.3.160.239",52132,"85.241.98.37",80,10,2148,6,1013,4,1135,127.439641,0.1412250000000057,57383.60771817789,64294.56540980445
"244.3.160.239",52133,"41.43.180.128",80,11,2162,6,1689,5,473,127.51296,0.0767579999999981,176033.7684671348,49297.793063916375
"244.3.160.239",52134,"41.43.180.128",80,26,19631,11,2028,15,17603,127.574439,0.13984800000000064,116011.66981293923,1006979.005777697
"244.3.160.239",52135,"41.43.180.128",80,13,4152,7,1730,6,2422,127.575305,0.08247799999999472,167802.32304373148,234923.2522612241
"244.3.160.239",52136,"85.241.98.37",80,12,2876,7,1116,5,1760,127.595005,0.1469069999999988,60773.14219199952,95842.94825978419
"244.3.160.239",52137,"41.43.180.128",80,31,23700,13,2124,18,21576,127.638365,0.1572100000000063,108084.72743463724,1097945.4233190834
"244.3.160.239",52138,"85.241.98.37",80,12,3053,7,1130,5,1923,127.750982,0.13945500000001232,64823.77827972609,110315.15542647192
"244.3.160.239",52139,"41.43.180.128",80,13,3789,7,1720,6,2069,127.781006,0.20960099999999215,65648.54175314294,78969.08888793766
"244.3.160.239",52140,"41.43.180.128",80,11,2384,6,1656,5,728,127.784854,0.20626300000000697,64228.678919629565,28235.796046793672
"244.3.160.239",52142,"43.106.84.108",80,12,2750,7,1686,5,1064,127.800405,0.12041200000000174,112015.41374613663,70690.62884097829
"244.3.160.239",52141,"197.154.128.255",80,12,3518,7,1618,5,1900,127.800409,0.005679999999998131,2278873.2394373696,2676056.33802905
"244.3.160.239",52143,"85.241.98.37",80,12,2997,7,1051,5,1946,127.908454,0.13249199999998496,63460.43534704703,117501.43404886157
"244.3.160.239",52144,"43.106.84.231",80,14,4584,7,1484,7,3100,127.933543,0.10597299999999166,112028.53557038995,234021.8734960976
"244.3.160.239",52145,"41.43.180.128",80,11,2155,6,1705,5,450,127.971903,0.0755890000000079,180449.53630817414,47625.97732473804
"244.3.160.239",52146,"41.43.180.128",80,11,2473,6,1656,5,817,127.972254,0.14291300000000717,92699.7543960265,45734.117959875395
"244.3.160.239",52147,"43.106.84.231",80,11,1572,6,1136,5,436,128.015038,0.10372899999998708,87612.91442124316,33626.083351815156
"244.3.160.239",52148,"43.106.84.231",80,11,1581,6,1145,5,436,128.016888,0.10515100000000643,87112.8187083284,33171.34406710147
"244.3.160.239",52149,"41.43.180.128",80,13,4587,7,1720,6,2867,128.027371,0.08743100000000936,157381.24921364879,262332.58226484363
"244.3.160.239",52150,"85.241.98.37",80,51,35505,20,1916,31,33589,128.050951,0.3461719999999957,44278.5667240568,776238.4017193861
"244.3.160.239",52151,"41.43.180.128",80,13,6138,7,1720,6,4418,128.096165,0.08254799999997431,166690.89499447937,428163.00818930805
"244.3.160.239",52152,"41.43.180.128",80,31,24942,13,2104,18,22838,128.096241,0.15294600000001424,110051.91374732542,1194565.4021679743
"244.3.160.239",52153,"188.68.211.254",80,11,2301,6,1225,5,1076,128.113217,0.37474800000001096,26150.90674266364,22970.102575596797
"244.3.160.239",52154,"41.43.180.128",80,13,5226,7,1720,6,3506,128.158568,0.09055100000000493,151958.5647866865,309748.0977570482
"244.3.160.239",52155,"43.106.84.108",80,12,3421,7,2552,5,869,128.205368,0.10845800000001304,188238.76523629003,64098.545058909105
"244.3.160.239",52156,"41.43.180.128",80,11,2154,6,1705,5,449,128.231928,0.0760089999999991,179452.43326448396,47257.56160454739
"244.3.160.239",52157,"41.43.180.128",80,11,2376,6,1656,5,720,128.232967,0.20495299999998906,64639.209965214985,28104.004332702167
"244.3.160.239",52158,"188.68.211.254",80,11,2385,6,1309,5,1076,128.234857,0.35682399999998893,29347.801717374183,24123.93785171476
"244.3.160.239",52159,"41.43.180.128",80,56,51066,21,2681,35,48385,128.287413,0.2014080000000149,106490.3082300525,1921870.034953782
"244.3.160.239",52160,"43.106.84.231",80,14,4584,7,1484,7,3100,128.312713,0.10610700000000861,111887.0574043092,233726.33285266746
"244.3.160.239",52161,"43.106.84.231",80,11,1581,6,1145,5,436,128.396123,0.11289000000002147,81140.93365221239,30897.33368765468
"244.3.160.239",52162,"43.106.84.231",80,11,1572,6,1136,5,436,128.398457,0.11244899999999802,80818.86010547145,31018.506167240805
"244.3.160.239",52163,"85.241.98.37",80,13,4299,7,1028,6,3271,128.410575,0.2612440000000049,31480.14882638394,100166.89378511853
"244.3.160.239",52164,"85.241.98.37",80,10,2569,6,952,4,1617,128.412172,0.2613489999999956,29141.110163039186,49497.03270339744
"244.3.160.239",52165,"41.43.180.128",80,11,2553,6,1656,5,897,128.419206,0.23193699999998785,57118.95902766999,30939.43613998791
"244.3.160.239",52166,"41.43.180.128",80,13,5086,7,1720,6,3366,128.468249,0.18379800000002433,74864.79722302842,146508.66712367075
"244.3.160.239",52168,"41.43.180.128",80,15,4535,8,2580,7,1955,128.63241,0.23854700000001117,86523.82968555058,65563.59962606643
"244.3.160.239",52169,"41.43.180.128",80,11,2708,6,1656,5,1052,128.63298,0.2387549999999976,55487.84318653068,35249.52357018737
"244.3.160.239",52170,"85.241.98.37",80,14,5178,8,1095,6,4083,128.668812,0.33302100000000223,26304.647454664846,98083.904618627
"244.3.160.239",52171,"85.241.98.37",80,10,1569,6,960,4,609,128.671012,0.2256490000000042,34035.16080283917,21591.0551343011
"244.3.160.239",52172,"41.43.180.128",80,11,2166,6,1716,5,450,128.850603,0.07542100000000573,182018.2707733782,47732.06401399778
"244.3.160.239",52173,"41.43.180.128",80,11,2165,6,1717,5,448,128.852547,0.07582899999999881,181144.4170436141,47264.23927521207
"244.3.160.239",52174,"85.241.98.37",80,10,1610,6,954,4,656,128.889726,0.24685700000000566,30916.684558265817,21259.271562077964
"244.3.160.239",52175,"41.43.180.128",80,11,2169,6,1719,5,450,128.906075,0.076469000000003,179837.5812420649,47077.90084870809
"244.3.160.239",52176,"85.241.98.37",80,33,21507,14,1482,19,20025,128.909065,0.3729370000000074,31790.892295480913,429563.1701869131
"244.3.160.239",52177,"41.43.180.128",80,11,2813,6,1719,5,1094,129.108507,0.1028129999999976,133757.4042193139,85125.42188244876
"244.3.160.239",52178,"85.241.98.37",80,10,1687,6,974,4,713,129.299294,0.3882380000000012,20070.1631473477,14692.018813202167
"244.3.160.239",52179,"85.241.98.37",80,25,17280,11,1282,14,15998,129.405003,0.21751800000001253,47150.12090953121,588383.4901019346
"244.3.160.239",52180,"85.241.98.37",80,17,7561,9,1146,8,6415,129.578763,0.32902899999999136,27863.805318073,155974.09346896884
"244.3.160.239",52181,"188.68.211.254",80,350,342088,125,8983,225,333105,130.172666,2.4849499999999978,28919.696573371722,1072391.79862774
"244.3.160.239",52184,"177.202.64.15",80,198,193368,69,5937,129,187431,133.20879,0.9681740000000048,49057.29755188609,1548738.1400450668
"244.3.160.239",52187,"82.242.98.77",80,53,46655,20,2643,33,44012,134.86985,0.7258349999999893,29130.58753022424,485090.9641998597
"244.3.160.239",52188,"82.242.98.106",80,10,2582,6,1337,4,1245,135.826998,0.34642800000000307,30875.10247439556,28750.562887526157
"244.3.160.239",52189,"82.242.98.106",80,10,2583,6,1338,4,1245,135.918928,0.36553499999999417,29283.10558496497,27247.732775247674
"244.3.160.239",52190,"82.242.98.106",80,11,2647,6,1338,5,1309,136.011449,0.3832429999999931,27930.06004023607,27324.69999452094
"244.3.160.239",52191,"244.3.31.75",80,13,4439,7,1842,6,2597,137.85568,0.2887580000000014,51032.35235041082,71949.52174485174
"244.3.160.239",52192,"244.3.31.75",80,11,2154,6,1529,5,625,138.150372,0.0071619999999938955,1707902.8204426733,698129.014242427
"244.3.160.239",52193,"244.3.31.75",80,16,4008,8,2023,8,1985,138.176653,0.26938600000002566,60077.361110074235,58948.86890929182
"244.3.160.239",52194,"244.3.31.75",443,18,4060,10,2325,8,1735,138.490192,0.06658099999998512,279358.97628458805,208467.88122742376
"244.3.160.239",52195,"244.3.31.75",80,14,3304,7,1929,7,1375,138.527574,0.05165400000001341,298757.1146473844,212955.4342354347
"244.3.160.239",52196,"244.3.31.75",80,25,18968,11,2132,14,16836,138.58321,0.14132100000000491,120689.77717394731,953064.3004224094
"244.3.160.239",52200,"244.3.31.75",80,11,2216,6,1594,5,622,138.819722,0.007902999999998883,1613564.4691891437,629634.3160825893
"244.3.160.239",52203,"244.3.31.75",80,25,15058,11,2248,14,12810,138.840355,0.08416000000002555,213688.21292769178,1217680.6083646493
"244.3.160.239",52204,"244.3.31.75",80,20,11462,9,2120,11,9342,138.850218,0.5333429999999737,31799.423635448176,140127.46018979096
"244.3.160.239",52207,"244.3.31.75",80,11,2228,6,1603,5,625,138.947587,0.01025300000000584,1250755.8763281668,487662.14766382053
"244.3.160.239",52208,"244.3.31.75",80,11,2228,6,1605,5,623,138.961814,0.005758999999983416,2229553.741975512,865428.0257013981
"244.3.160.239",52210,"244.3.31.75",80,13,3944,7,1587,6,2357,138.987261,0.011774000000002616,1078308.1365718686,1601494.8190925608
"244.3.160.239",52211,"82.242.98.77",80,99,92770,36,3777,63,88993,139.074287,4.647013000000015,6502.241332227799,153204.64995471234
"244.3.160.239",52213,"81.67.210.26",80,11,2188,6,1581,5,607,140.872086,0.36224599999999896,34915.49941200189,13405.254992463724
"244.3.160.239",52214,"128.71.90.164",80,10,2926,6,1503,4,1423,141.63139,0.2481949999999813,48445.7785209247,45867.1609017138
"244.3.160.239",52215,"156.224.224.225",80,10,1624,6,987,4,637,141.862583,0.12177199999999289,64842.492527021495,41848.70085077274
"244.3.160.239",52216,"128.71.90.164",80,10,1996,6,1531,4,465,142.111309,0.23386099999999033,52372.99079367875,15906.884858955336
"244.3.160.239",52217,"244.3.31.75",80,19,9998,9,2139,10,7859,142.221302,0.3851439999999968,44430.135222151046,163242.83904202198
"244.3.160.239",52218,"188.68.193.77",80,11,1916,6,999,5,917,142.312282,0.7205519999999979,11091.496519335209,10181.083391622009
"244.3.160.239",52220,"128.71.90.164",80,103,97605,37,3523,66,94082,142.70477,1.5767649999999946,17874.57230468719,477341.89939528244
"244.3.160.239",52221,"188.68.193.77",80,46,37303,18,1808,28,35495,143.161572,2.202980999999994,6565.649000150269,128898.07038735275
"244.3.160.239",52222,"117.203.39.40",80,10,2596,6,1405,4,1191,143.659981,0.1325920000000167,84771.32858693274,71859.53903703693
"244.3.160.239",52223,"117.203.39.40",80,12,4610,7,1741,5,2869,143.80057299999999,0.17016000000000986,81852.37423600843,134884.81429242285
"244.3.160.239",52224,"82.242.98.106",80,14,3595,7,1446,7,2149,143.840773,0.4637989999999945,24941.83902940743,37067.78151742501
"244.3.160.239",52225,"82.242.98.77",80,12,2444,7,1925,5,519,143.934862,0.4557800000000043,33788.23116415783,9109.6581684145
"244.3.160.239",52226,"82.242.98.77",80,24,16983,11,1985,13,14998,144.122605,0.13407900000001405,118437.63751220054,894875.4092735434
"244.3.160.239",52227,"82.242.98.77",80,11,2265,6,1638,5,627,144.172137,1.2394240000000138,10572.653103376935,4047.041206237691
"244.3.160.239",52228,"82.242.98.77",80,10,2119,6,1651,4,468,144.17465,0.12028599999999301,109804.96483381913,31125.81680328731
"244.3.160.239",52229,"82.242.98.77",80,11,2170,6,1665,5,505,144.175927,1.0737120000000004,12405.561267826004,3762.6477118631424
"244.3.160.239",52230,"82.242.98.77",80,10,2093,6,1638,4,455,144.175932,0.1203610000000026,108872.47530345972,30242.354250961034
"244.3.160.239",52231,"48.151.224.224",80,10,2173,6,1259,4,914,144.177006,0.32952099999999973,30565.578521551004,22189.7845660823
"244.3.160.239",52232,"128.71.90.164",80,10,2987,6,1491,4,1496,144.909257,0.2602380000000153,45834.96645378192,45988.671908019955
"244.3.160.239",52233,"188.68.193.77",80,28,19510,12,1302,16,18208,145.202468,0.400542999999999,26004.698621621214,363666.3229665738
"244.3.160.239",52234,"188.68.193.77",80,11,1672,6,921,5,751,145.229625,0.2978600000000142,24736.45336735261,20170.549922781553
"244.3.160.239",52235,"188.68.193.77",80,19,9149,9,1110,10,8039,145.293267,0.3339910000000259,26587.542778096747,192556.08684064844
"244.3.160.239",52236,"94.2.202.203",80,19,10822,13,9753,6,1069,145.47779,1.1577039999999954,67395.46550759116,7387.035027951906
"244.3.160.239",52237,"188.68.193.77",80,11,1980,6,919,5,1061,145.508844,0.44279699999998456,16603.545191137826,19169.054894229852
"244.3.160.239",52238,"128.71.90.164",80,16,7867,8,1620,8,6247,145.699786,0.37945799999999963,34153.97751529817,131703.6404555973
"244.3.160.239",52239,"188.68.193.77",80,19,10483,9,1124,10,9359,145.975054,0.4363299999999981,20608.255219673272,171594.89377306242
"244.3.160.239",52240,"188.68.193.77",80,27,17536,12,1309,15,16227,146.462101,0.5093540000000019,20559.37520859748,254864.00420925237
"244.3.160.239",52241,"94.2.202.203",80,113,103073,40,3852,73,99221,146.603794,1.0881550000000004,28319.4949248958,729462.2549177274
"244.3.160.239",52242,"244.3.31.75",80,58,49763,22,3000,36,46763,147.035269,0.20620400000001382,116389.59477021974,1814242.2067465952
"244.3.160.239",52243,"188.68.193.77",80,13,3515,7,992,6,2523,147.113472,0.35843099999999595,22140.94205021354,56312.0935410169
"244.3.160.239",52246,"244.3.31.75",80,11,2249,6,1627,5,622,147.315303,0.012218999999987545,1065226.2869312766,407234.63458589674
"244.3.160.239",52247,"244.3.31.75",80,11,2243,6,1622,5,621,147.333591,0.003723999999976968,0,0
"244.3.160.239",52248,"244.3.31.75",80,11,2253,6,1630,5,623,147.34241,0.0029380000000003292,0,0
"244.3.160.239",52249,"244.3.31.75",80,11,2258,6,1634,5,624,147.343251,0.004053999999996449,0,0
"244.3.160.239",52250,"244.3.31.75",80,11,2271,6,1647,5,624,147.353734,0.0037370000000009895,0,0
"244.3.160.239",52251,"244.3.31.75",80,11,2250,6,1626,5,624,147.355171,0.012063999999980979,1078249.3368717267,413793.1034489283
"244.3.160.239",52252,"244.3.31.75",80,11,2258,6,1634,5,624,147.370531,0.003330000000005384,0,0
"244.3.160.239",52253,"244.3.31.75",80,11,2253,6,1630,5,623,147.371206,0.005945999999994456,2193070.9720841167,838210.5617229478
"244.3.160.239",52254,"244.3.31.75",80,11,2260,6,1637,5,623,147.384932,0.00342200000000048,0,0
"244.3.160.239",52255,"244.3.31.75",80,11,2258,6,1634,5,624,147.386399,0.0075219999999944775,1737835.6820007442,663653.2837016305
"244.3.160.239",52256,"244.3.31.75",80,11,2262,6,1638,5,624,147.391761,0.005469000000005053,2396050.4662621855,912781.1300046421
"244.3.160.239",52257,"244.3.31.75",80,11,2257,6,1633,5,624,147.397634,0.004919000000001006,0,0
"244.3.160.239",52258,"244.3.31.75",80,11,2249,6,1626,5,623,147.400543,0.006920000000008031,1879768.7861249861,720231.2138719965
"244.3.160.239",52259,"244.3.31.75",80,11,2257,6,1634,5,623,147.406385,0.006806000000011636,1920658.2427237218,732295.0337924594
"244.3.160.239",52260,"244.3.31.75",80,11,2256,6,1633,5,623,147.411169,0.005985000000009677,2182790.3091025692,832748.5380103495
"244.3.160.239",52261,"244.3.31.75",80,11,2261,6,1638,5,623,147.467336,0.009893000000005259,1324572.9303540923,503790.55898082996
"244.3.160.239",52262,"94.2.202.197",80,10,1887,6,1543,4,344,147.515816,0.11757199999999557,104990.98424795415,23406.93362365277
"244.3.160.239",52263,"94.2.202.197",80,10,1885,6,1542,4,343,147.520476,0.11692999999999643,105499.01650560487,23467.031557342718
"244.3.160.239",52264,"94.2.202.197",80,10,1892,6,1549,4,343,147.524454,0.1172860000000071,105656.25905904583,23395.801715463345
"244.3.160.239",52265,"94.2.202.197",80,10,1891,6,1548,4,343,147.528496,0.1169140000000084,105924.01252201713,23470.243084658832
"244.3.160.239",52266,"188.68.193.77",80,11,1662,6,926,5,736,147.588834,0.42572699999999486,17400.822592882505,13830.459425876374
"244.3.160.239",52267,"188.68.193.77",80,11,1665,6,926,5,739,147.593439,0.4215990000000147,17571.199172672947,14022.803659400979
"244.3.160.239",52268,"188.68.193.77",80,11,1615,6,915,5,700,147.597244,0.4163020000000017,17583.388982037006,13451.7729917223
"244.3.160.239",52269,"188.68.193.77",80,11,2201,6,948,5,1253,147.597875,0.4175340000000176,18163.790254206076,24007.625726287144
"244.3.160.239",52270,"188.68.193.77",80,11,1639,6,934,5,705,147.624337,0.3895819999999901,19179.53088181741,14477.054894733697
"244.3.160.239",52271,"188.68.193.77",80,11,1649,6,946,5,703,147.625878,0.3882189999999923,19494.15149696473,14486.668607152435
"244.3.160.239",52272,"94.2.202.197",80,10,1893,6,1548,4,345,147.673331,0.11726699999999823,105605.15746117993,23536.03315510793
"244.3.160.239",52274,"94.2.202.197",80,10,1869,6,1525,4,344,147.746412,0.11759499999999434,103745.9075641021,23402.355542328605
"244.3.160.239",52275,"94.2.202.197",80,10,2040,6,1578,4,462,147.746759,0.11831900000001383,106694.61371376131,31237.586524561295
"244.3.160.239",52276,"94.2.202.197",80,10,1879,6,1535,4,344,147.747452,0.11788400000000365,104170.20121475025,23344.983203826767
"244.3.160.239",52277,"94.2.202.197",80,10,1883,6,1539,4,344,147.787269,0.11744199999998273,104834.72692905273,23432.843446130046
"244.3.160.239",52278,"94.2.202.197",80,10,1894,6,1549,4,345,147.873571,0.11787100000000805,105131.88146362679,23415.428731408163
"244.3.160.239",52279,"94.2.202.197",80,10,2002,6,1540,4,462,147.967395,0.11751999999998475,104833.21987748127,31449.96596324438
"244.3.160.239",52280,"188.68.193.77",80,11,1638,6,931,5,707,148.028787,0.43375800000001163,17170.86486012892,13039.528953932488
"244.3.160.239",52281,"188.68.193.77",80,11,2553,6,936,5,1617,148.033609,0.42927499999998986,17443.363811077226,30134.529147982776
"244.3.160.239",52282,"188.68.193.77",80,11,1677,6,937,5,740,148.034028,0.4292899999999804,17461.38973654253,13790.21174497489
"244.3.160.239",52283,"188.68.193.77",80,11,2461,6,937,5,1524,148.041288,0.42221399999999676,17754.029946899103,28876.351802640587
"244.3.160.239",52284,"188.68.193.77",80,11,2223,6,932,5,1291,148.041546,0.42202100000000087,17667.367263714328,24472.71581272017
"244.3.160.239",52285,"188.68.193.77",80,11,2307,6,931,5,1376,148.044777,0.4192149999999799,17766.539842325197,26258.602387797495
"244.3.160.239",52286,"94.2.202.197",80,10,1888,6,1543,4,345,148.05501,0.11839299999999753,104262.92094972049,23312.189065232385
"244.3.160.239",52287,"94.2.202.197",80,10,1887,6,1543,4,344,148.141976,0.11826800000000048,104373.1186796086,23269.18524030159
"244.3.160.239",52288,"94.2.202.197",80,10,1891,6,1546,4,345,148.229382,0.11759299999999939,105176.32852295684,23470.784825627496
"244.3.160.239",52289,"94.2.202.197",80,10,1913,6,1569,4,344,148.430095,0.11731000000000336,106998.55084817698,23459.210638478573
"244.3.160.239",52290,"94.2.202.197",80,10,1870,6,1525,4,345,148.435151,0.11781799999999976,103549.54251472632,23425.96207710202
"244.3.160.239",52291,"94.2.202.197",80,10,1886,6,1543,4,343,148.435751,0.11773199999998951,104848.2995277503,23307.172221658042
"244.3.160.239",52292,"94.2.202.197",80,10,1878,6,1535,4,343,148.436232,0.11807799999999702,103999.05147445171,23238.875997222764
"244.3.160.239",52293,"188.68.193.77",80,11,2244,6,932,5,1312,148.474317,0.31879199999997354,23388.29079776349,32924.2891917014
"244.3.160.239",52294,"188.68.193.77",80,40,31432,16,1580,24,29852,148.483004,0.5783979999999929,21853.46422359717,412892.1607612802
"244.3.160.239",52295,"188.68.193.77",80,23,13986,10,1195,13,12791,148.483566,0.39912499999999795,23952.395865956903,256380.83307234707
"244.3.160.239",52296,"188.68.193.77",80,11,2519,6,948,5,1571,148.48733,0.30675600000000713,24723.23279740192,40970.6737602515
"244.3.160.239",52297,"188.68.193.77",80,11,2634,6,950,5,1684,148.487829,0.3062620000000038,24815.35417387696,43988.48045137768
"244.3.160.239",52298,"188.68.193.77",80,11,2453,6,943,5,1510,148.49497,0.2993730000000028,25199.333273207438,40351.00025720385
"244.3.160.239",52299,"94.2.202.197",80,10,1876,6,1532,4,344,148.516337,0.11718600000000379,104585.87203249197,23484.033928966866
"244.3.160.239",52300,"94.2.202.197",80,10,1895,6,1550,4,345,148.523647,0.11863399999998592,104523.1552506151,23264.83132997562
"244.3.160.239",52301,"94.2.202.197",80,10,1882,6,1538,4,344,148.528349,0.11814900000001671,104139.68802104342,23292.622028113743
"244.3.160.239",52302,"94.2.202.197",80,10,1877,6,1533,4,344,148.528901,0.11781400000000986,104096.28736821578,23358.853786475036
"244.3.160.239",52303,"94.2.202.197",80,10,1867,6,1524,4,343,148.601452,0.11738099999999463,103866.89498300881,23376.86678423361
"244.3.160.239",52304,"94.2.202.197",80,10,1875,6,1532,4,343,148.61024,0.11665299999998524,105063.73603766342,23522.755522792788
"244.3.160.239",52305,"94.2.202.197",80,10,1891,6,1546,4,345,148.615768,0.11711900000000242,105601.99455254694,23565.77498100174
"244.3.160.239",52306,"94.2.202.197",80,10,1878,6,1534,4,344,148.619546,0.11763799999999947,104320.03264251395,23393.801322701955
"244.3.160.239",52307,"94.2.202.197",80,10,1875,6,1532,4,343,148.687768,0.1169879999999921,104762.88166308364,23455.39713475045
"244.3.160.239",52308,"94.2.202.197",80,10,1895,6,1551,4,344,148.722209,0.11732000000000653,105762.0184111772,23457.211046708548
"244.3.160.239",52309,"188.68.193.77",80,11,2405,6,943,5,1462,148.915173,0.36674899999999866,20569.92657103367,31891.020834412753
"244.3.160.239",52310,"188.68.193.77",80,11,2136,6,936,5,1200,148.943473,0.41282199999997715,18138.568196463402,23254.574610850515
"244.3.160.239",52311,"188.68.193.77",80,11,2134,6,937,5,1197,148.944478,0.4113089999999886,18224.741009800924,23281.766263320922
"244.3.160.239",52312,"188.68.193.77",80,11,1655,6,910,5,745,148.944482,0.4121870000000172,17661.886473857005,14459.456508816997
"244.3.160.239",52313,"177.202.64.15",80,197,191731,69,5937,128,185794,149.070885,0.8186299999999846,58018.885210657914,1815657.8674126624
"244.3.160.239",52314,"188.68.193.77",80,11,1866,6,928,5,938,149.130897,0.4410660000000064,16831.94805312559,17013.326803698066
"244.3.160.239",52315,"188.68.193.77",80,16,6668,8,1064,8,5604,149.231486,0.44996500000002015,18917.026879867586,99634.41601012966
"244.3.160.239",52316,"188.68.193.77",80,11,1660,6,948,5,712,149.294999,0.386745000000019,19609.82042430963,14728.050782814827
"244.3.160.239",52317,"188.68.193.77",80,11,1653,6,947,5,706,149.407185,0.2747850000000085,27570.64614152798,20554.25150572202
"244.3.160.239",52318,"188.68.193.77",80,11,2214,6,948,5,1266,149.411482,0.27075199999998745,28010.873419218886,37406.92589528598
"244.3.160.239",52319,"188.68.193.77",80,11,2417,6,947,5,1470,149.41525,0.26735300000001416,28337.067472590916,43986.78900180427
"244.3.160.239",52320,"128.71.90.164",80,24,14709,11,1596,13,13113,149.55188,0.5342259999999897,23899.997379386714,196366.33185206642
"244.3.160.239",52321,"188.68.193.77",80,14,5069,7,1143,7,3926,149.665027,0.690780999999987,13237.190947637779,45467.376780775085
"244.3.160.239",52322,"43.106.84.231",80,11,1671,6,1235,5,436,150.083253,0.10366999999999393,95302.40185203606,33645.22041092123
"244.3.160.239",52323,"188.68.193.77",80,31,22384,13,1525,18,20859,150.525373,0.9766290000000026,12491.94934821715,170865.29275702397
"244.3.160.239",52324,"188.68.193.77",80,37,28560,15,1737,22,26823,150.529304,0.9964669999999956,13945.268634084281,215344.8132251253
"244.3.160.239",52325,"43.106.84.231",80,14,4313,7,1213,7,3100,151.638305,0.10579100000001063,91728.02979458579,234424.4784527749
"244.3.160.239",52326,"188.68.193.77",80,11,1738,6,1006,5,732,151.692144,0.3303449999999941,24362.408996655446,17726.921854425236
"244.3.160.239",52327,"188.68.193.77",80,11,1753,6,1013,5,740,151.69287,0.3294879999999978,24595.736415286912,17967.270431700214
"244.3.160.239",52328,"188.68.193.77",80,16,6666,8,1062,8,5604,151.700816,0.43058099999998944,19731.479094526254,104119.78234060746
"244.3.160.239",52329,"188.68.193.77",80,11,1658,6,946,5,712,151.705085,0.3176589999999919,23824.28956837424,17931.177772391606
"244.3.160.239",52330,"188.68.193.77",80,13,3619,7,1067,6,2552,151.715371,0.3068539999999871,27817.78956767831,66533.26989382853
"244.3.160.239",52331,"188.68.193.77",80,11,1651,6,945,5,706,151.778773,0.35408200000000534,21350.986494653458,15951.107370608828
"244.3.160.239",52332,"41.177.230.67",80,20,10599,9,1816,11,8783,151.843287,0.040390000000002146,359692.9933151579,1739638.5243871321
"244.3.160.239",52333,"41.177.230.67",80,11,2791,6,1548,5,1243,151.933679,0.008150000000000546,1519509.202453886,1220122.6993864214
"244.3.160.239",52334,"41.177.230.67",80,19,9234,9,1752,10,7482,151.98499,0.07280499999998824,192514.25039492155,822141.3364468054
"244.3.160.239",52335,"41.177.26.15",80,264,301634,46,5466,218,296168,151.992068,0.3749600000000157,116620.43951354323,6318924.6852995
"244.3.160.239",52336,"188.68.193.77",80,11,2415,6,945,5,1470,152.148969,0.40253699999999526,18780.88225430231,29214.705728914705
"244.3.160.239",52337,"188.68.193.77",80,11,2212,6,946,5,1266,152.15745,0.39427599999999074,19194.67581085376,25687.58940437723
"244.3.160.239",52338,"43.106.84.231",80,14,4314,7,1214,7,3100,152.317425,0.30169600000002106,32191.34492999351,82201.9516334266
"244.3.160.239",52339,"188.68.193.77",80,11,1469,6,813,5,656,152.580873,0.24393100000000345,26663.27773017742,21514.280677732335
"244.3.160.239",52340,"94.2.202.203",80,14,4029,8,2603,6,1426,152.614847,0.2723799999999983,76452.01556648848,41882.66392539861
"244.3.160.239",52341,"188.68.193.77",80,58,48062,25,2328,33,45734,153.221335,0.8706229999999948,21391.578214680878,420241.59710919904
"244.3.160.239",52342,"188.68.193.77",80,129,123572,46,3672,83,119900,153.404749,1.3365579999999966,21978.844165386072,717664.3288207488
"244.3.160.239",52343,"85.241.98.37",80,839,809075,286,19355,553,789720,154.759331,5.090486999999996,30417.521938470745,1241091.4712089442
"244.3.160.239",52344,"43.106.84.108",80,10,2275,6,1282,4,993,155.062948,0.13667999999998415,75036.58179690657,58121.158911332466
"244.3.160.239",52345,"94.2.202.203",80,13,5666,8,4459,5,1207,155.174182,0.6536609999999996,54572.63015538639,14772.183134682971
"244.3.160.239",52346,"43.106.84.108",80,10,1570,6,1007,4,563,155.749996,0.23960299999998824,33622.28352733645,18797.761296812732
"244.3.160.239",52347,"94.2.202.203",80,201,187423,70,5856,131,181567,155.796742,1.9360810000000015,24197.334718950275,750245.4701017152
"244.3.160.239",52348,"43.106.84.108",80,10,2275,6,1282,4,993,156.354029,0.1321980000000167,77580.59879876174,60091.68066081935
"244.3.160.239",52349,"43.106.84.108",80,12,2735,7,1671,5,1064,156.51706,0.12488500000000613,107042.47908074904,68158.70600952543
"244.3.160.239",52350,"43.106.84.231",80,14,4569,7,1469,7,3100,156.650696,0.10602699999998322,110839.69177664048,233902.68516513647
"244.3.160.239",52351,"43.106.84.231",80,11,1572,6,1136,5,436,156.758909,0.10371200000000158,87627.2755322418,33631.59518667027
"244.3.160.239",52352,"43.106.84.231",80,11,1581,6,1145,5,436,156.76218,0.1033610000000067,88621.43361615509,33745.80354292019
"244.3.160.239",52353,"43.106.84.108",80,22,11377,12,10188,10,1189,156.963487,0.18591100000000438,438403.32201966573,51164.26677280944
"244.3.160.239",52354,"43.106.84.231",80,14,4569,7,1469,7,3100,157.155275,0.10832200000001535,108491.34986427812,228947.0283044671
"244.3.160.239",52355,"43.106.84.231",80,11,1572,6,1136,5,436,157.259163,0.10566099999999778,86010.92172135595,33011.23404094295
"244.3.160.239",52356,"43.106.84.231",80,11,1581,6,1145,5,436,157.260686,0.10340200000001687,88586.2942689552,33732.42297053665
"244.3.160.239",52357,"94.2.202.197",80,10,1974,6,1631,4,343,157.424019,0.11729600000001028,111239.93998089326,23393.807120445366
"244.3.160.239",52358,"94.2.202.197",80,10,1974,6,1630,4,344,157.433285,0.11772999999999456,110761.91285144485,23375.520258219036
"244.3.160.239",52359,"94.2.202.197",80,10,1980,6,1637,4,343,157.435091,0.11673700000000053,112183.797767631,23505.829342881756
"244.3.160.239",52360,"94.2.202.197",80,10,1980,6,1636,4,344,157.438185,0.11895599999999718,110023.87437372062,23134.604391540277
"244.3.160.239",52361,"94.2.202.203",80,10,2219,6,1653,4,566,157.441895,0.12052700000000982,109718.15443841564,37568.34568187735
"244.3.160.239",52362,"94.2.202.197",80,10,1980,6,1636,4,344,157.647381,0.11651399999999512,112329.84877354265,23619.47920421679
"244.3.160.239",52364,"94.2.202.197",80,10,1972,6,1628,4,344,157.682091,0.1185249999999769,109883.99071927895,23218.730225695308
"244.3.160.239",52365,"94.2.202.197",80,10,1958,6,1613,4,345,157.6834,0.11763099999998872,109698.97390994923,23463.20272717451
"244.3.160.239",52366,"94.2.202.197",80,10,1962,6,1619,4,343,157.684306,0.11722000000000321,110493.0899163935,23408.97457771647
"244.3.160.239",52367,"94.2.202.197",80,10,1984,6,1640,4,344,157.75943,0.11701999999999657,112117.58673731315,23517.347461973
"244.3.160.239",52368,"94.2.202.197",80,10,1955,6,1611,4,344,157.7719,0.118977000000001,108323.45747497324,23130.521025071877
"244.3.160.239",52369,"94.2.202.197",80,10,1966,6,1623,4,343,157.772518,0.11992000000000758,108272.18145429603,22881.921280852457
"244.3.160.239",52370,"94.2.202.197",80,10,1978,6,1634,4,344,157.876055,0.11708099999998467,111649.20012642283,23505.094763457437
"244.3.160.239",52371,"94.2.202.197",80,10,1972,6,1627,4,345,157.970015,0.11721300000002088,111045.7031216476,23546.876199734743
"244.3.160.239",52372,"94.2.202.197",80,10,1981,6,1637,4,344,158.056022,0.11673999999999296,112180.91485352741,23573.75364057021
"244.3.160.239",52373,"94.2.202.197",80,10,1975,6,1630,4,345,158.148434,0.11976199999998016,108882.61719077971,23045.707319520858
"244.3.160.239",52374,"94.2.202.197",80,10,1982,6,1637,4,345,158.239257,0.11675599999998099,112165.5418137152,23639.04210490638
"244.3.160.239",52375,"85.241.98.37",80,26,13952,12,1621,14,12331,158.248914,0.4061749999999904,31927.12500769448,242870.68381855686
"244.3.160.239",52376,"94.2.202.197",80,10,1994,6,1649,4,345,158.325804,0.11734200000000783,112423.51417224114,23520.989926878832
"244.3.160.239",52377,"94.2.202.197",80,10,1994,6,1650,4,344,158.413048,0.11680699999999433,113006.92595478559,23560.231835421964
"244.3.160.239",52378,"94.2.202.197",80,10,1977,6,1633,4,344,158.499498,0.11722900000000891,111440.00204726652,23475.41990462932
"244.3.160.239",52379,"85.241.98.37",80,119,106523,43,3725,76,102798,158.66287,0.6836389999999994,43590.25743118813,1202950.68011041
"244.3.160.239",52380,"94.2.202.197",80,10,2000,6,1655,4,345,158.825019,0.11850699999999392,111723.35811387243,23289.763473888812
"244.3.160.239",52381,"94.2.202.197",80,10,1957,6,1613,4,344,158.83535,0.11674099999999044,110535.28751681978,23573.55170848481
"244.3.160.239",52382,"94.2.202.197",80,10,1967,6,1623,4,344,158.836038,0.1184379999999976,109626.97782806416,23235.78581198649
"244.3.160.239",52383,"94.2.202.197",80,10,1974,6,1631,4,343,158.836542,0.11764800000000264,110907.11274309557,23323.813409492202
"244.3.160.239",52384,"94.2.202.197",80,10,1963,6,1620,4,343,158.911509,0.11760200000000509,110202.20744544684,23332.936514684116
"244.3.160.239",52385,"94.2.202.197",80,10,1970,6,1626,4,344,158.928419,0.11739700000001108,110803.5128665875,23441.825600311255
"244.3.160.239",52386,"94.2.202.197",80,10,1965,6,1621,4,344,158.931553,0.1179960000000051,109902.03057730295,23322.8245025245
"244.3.160.239",52387,"94.2.202.197",80,10,1962,6,1619,4,343,158.932366,0.11757399999999052,110160.4096143794,23338.493204281738
"244.3.160.239",52388,"94.2.202.197",80,10,1964,6,1621,4,343,158.997757,0.11670599999999354,111116.82347095023,23512.073072508287
"244.3.160.239",52389,"94.2.202.197",80,10,1962,6,1618,4,344,159.020416,0.11867099999997777,109074.6686216719,23190.164404113184
"244.3.160.239",52390,"94.2.202.197",80,10,1964,6,1620,4,344,159.038481,0.11835200000001578,109503.85291332865,23252.6700013488
"244.3.160.239",52391,"94.2.202.197",80,10,1966,6,1622,4,344,159.038777,0.11757399999999052,110364.53637709907,23406.535458521626
"244.3.160.239",52392,"94.2.202.197",80,10,1956,6,1612,4,344,159.083279,0.11664600000000291,110556.72719167119,23592.750715840502
"244.3.160.239",52393,"94.2.202.197",80,10,1964,6,1621,4,343,159.108111,0.11685799999997926,110972.29115680828,23481.490355820628
"244.3.160.239",52394,"94.2.202.197",80,10,1964,6,1621,4,343,159.130987,0.11659499999998957,111222.6081736023,23534.456880657366
"244.3.160.239",52395,"94.2.202.197",80,10,1965,6,1621,4,344,159.141069,0.11712800000000811,110716.48111467029,23495.662864556805
"244.3.160.239",52396,"94.2.202.197",80,10,1969,6,1625,4,344,159.168839,0.12392200000002163,104904.69811653889,22207.517632055
"244.3.160.239",52397,"94.2.202.197",80,10,1965,6,1621,4,344,159.193968,0.11752299999997717,110344.35812566492,23416.69290267041
"244.3.160.239",52398,"94.2.202.197",80,10,1964,6,1620,4,344,159.2179,0.11716800000002081,110610.40557146745,23487.6416769042
"244.3.160.239",52399,"94.2.202.197",80,10,1963,6,1620,4,343,159.232181,0.11713800000001129,110638.73380114694,23425.361539378642
"244.3.160.239",52400,"94.2.202.197",80,10,1970,6,1625,4,345,159.262167,0.11774800000000596,110405.27227638128,23439.888575600948
"244.3.160.239",52401,"94.2.202.197",80,10,1968,6,1625,4,343,159.280655,0.11748000000000047,110657.13312904279,23357.167177391802
"244.3.160.239",52402,"94.2.202.197",80,10,1965,6,1621,4,344,159.304054,0.11715499999999679,110690.9649609522,23490.247962102134
"244.3.160.239",52403,"94.2.202.197",80,10,1965,6,1622,4,343,159.31827,0.11725299999997674,110666.67803811053,23402.386292892672
"244.3.160.239",52404,"94.2.202.197",80,10,1963,6,1619,4,344,159.350823,0.11782700000000546,109923.87143862952,23356.276574977488
"244.3.160.239",52405,"41.177.254.197",80,27,20177,10,1756,17,18421,159.360631,0.34574499999999375,40631.10095590755,426233.2065539709
"244.3.160.239",52406,"94.2.202.197",80,10,1968,6,1624,4,344,159.3671,0.11750399999999672,110566.44880174601,23420.479302832897
"244.3.160.239",52407,"94.2.202.197",80,10,1968,6,1625,4,343,159.390249,0.11755999999999744,110581.83055461281,23341.272541681352
"244.3.160.239",52408,"94.2.202.197",80,10,1962,6,1618,4,344,159.40384,0.11744899999999348,110209.53775681971,23431.446840757715
"244.3.160.239",52409,"94.2.202.197",80,10,1968,6,1624,4,344,159.436495,0.117999999999995,110101.69491525891,23322.033898306072
"244.3.160.239",52410,"94.2.202.197",80,10,1971,6,1626,4,345,159.453143,0.11690600000000018,111268.88269207723,23608.71127230421
"244.3.160.239",52411,"94.2.202.197",80,10,1963,6,1620,4,343,159.476591,0.11769699999999261,110113.25692244334,23314.10316320868
"244.3.160.239",52412,"85.241.98.37",80,472,447697,160,11288,312,436409,159.659271,2.063637,43759.63408293222,1691805.293275901
"244.3.160.239",52413,"43.106.84.231",80,79,71504,29,3002,50,68502,159.683693,0.5122379999999964,46884.45605363165,1069846.4385695786
"244.3.160.239",52414,"41.177.254.197",80,16,6874,8,1436,8,5438,159.764852,0.21676300000001447,52997.97474660912,200698.45868527883
"244.3.160.239",52415,"41.177.254.197",80,19,9251,9,1516,10,7735,159.768614,0.2130759999999725,56918.65813137831,290412.81045264594
"244.3.160.239",52416,"41.177.254.197",80,17,8078,9,1513,8,6565,159.769646,0.21224900000001412,57027.35937506982,247445.21764529636
"244.3.160.239",52417,"41.177.254.197",80,14,4604,8,1451,6,3153,159.785164,0.19677099999998404,58992.43282801298,128189.62143812882
"244.3.160.239",52418,"41.177.254.197",80,10,1820,6,1317,4,503,159.785424,0.1966809999999839,53568.97717624409,20459.52583116991
"244.3.160.239",52419,"41.177.254.197",80,13,3185,7,1381,6,1804,159.788259,0.19410399999998162,56917.94089766849,74351.89383011873
"244.3.160.239",52420,"41.177.254.197",80,24,15021,11,1649,13,13372,159.917715,0.1706490000000258,77304.8772626737,626877.3916048956
"244.3.160.239",52421,"41.177.254.197",80,13,4228,7,1386,6,2842,159.918098,0.17042200000000207,65062.022508830225,133410.00575042967
"244.3.160.239",52422,"41.177.254.197",80,10,2895,6,1323,4,1572,159.918754,0.16979599999999095,62333.62387806876,74065.3490070477
"244.3.160.239",52423,"41.177.254.197",80,10,2411,6,1323,4,1088,159.91977,0.1690279999999973,62616.84454646668,51494.42695884788
"244.3.160.239",52424,"41.177.254.197",80,10,2699,6,1322,4,1377,159.920312,0.168547000000018,62748.0762042568,65358.62400398004
"244.3.160.239",52425,"41.177.254.197",80,10,2884,6,1320,4,1564,159.921355,0.16788199999999165,62901.32354868613,74528.53790162508
"244.3.160.239",52426,"43.106.84.231",80,11,1654,6,1218,5,436,159.996336,0.1038639999999873,93814.98883156042,33582.37695448304
"244.3.160.239",52427,"41.177.254.197",80,12,3407,7,1388,5,2019,160.197816,0.06112200000001167,181669.4479892327,264258.3685088334
"244.3.160.239",52428,"41.177.254.197",80,10,2744,6,1323,4,1421,160.198931,0.060000000000002274,176399.9999999933,189466.6666666595
"244.3.160.239",52429,"41.177.254.197",80,12,3299,7,1387,5,1912,160.199185,0.059764999999998736,185660.50363925766,255935.74834770054
"244.3.160.239",52430,"41.177.254.197",80,10,2082,6,1318,4,764,160.199544,0.05958200000000602,176966.19784496888,102581.31650497437
"244.3.160.239",52431,"41.177.254.197",80,12,4093,7,1392,5,2701,160.199796,0.05913900000001604,188302.1356464766,365376.48590598657
"244.3.160.239",52432,"41.177.254.197",80,10,2402,6,1315,4,1087,160.200394,0.05883300000002123,178811.2113949009,147808.20287928308
"244.3.160.239",52433,"43.106.84.231",80,11,1647,6,1211,5,436,160.221754,0.10412900000000036,93038.44270088032,33496.91248355394
"244.3.160.239",52434,"43.106.84.231",80,11,1650,6,1214,5,436,160.226741,0.10322199999998816,94088.46951232407,33791.24605220205
"244.3.160.239",52435,"43.106.84.231",80,11,1649,6,1213,5,436,160.298826,0.10283300000000395,94366.59438117752,33919.072671222915
"244.3.160.239",52436,"43.106.84.231",80,11,1651,6,1215,5,436,160.380704,0.10509399999997981,92488.62922718583,33189.33526177203
"244.3.160.239",52437,"41.177.254.197",80,10,2377,6,1325,4,1052,160.438474,0.2191039999999873,48378.85205199638,38410.98291222656
"244.3.160.239",52438,"41.177.254.197",80,13,3203,7,1381,6,1822,160.440857,0.21760399999999436,50771.125530782,66984.0627929651
"244.3.160.239",52439,"43.106.84.231",80,11,1658,6,1222,5,436,160.523081,0.10564500000000976,92536.32448292959,33016.233612567354
"244.3.160.239",52440,"43.106.84.231",80,11,1655,6,1219,5,436,160.60305,0.10538400000001502,92537.76664387962,33098.00349198648
"244.3.160.239",52441,"43.106.84.231",80,11,1656,6,1220,5,436,160.687084,0.10367300000001478,94142.1585176334,33644.246814498496
"244.3.160.239",52442,"43.106.84.26",80,21,11375,9,1413,12,9962,160.766357,0.2187889999999868,51666.217222989646,364259.62914042664
"244.3.160.239",52443,"43.106.84.231",80,11,1661,6,1225,5,436,160.963719,0.10345900000001507,94723.5136624032,33713.838332087995
"244.3.160.239",52444,"43.106.84.231",80,11,1656,6,1220,5,436,161.040477,0.10287199999999075,94875.18469555251,33906.213546935156
"244.3.160.239",52445,"94.2.202.203",80,18,8737,11,7268,7,1469,161.10014,0.20790599999997994,279664.84853734676,56525.54519831623
"244.3.160.239",52446,"43.106.84.231",80,11,1656,6,1220,5,436,161.119274,0.10395800000000577,93884.06856614651,33552.01138921301
"244.3.160.239",52447,"43.106.84.231",80,14,4328,7,1228,7,3100,161.198786,0.1069919999999911,91819.94915508466,231793.03125469253
"244.3.160.239",52448,"43.106.84.231",80,11,1642,6,1206,5,436,161.200879,0.10571400000000608,91265.1115273232,32994.68376941369
"244.3.160.239",52449,"43.106.84.231",80,11,1641,6,1205,5,436,161.277866,0.10348799999999869,93150.89672232648,33704.39084724842
"244.3.160.239",52450,"43.106.84.231",80,11,1645,6,1209,5,436,161.279207,0.10516299999997614,91971.5108926352,33167.55893233163
"244.3.160.239",52451,"94.2.202.203",80,290,267999,104,8196,186,259803,161.328472,5.002233999999987,13107.743460222006,415499.1549775571
"244.3.160.239",52452,"43.106.84.231",80,11,1652,6,1216,5,436,161.353523,0.10582099999999173,91928.82320145113,32961.3214768361
"244.3.160.239",52453,"43.106.84.231",80,11,1655,6,1219,5,436,161.440069,0.10338899999999285,94323.3806304411,33736.66444206097
"244.3.160.239",52454,"43.106.84.231",80,11,1645,6,1209,5,436,161.531403,0.10418999999998846,92830.40598906873,33477.301084560764
"244.3.160.239",52455,"43.106.84.231",80,11,1644,6,1208,5,436,161.631072,0.1058540000000221,91295.55803274305,32951.04578002977
"244.3.160.239",52456,"43.106.84.231",80,11,1662,6,1226,5,436,161.632552,0.10472999999998933,93650.33896687672,33304.688245969206
"244.3.160.239",52457,"43.106.84.231",80,11,1667,6,1231,5,436,161.710274,0.10552100000001019,93327.39454704797,33055.03169984802
"244.3.160.239",52458,"43.106.84.231",80,11,1669,6,1233,5,436,161.711227,0.10373199999997951,95091.19654496152,33625.11086261413
"244.3.160.239",52459,"43.106.84.231",80,11,1667,6,1231,5,436,161.787973,0.10350099999999429,95148.83914165605,33700.15748640295
"244.3.160.239",52460,"43.106.84.231",80,11,1669,6,1233,5,436,161.788972,0.10476800000000708,94150.88576663994,33292.60843005273
"244.3.160.239",52461,"43.106.84.231",80,11,1675,6,1239,5,436,161.863681,0.1044819999999902,94868.01554335609,33383.74074003491
"244.3.160.239",52462,"43.106.84.231",80,142,135370,50,4077,92,131293,161.867532,0.7017479999999807,46478.22295183014,1496753.8204598073
"244.3.160.239",52463,"43.106.84.231",80,11,1669,6,1233,5,436,161.941281,0.10443699999999012,94449.28521501894,33398.1251855217
"244.3.160.239",52464,"43.106.84.231",80,11,1655,6,1219,5,436,162.018476,0.10357600000000389,94153.0856569054,33675.755001157304
"244.3.160.239",52465,"85.241.98.37",80,16,6452,8,1260,8,5192,162.064907,1.148128999999983,8779.501258134014,36177.119470025245
"244.3.160.239",52466,"43.106.84.108",80,13,5188,7,1150,6,4038,162.074849,0.1362410000000125,67527.39630507084,237109.2402433705
"244.3.160.239",52467,"43.106.84.231",80,11,1644,6,1208,5,436,162.094338,0.10538700000000745,91700.11481491377,33097.061307369535
"244.3.160.239",52468,"43.106.84.231",80,11,1653,6,1217,5,436,162.171722,0.10542700000002014,92348.259933396,33084.50396956504
"244.3.160.239",52469,"43.106.84.231",80,11,1660,6,1224,5,436,162.248657,0.10303299999998217,95037.51225337217,33853.231488946294
"244.3.160.239",52470,"43.106.84.231",80,11,1653,6,1217,5,436,162.324389,0.10352900000000886,94041.28311873162,33691.04308937304
"244.3.160.239",52471,"43.106.84.231",80,11,1647,6,1211,5,436,162.401322,0.10385899999999992,93280.31273168437,33583.99368374433
"244.3.160.239",52472,"43.106.84.231",80,11,1652,6,1216,5,436,162.439903,0.10385400000001255,93669.95975117786,33585.6105686789
"244.3.160.239",52473,"43.106.84.231",80,11,1652,6,1216,5,436,162.478343,0.10470399999999813,92909.5354523244,33312.95843520842
"244.3.160.239",52474,"43.106.84.231",80,11,1655,6,1219,5,436,162.516642,0.10473900000002345,93107.62944077962,33301.826444774335
"244.3.160.239",52475,"43.106.84.231",80,11,1655,6,1219,5,436,162.555667,0.1037939999999935,93955.33460508902,33605.025338653664
"244.3.160.239",52476,"43.106.84.231",80,11,1668,6,1232,5,436,162.593688,0.10570800000002123,93237.97631208632,32996.55655200457
"244.3.160.239",52477,"43.106.84.231",80,11,1656,6,1220,5,436,162.631713,0.10431500000001392,93562.76662032015,33437.1854479177
"244.3.160.239",52478,"43.106.84.231",80,14,4329,7,1229,7,3100,162.672031,0.2874689999999873,34201.94873186477,86270.17174026102
"244.3.160.239",52479,"43.106.84.231",80,11,1661,6,1225,5,436,162.707832,0.10510999999999626,93235.65788222195,33184.283131958175
"244.3.160.239",52480,"43.106.84.231",80,11,1658,6,1222,5,436,162.785416,0.1048240000000078,93261.08524764628,33274.822559716675
"244.3.160.239",52481,"177.202.64.15",80,188,183643,65,5272,123,178371,162.803751,1.0862549999999942,38826.97893220305,1313658.3951282229
"244.3.160.239",52482,"43.106.84.231",80,11,1654,6,1218,5,436,162.863359,0.10286700000000337,94724.25559216931,33907.86160770593
"244.3.160.239",52483,"43.106.84.231",80,11,1665,6,1229,5,436,162.866235,0.10531300000002375,93359.79413745485,33120.31752964224
"244.3.160.239",52484,"43.106.84.231",80,11,1650,6,1214,5,436,162.939667,0.10550100000000384,92055.99946919599,33061.29799717418
"244.3.160.239",52485,"43.106.84.231",80,11,1653,6,1217,5,436,162.943634,0.10418500000000108,93449.15294907999,33478.9077122423
"244.3.160.239",52486,"43.106.84.231",80,11,1655,6,1219,5,436,163.017155,0.1038949999999943,93863.99730497651,33572.356706291845
"244.3.160.239",52487,"43.106.84.231",80,11,1654,6,1218,5,436,163.020367,0.10437200000001212,93358.37197714778,33418.92461579346
"244.3.160.239",52488,"43.106.84.108",80,10,1460,6,1070,4,390,163.122302,0.10312000000001831,83010.08533745617,30256.012412717668
"244.3.160.239",52489,"43.106.84.231",80,11,1656,6,1220,5,436,163.198425,0.10342900000000554,94364.24987188773,33723.61716733037
"244.3.160.239",52490,"43.106.84.108",80,10,1455,6,1065,4,390,163.226344,0.10314599999998109,82601.3611773754,30248.385783264228
"244.3.160.239",52491,"43.106.84.108",80,10,1458,6,1068,4,390,163.233138,0.1023399999999981,83486.41782294468,30486.613249951708
"244.3.160.239",52492,"43.106.84.108",80,36,28752,15,1643,21,27109,163.827177,0.2120209999999929,61993.85909886492,1022879.8090755503
"244.3.160.239",52493,"43.106.84.108",80,10,2290,6,1297,4,993,164.029389,0.13489799999999263,76917.374608968,58888.93830894775
"244.3.160.239",52494,"43.106.84.108",80,10,1456,6,1066,4,390,164.16577,0.1028609999999901,82908.0020610418,30332.195875990903
"244.3.160.239",52495,"43.106.84.108",80,10,1453,6,1063,4,390,164.173487,0.10206800000000271,83317.00435003893,30567.85672296819
"244.3.160.239",52496,"43.106.84.108",80,10,1452,6,1062,4,390,164.240745,0.10205299999998374,83250.8598473475,30572.349661455293
"244.3.160.239",52497,"43.106.84.108",80,10,1463,6,1073,4,390,164.2481,0.10296099999999342,83371.37362691261,30302.735987414646
"244.3.160.239",52498,"43.106.84.108",80,10,1458,6,1068,4,390,164.316968,0.10131799999999203,84328.54971476611,30794.133322807847
"244.3.160.239",52499,"43.106.84.108",80,10,1476,6,1076,4,400,164.32345,0.10268999999999551,83825.10468400405,31161.74895316136
"244.3.160.239",52500,"94.2.202.197",80,12,2350,7,1943,5,407,164.328076,0.11751300000000242,132274.72705147244,27707.572779181308
"244.3.160.239",52501,"94.2.202.197",80,12,2351,7,1944,5,407,164.329791,0.11707300000000487,132840.193725277,27811.707225405215
"244.3.160.239",52502,"43.106.84.108",80,10,1456,6,1066,4,390,164.390999,0.11029200000001538,77322.01791606654,28288.543140024343
"244.3.160.239",52503,"94.2.202.197",80,12,2345,7,1938,5,407,164.397967,0.11751699999999232,131929.8484474673,27706.629679112066
"244.3.160.239",52504,"43.106.84.108",80,10,1468,6,1068,4,400,164.399312,0.10561799999999266,80895.30193717542,30297.86589407319
"244.3.160.239",52505,"94.2.202.197",80,12,2345,7,1937,5,408,164.400584,0.11832699999999363,130959.12175581933,27584.574949083268
"244.3.160.239",52506,"94.2.202.203",80,12,2590,7,1960,5,630,164.658381,0.120900000000006,129693.96195202004,41687.344913149296
"244.3.160.239",52507,"43.106.84.108",80,10,1585,6,1022,4,563,164.949808,0.2462409999999977,33203.243976429905,18291.023834373813
"244.3.160.239",52508,"43.106.84.108",80,10,2290,6,1297,4,993,165.011807,0.13228300000000104,78437.89451403369,60053.0680435123
"244.3.160.239",52509,"198.123.241.156",80,36,28996,12,2264,24,26732,165.239597,0.5732069999999965,31597.660182098458,373086.8604186643
"244.3.160.239",52510,"43.106.84.108",80,12,2589,7,1686,5,903,165.358256,0.12243499999999585,110164.57712255856,59002.73614571197
"244.3.160.239",52511,"43.106.84.231",80,14,4584,7,1484,7,3100,165.479374,0.10527099999998768,112775.59821794597,235582.44910756906
"244.3.160.239",52512,"244.3.31.75",80,13,3865,7,1090,6,2775,165.500651,0.29737599999998565,29323.14645432187,74652.9645970121
"244.3.160.239",52513,"94.2.202.197",80,12,2351,7,1943,5,408,165.626879,0.11817899999999781,131529.29031384838,27619.1201482502
"244.3.160.239",52514,"43.106.84.231",80,11,1572,6,1136,5,436,165.631751,0.10367599999997879,87657.70284349183,33643.27327443877
"244.3.160.239",52515,"43.106.84.231",80,11,1581,6,1145,5,436,165.632803,0.10587900000001582,86513.85071637087,32943.26542562244
"244.3.160.239",52516,"198.123.241.156",80,11,3036,6,1482,5,1554,165.691302,0.3650289999999927,32479.611208973085,34057.56802884222
"244.3.160.239",52517,"198.123.241.156",80,423,427419,144,10354,279,417065,165.695868,1.7744880000000194,46679.38019304672,1880271.9432309284
"244.3.160.239",52518,"43.106.84.108",80,12,3298,7,2429,5,869,165.778695,0.10722599999999716,181224.7029638382,64835.021356762205
"244.3.160.239",52519,"43.106.84.231",80,14,4584,7,1484,7,3100,165.8853,0.10774200000000178,110189.15557535412,230179.50288652143
"244.3.160.239",52520,"244.3.31.75",80,50,40681,19,1880,31,38801,165.904312,0.06291500000000383,239052.69013747253,4933767.781927698
"244.3.160.239",52521,"94.2.202.197",80,12,2334,7,1926,5,408,165.952976,0.11703399999998965,131654.04925065677,27889.331305435077
"244.3.160.239",52522,"94.2.202.197",80,12,2328,7,1920,5,408,165.971501,0.11735800000002428,130881.57603228431,27812.33490686042
"244.3.160.239",52523,"43.106.84.231",80,11,1572,6,1136,5,436,165.972162,0.10355799999999249,87757.58512138762,33681.6083740537
"244.3.160.239",52524,"43.106.84.231",80,11,1581,6,1145,5,436,165.974146,0.104723000000007,87468.84638521993,33306.914431402525
"244.3.160.239",52525,"94.2.202.197",80,12,2326,7,1918,5,408,166.018038,0.11722800000001143,130890.23100281932,27843.177397888572
"244.3.160.239",52526,"94.2.202.197",80,12,2342,7,1935,5,407,166.216647,0.1175190000000157,131723.3809000922,27706.158153146003
"244.3.160.239",52527,"94.2.202.197",80,12,2509,7,1982,5,527,166.264986,0.11860500000000229,133687.44993887015,35546.562117953865
"244.3.160.239",52528,"244.3.31.75",80,13,3387,7,1424,6,1963,166.371489,0.26334900000000516,43258.185905394654,59631.89531761917
"244.3.160.239",52529,"244.3.31.75",80,11,2494,6,923,5,1571,166.388872,0.056430000000005975,130852.38348394858,222718.4121920728
"244.3.160.239",52530,"94.2.202.197",80,12,2356,7,1947,5,409,166.568447,0.11748300000002132,132580.88404277363,27850.837993576995
"244.3.160.239",52531,"94.2.202.197",80,12,2673,7,1990,5,683,166.745413,0.11929299999999898,133452.92682722487,45803.190463816376
"244.3.160.239",52532,"94.2.202.197",80,12,2673,7,1990,5,683,166.766923,0.11936000000000035,133378.0160857905,45777.47989276126
"244.3.160.239",52533,"94.2.202.197",80,12,2673,7,1990,5,683,166.769975,0.12358500000001982,128818.22227614555,44212.48533397357
"244.3.160.239",52534,"94.2.202.197",80,12,2673,7,1990,5,683,166.829339,0.11996399999998175,132706.47861026993,45546.99743257003
"244.3.160.239",52535,"94.2.202.197",80,12,2673,7,1990,5,683,166.836414,0.14314300000000912,111217.45387478944,38171.61859119658
"244.3.160.239",52536,"94.2.202.197",80,12,2349,7,1941,5,408,166.850998,0.11689699999999448,132834.8888337659,27922.01681822591
"244.3.160.239",52537,"94.2.202.197",80,12,2673,7,1990,5,683,166.860165,0.13971300000000042,113947.87886596059,39108.744354498034
"244.3.160.239",52538,"94.2.202.197",80,12,2673,7,1990,5,683,166.883007,0.12336000000001945,129053.17769128963,44293.12581062855
"244.3.160.239",52539,"94.2.202.197",80,12,2674,7,1990,5,684,166.891411,0.13268999999999664,119978.89818373957,41238.97806918486
"244.3.160.239",52540,"41.177.254.197",80,36,23771,16,2586,20,21185,167.010743,1.943000000000012,10647.452393206317,87225.93926917085
"244.3.160.239",52541,"94.2.202.197",80,12,2674,7,1990,5,684,167.066932,0.14785599999999022,107672.32983444062,37008.98171193839
"244.3.160.239",52542,"94.2.202.197",80,12,2343,7,1934,5,409,167.068599,0.11764600000000769,131513.18361864396,27812.250310250976
"244.3.160.239",52543,"94.2.202.197",80,12,2673,7,1990,5,683,167.069986,0.14138500000001386,112600.34657140743,38646.24960214637
"244.3.160.239",52544,"94.2.202.197",80,12,2672,7,1990,5,682,167.073427,0.14652799999998933,108648.17645774977,37235.204193057965
"244.3.160.239",52545,"94.2.202.197",80,12,2672,7,1990,5,682,167.075564,0.15053399999999328,105756.83898654596,36244.30361247455
"244.3.160.239",52546,"94.2.202.197",80,14,4199,8,1978,6,2221,167.092376,0.15500900000000684,102084.39509963487,114625.60238437263
"244.3.160.239",52547,"94.2.202.197",80,12,2352,7,1944,5,408,167.254081,0.11769499999999766,132138.1537023689,27732.698925188535
"244.3.160.239",52548,"198.123.241.156",80,14,2631,7,2059,7,572,167.294621,0.33132799999998497,49715.085957120275,13811.087502415152
"244.3.160.239",52549,"94.2.202.197",80,14,4174,8,1978,6,2196,167.301455,0.3363379999999836,47047.91013801822,52233.170203785645
"244.3.160.239",52550,"94.2.202.197",80,14,4137,8,1978,6,2159,167.303495,0.3340400000000159,47371.57226679214,51706.38246916291
"244.3.160.239",52551,"94.2.202.197",80,14,3996,8,1978,6,2018,167.305363,0.33323100000001205,47486.57837956081,48446.8731900676
"244.3.160.239",52552,"94.2.202.197",80,12,2338,7,1930,5,408,167.307068,0.11907300000001442,129668.35470676082,27411.755813657208
"244.3.160.239",52554,"94.2.202.197",80,12,2345,7,1937,5,408,167.310479,0.11766200000002414,131699.27419215057,27740.476959420463
"244.3.160.239",52555,"94.2.202.197",80,12,2353,7,1944,5,409,167.516136,0.11700400000000855,132918.53269972705,27964.85590236027
"244.3.160.239",52556,"94.2.202.197",80,12,2365,7,1956,5,409,167.526311,0.11830900000001066,132263.8176300923,27656.391314267767
"244.3.160.239",52557,"244.3.31.75",443,21,6010,11,1957,10,4053,167.593711,0.11286899999998923,138709.4773587211,287271.0841772594
"244.3.160.239",52558,"94.2.202.197",80,12,2349,7,1940,5,409,167.747797,0.11720300000001771,132419.8186053058,27917.374128644366
"244.3.160.239",52559,"244.3.31.75",80,11,2857,6,1492,5,1365,167.783988,0.006186000000013792,1929518.2670503377,1765276.430645919
"244.3.160.239",52560,"244.3.31.75",80,140,136288,50,4249,90,132039,167.95203,0.7784240000000011,43667.718364284694,1356987.9654275798
"244.3.160.239",52561,"94.2.202.197",80,12,2365,7,1957,5,408,168.450756,0.11772599999997624,132986.7658801213,27725.396259115732
"244.3.160.239",52566,"94.2.202.197",80,12,2335,7,1927,5,408,168.886776,0.11942899999999668,129080.87650403527,27330.04546634478
"244.3.160.239",52567,"94.2.202.197",80,12,2370,7,1962,5,408,168.899955,0.1188669999999945,132046.74131593062,27459.261191080375
"244.3.160.239",52568,"94.2.202.197",80,12,2340,7,1933,5,407,168.913757,0.11743200000000797,131684.71966754334,27726.68437904301
"244.3.160.239",52569,"94.2.202.197",80,12,2346,7,1938,5,408,168.922095,0.11918799999997987,130080.20941707738,27385.3072457005
"244.3.160.239",52570,"94.2.202.197",80,12,2337,7,1930,5,407,168.923396,0.11747400000001562,131433.33844082901,27716.771370682593
"244.3.160.239",52571,"94.2.202.197",80,12,2328,7,1920,5,408,168.923747,0.11805400000000077,130109.94968404205,27648.364307858934
"244.3.160.239",52572,"41.177.254.197",80,10,2466,6,1456,4,1010,169.020319,0.14687699999998927,79304.45202448887,55012.01685764681
"244.3.160.239",52573,"41.177.254.197",80,12,3342,7,1522,5,1820,169.022411,0.1451849999999979,83865.41309364037,100285.84220133079
"244.3.160.239",52575,"94.2.202.197",80,12,2335,7,1928,5,407,169.110478,0.11763400000000956,131118.55415950104,27679.0723770316
"244.3.160.239",52576,"94.2.202.197",80,12,2332,7,1925,5,407,169.134562,0.11693500000001222,131697.09667762765,27844.529011841278
"244.3.160.239",52577,"94.2.202.197",80,12,2336,7,1928,5,408,169.136327,0.12015500000001111,128367.525279835,27164.911988678774
"244.3.160.239",52578,"94.2.202.197",80,12,2334,7,1926,5,408,169.140767,0.11946499999999105,128975.01360231996,27321.809735070896
"244.3.160.239",52579,"94.2.202.197",80,12,2340,7,1932,5,408,169.183673,0.11776000000000408,131249.99999999546,27717.391304346864
"244.3.160.239",52580,"94.2.202.197",80,12,2335,7,1927,5,408,169.197274,0.11791400000001317,130739.3524093685,27681.191376763025
"244.3.160.239",52581,"94.2.202.197",80,12,2337,7,1929,5,408,169.208611,0.11721700000001078,131653.2584863849,27845.790286389343
"244.3.160.239",52583,"94.2.202.197",80,12,2328,7,1919,5,409,169.276962,0.11845199999999068,129605.2409414886,27623.00341066641
"244.3.160.239",52584,"94.2.202.197",80,12,2336,7,1928,5,408,169.285838,0.11925999999999704,129330.87372128444,27368.774106993806
"244.3.160.239",52585,"94.2.202.197",80,12,2336,7,1928,5,408,169.29209,0.11785599999998908,130871.57208798389,27694.814010320242
"244.3.160.239",52586,"244.3.31.75",80,11,2232,6,1096,5,1136,169.295334,0.021891000000010763,400529.89813145535,415147.77762530406
"244.3.160.239",52587,"94.2.202.197",80,12,2327,7,1919,5,408,169.297304,0.11817400000001044,129910.13251644731,27620.288726790255
"244.3.160.239",52588,"94.2.202.197",80,12,2336,7,1928,5,408,169.309868,0.11858900000001427,130062.65336581087,27523.63204006786
"244.3.160.239",52589,"94.2.202.197",80,12,2335,7,1928,5,407,169.3136,0.11781199999998648,130920.4495297743,27637.252571897374
"244.3.160.239",52590,"94.2.202.197",80,12,2340,7,1932,5,408,169.450874,0.12143299999999613,127280.06390355581,26879.01970634098
"244.3.160.239",52591,"94.2.202.197",80,12,2336,7,1928,5,408,169.459407,0.1168169999999975,132035.57701362242,27941.138704127563
"244.3.160.239",52592,"94.2.202.197",80,12,2329,7,1921,5,408,169.462167,0.11778100000000791,130479.44914713722,27712.449376383127
"244.3.160.239",52593,"94.2.202.197",80,12,2335,7,1927,5,408,169.468525,0.11981099999999856,128669.32084700224,27242.907579437942
"244.3.160.239",52594,"94.2.202.197",80,12,2334,7,1927,5,407,169.469913,0.11677199999999743,132017.9495084467,27883.396704690094
"244.3.160.239",52595,"94.2.202.197",80,12,2337,7,1928,5,409,169.488371,0.11769200000000524,131053.93739590893,27801.37987288732
"244.3.160.239",52596,"94.2.202.197",80,12,2336,7,1929,5,407,169.54578,0.12013399999997887,128456.55684487917,27103.06824046958
"244.3.160.239",52597,"94.2.202.197",80,11,2270,7,1926,4,344,169.576097,0.11998700000000895,128413.91150707036,22935.818046953376
"244.3.160.239",52598,"94.2.202.197",80,12,2339,7,1932,5,407,169.661882,0.11785800000001245,131140.86443006303,27626.46574691286
"244.3.160.239",52599,"94.2.202.197",80,12,2339,7,1931,5,408,169.66237,0.11732799999998633,131665.07568527377,27819.44633847317
"244.3.160.239",52600,"94.2.202.197",80,12,2328,7,1920,5,408,169.708398,0.11713300000002391,131132.9855804672,27865.75943584928
"244.3.160.239",52601,"94.2.202.197",80,12,2333,7,1926,5,407,169.709544,0.1173339999999996,131317.43569638854,27749.8423304414
"244.3.160.239",52602,"94.2.202.197",80,12,2337,7,1928,5,409,169.717159,0.11831300000000056,130366.06290094857,27655.45628967218
"244.3.160.239",52603,"94.2.202.197",80,12,2333,7,1924,5,409,169.717963,0.11790700000000243,130543.56399534958,27750.684861797286
"244.3.160.239",52604,"244.3.31.75",80,11,1557,6,1003,5,554,169.775064,0.012297000000017988,652516.8740333628,360413.1088878195
"244.3.160.239",52605,"94.2.202.197",80,12,2338,7,1930,5,408,169.825904,0.12151199999999562,127065.63960761535,26861.544538811948
"244.3.160.239",52606,"94.2.202.197",80,12,2341,7,1932,5,409,169.848447,0.12975199999999631,119119.55114372371,25217.33769036387
"244.3.160.239",52607,"94.2.202.197",80,12,2335,7,1927,5,408,169.926144,0.11911900000001197,129416.80168569625,27401.17025831036
"244.3.160.239",52608,"94.2.202.197",80,12,2341,7,1932,5,409,169.926812,0.11852399999997942,130403.96881646488,27606.22321218123
"244.3.160.239",8080,"244.3.160.204",1097,2,128,1,64,1,64,171.116693,7.500000000959517e-5,0,0
"244.3.160.239",52610,"41.177.254.197",80,38,26376,17,3513,21,22863,171.20688,0.042756999999994605,657295.8813762319,4277755.689127467
"244.3.160.239",52611,"41.177.254.197",80,13,3937,7,1518,6,2419,171.300945,0.21638599999999997,56121.93025426784,89432.77291506846
"244.3.160.239",52612,"41.177.254.197",80,13,3311,7,1512,6,1799,171.301764,0.21583200000000602,56043.58945846614,66681.49301308239
"244.3.160.239",52613,"41.177.254.197",80,10,3024,6,1451,4,1573,171.349682,0.1682079999999928,69009.79739370599,74812.1373537557
"244.3.160.239",52614,"41.177.254.197",80,10,2304,6,1450,4,854,171.384439,0.1337700000000268,86716.00508333465,51072.73678701226
"244.3.160.239",52615,"41.177.254.197",80,10,2220,6,1445,4,775,171.387684,0.131054000000006,88207.91429486677,47308.74296091471
"244.3.160.239",52616,"41.177.254.197",80,10,2525,6,1454,4,1071,171.388047,0.13097300000001155,88812.19793391747,65418.063264941964
"244.3.160.239",52617,"41.177.254.197",80,10,3079,6,1447,4,1632,171.795577,0.22203700000000026,52135.45490166047,58801.01064237035
"244.3.160.239",52618,"244.3.31.75",80,52,42408,20,2017,32,40391,172.407693,0.08510400000000118,189603.30889264637,3796860.312088686
"244.3.160.239",52619,"244.3.31.75",80,11,1946,6,1109,5,837,172.415363,0.01291699999998741,686846.791051223,518386.62228122057
"244.3.160.239",52620,"244.3.31.75",80,14,4734,7,1169,7,3565,172.627351,0.012871999999987338,726538.2224991609,2215661.9018045412
"244.3.160.239",52621,"244.3.31.75",80,19,8619,9,1290,10,7329,172.671341,0.01999599999999191,516103.22064433765,2932186.437288644
"244.3.160.239",52622,"244.3.31.75",80,11,2338,6,1100,5,1238,172.73132,0.015559999999993579,565552.6992290252,636503.8560413938
"244.3.160.239",52624,"244.3.31.75",80,11,1959,6,1138,5,821,172.931546,0.03771399999999403,241395.76814979693,174152.83449119795
"244.3.160.239",52625,"244.3.31.75",80,11,2735,6,1142,5,1593,172.939798,0.029738000000008924,307216.3561771894,428542.60542054527
"244.3.160.239",52626,"244.3.31.75",80,11,2160,6,1155,5,1005,172.943593,0.02609800000001883,354050.11878279306,308069.58387593686
"244.3.160.239",52631,"244.3.31.75",80,11,2736,6,1134,5,1602,173.101582,0.15491099999999847,58562.658558785944,82731.37478939602
"244.3.160.239",52632,"244.3.31.75",80,11,2119,6,1142,5,977,173.105303,0.15148300000001313,60310.39786642203,51596.548787648266
"244.3.160.239",8080,"244.3.160.204",1431,2,128,1,64,1,64,173.116278,7.300000001464468e-5,0,0
"244.3.160.239",52633,"244.3.31.75",80,11,1895,6,1138,5,757,173.131509,0.12629000000001156,72088.0513104693,47953.12376276384
"244.3.160.239",52634,"41.177.254.197",80,28,18037,13,2704,15,15333,173.222071,0.1586200000000133,136376.24511409775,773319.8839994308
"244.3.160.239",52635,"244.3.31.75",80,11,1944,6,1145,5,799,173.253473,0.06477399999999989,141414.76518356154,98681.56976564688
"244.3.160.239",52636,"244.3.31.75",80,11,2751,6,1142,5,1609,173.309403,0.11715300000000184,77983.49167328072,109873.41339956978
"244.3.160.239",52637,"244.3.31.75",80,11,2746,6,1146,5,1600,173.313327,0.11471800000001053,79917.71125716242,111577.95637998244
"244.3.160.239",52638,"244.3.31.75",80,11,2739,6,1141,5,1598,173.317501,0.11129200000002015,82018.47392443614,114868.99327892109
"244.3.160.239",52639,"244.3.31.75",80,11,2226,6,1134,5,1092,173.321431,0.10757300000000214,84333.42939213203,81209.96904427529
"244.3.160.239",52640,"244.3.31.75",80,13,3051,7,1206,6,1845,173.327419,0.10187100000001692,94708.01307534428,144889.12448093714
"244.3.160.239",52641,"41.177.254.197",80,13,4906,7,1508,6,3398,173.378957,0.05051399999999262,238824.8802312579,538147.8402027946
"244.3.160.239",52642,"244.3.31.75",80,13,3071,7,1205,6,1866,173.418691,0.11779899999999088,81834.31098736616,126724.33552068485
"244.3.160.239",52643,"244.3.31.75",80,16,6783,8,1265,8,5518,173.581573,0.17488400000002002,57866.928935745076,252418.74614026982
"244.3.160.239",52644,"244.3.31.75",80,11,2862,6,1139,5,1723,173.617334,0.1399590000000046,65104.78068577012,98485.9851813713
"244.3.160.239",52645,"244.3.31.75",80,11,2191,6,1146,5,1045,173.745358,0.05159499999999184,177691.6367865384,162031.20457411226
"244.3.160.239",52646,"94.2.202.203",80,25,14327,16,13066,9,1261,174.859976,1.6290450000000192,64165.20108406997,6192.585226313504
"244.3.160.239",8080,"244.3.160.204",1767,2,128,1,64,1,64,175.116122,7.700000000454565e-5,0,0
"244.3.160.239",52647,"94.2.202.203",80,206,192736,72,5984,134,186752,176.457737,1.6397389999999916,29194.890162397944,911130.3689184728
"244.3.160.239",52648,"43.106.84.231",80,14,4313,7,1213,7,3100,177.091761,0.10550000000000637,91981.04265402288,235071.09004737917
"244.3.160.239",8080,"244.3.160.204",2098,2,128,1,64,1,64,177.116606,7.10000000196942e-5,0,0
"244.3.160.239",52649,"43.106.84.231",80,14,4314,7,1214,7,3100,177.474459,0.2848079999999982,34100.16572568208,87076.20572455885
"244.3.160.239",52650,"94.2.202.197",80,10,1921,6,1578,4,343,177.784515,0.11771999999999139,107237.51274210775,23309.548080191988
"244.3.160.239",52651,"94.2.202.197",80,10,1927,6,1582,4,345,177.796068,0.11853200000001607,106772.85458777616,23284.85134815599
"244.3.160.239",52652,"94.2.202.197",80,10,1886,6,1543,4,343,177.798778,0.11762999999999124,104939.21618635484,23327.382470459954
"244.3.160.239",52653,"94.2.202.197",80,10,1885,6,1542,4,343,177.800831,0.1169840000000022,105450.31799220208,23456.199138343265
"244.3.160.239",52654,"94.2.202.203",80,10,2131,6,1565,4,566,177.805696,0.12040700000000015,103980.66557592154,37605.78703895948
"244.3.160.239",52655,"94.2.202.197",80,10,1892,6,1549,4,343,177.875334,0.11758000000000379,105392.07348188128,23337.30226228875
"244.3.160.239",52656,"94.2.202.197",80,10,1891,6,1548,4,343,177.900602,0.11665800000000104,106156.45733682979,23521.747329801434
"244.3.160.239",52657,"94.2.202.197",80,10,2024,6,1562,4,462,177.974104,0.11783599999998273,106045.69062087843,31365.62680335841
"244.3.160.239",52658,"94.2.202.197",80,10,1911,6,1566,4,345,177.979093,0.11827599999998029,105921.74236533268,23335.24975481467
"244.3.160.239",52659,"94.2.202.197",80,10,1892,6,1548,4,344,178.092423,0.11702500000001237,105823.5419781986,23516.34266182191
"244.3.160.239",52660,"94.2.202.197",80,10,1891,6,1546,4,345,178.204796,0.1175010000000043,105258.67864953956,23489.16179436685
"244.3.160.239",52661,"94.2.202.197",80,10,1884,6,1540,4,344,178.299565,0.11814300000000344,104280.40594872012,23293.80496516865
"244.3.160.239",52662,"94.2.202.197",80,10,1895,6,1550,4,345,178.418234,0.11707399999997392,105915.91642894888,23574.83301160475
"244.3.160.239",52663,"94.2.202.197",80,10,1884,6,1539,4,345,178.424424,0.11759600000002024,104697.43868837274,23470.186060746328
"244.3.160.239",52664,"94.2.202.197",80,10,1895,6,1551,4,344,178.511129,0.11692899999999895,106115.67703478274,23535.649838791272
"244.3.160.239",52665,"94.2.202.197",80,10,1887,6,1542,4,345,178.596915,0.11772899999999709,104783.01862752852,23443.671482812802
"244.3.160.239",52666,"94.2.202.197",80,10,1884,6,1539,4,345,178.683701,0.11861599999997452,103797.12686317736,23268.361772447166
"244.3.160.239",52667,"94.2.202.197",80,10,1907,6,1562,4,345,178.771625,0.1173729999999864,106464.00790643033,23514.777674595687
"244.3.160.239",52668,"94.2.202.197",80,10,2005,6,1543,4,462,178.858394,0.11994999999998868,102909.54564402805,30812.838682787402
"244.3.160.239",52669,"94.2.202.197",80,10,1885,6,1540,4,345,178.950596,0.11733100000000718,105002.0881097003,23523.195063536758
"244.3.160.239",8080,"244.3.160.204",2437,2,128,1,64,1,64,179.11644,6.999999999379725e-5,0,0
"244.3.160.239",52671,"94.2.202.197",80,10,1870,6,1525,4,345,179.25145,0.11928699999998571,102274.34674358029,23137.475164941116
"244.3.160.239",52672,"94.2.202.197",80,10,1887,6,1543,4,344,179.251969,0.11962199999999257,103191.7205865206,23005.801608401223
"244.3.160.239",52673,"94.2.202.197",80,10,1878,6,1535,4,343,179.25254,0.11917299999998932,103043.47461254732,23025.34970169624
"244.3.160.239",52674,"94.2.202.197",80,10,1875,6,1532,4,343,179.253046,0.11892499999999018,103056.54824470055,23073.365566535434
"244.3.160.239",52675,"94.2.202.197",80,10,1881,6,1538,4,343,179.374308,0.1178639999999973,104391.50207018497,23281.069707459978
"244.3.160.239",52676,"94.2.202.197",80,10,1876,6,1533,4,343,179.381598,0.11648999999999887,105279.42312644965,23555.670014593754
"244.3.160.239",52677,"94.2.202.197",80,10,1875,6,1531,4,344,179.382337,0.1188410000000033,103062.0745365628,23156.991274054606
"244.3.160.239",52678,"94.2.202.197",80,10,1884,6,1540,4,344,179.382702,0.11878699999999753,103715.05299401665,23167.518331130992
"244.3.160.239",52679,"94.2.202.197",80,10,1875,6,1532,4,343,179.4611,0.11769000000001029,104137.98963377457,23315.4898462041
"244.3.160.239",52680,"94.2.202.197",80,10,1876,6,1533,4,343,179.470327,0.11741200000000163,104452.69648758075,23370.694647906195
"244.3.160.239",52681,"94.2.202.197",80,10,1878,6,1534,4,344,179.482026,0.1173740000000123,104554.67139229058,23446.419138818746
"244.3.160.239",52682,"94.2.202.197",80,10,1876,6,1533,4,343,179.482552,0.11796699999999305,103961.27730637147,23260.74241101462
"244.3.160.239",52683,"94.2.202.197",80,10,1867,6,1524,4,343,179.547246,0.11729099999999448,103946.5943678592,23394.804375443375
"244.3.160.239",52684,"94.2.202.197",80,10,1868,6,1524,4,344,179.556809,0.12578500000000759,96927.29657748749,21878.602377070667
"244.3.160.239",52685,"94.2.202.197",80,9,1812,6,1532,3,280,179.569156,0.13179999999999836,92989.37784522118,16995.447647951652
"244.3.160.239",52686,"94.2.202.197",80,10,1874,6,1531,4,343,179.573119,0.1180270000000121,103772.86553075774,23248.91762054207
"244.3.160.239",52687,"94.2.202.197",80,10,1874,6,1530,4,344,179.63355,0.1174699999999973,104196.81620839603,23427.25802332564
"244.3.160.239",52688,"94.2.202.197",80,10,1880,6,1536,4,344,179.66176,0.117321000000004,104738.28214897231,23457.011106280257
"244.3.160.239",52689,"94.2.202.197",80,10,1875,6,1530,4,345,179.667786,0.11881199999999126,103019.8969801106,23229.97677002494
"244.3.160.239",52690,"94.2.202.197",80,10,1879,6,1536,4,343,179.69129,0.11719999999999686,104846.41638225537,23412.969283277078
"244.3.160.239",52691,"198.123.241.156",80,479,470631,166,11482,313,459149,179.693504,5.388326000000006,17047.2239430205,681694.4631783592
"244.3.160.239",52692,"94.2.202.197",80,10,1876,6,1533,4,343,179.850334,0.1168299999999931,104973.03774716018,23487.118034752733
"244.3.160.239",52693,"94.2.202.197",80,10,1876,6,1533,4,343,179.854572,0.117479000000003,104393.1255798882,23357.365997326586
"244.3.160.239",52694,"94.2.202.197",80,10,1876,6,1532,4,344,179.854814,0.11874599999998736,103211.8976639323,23175.517491117957
"244.3.160.239",52695,"94.2.202.197",80,10,1875,6,1532,4,343,179.855932,0.11716499999999996,104604.61741987798,23419.9632996202
"244.3.160.239",52696,"94.2.202.197",80,9,1814,6,1534,3,280,179.93922,0.11882299999999191,103279.66807773609,18851.569140655873
"244.3.160.239",52697,"94.2.202.197",80,10,1880,6,1536,4,344,179.94491,0.1179830000000095,104150.59796749541,23325.394336470326
"244.3.160.239",52698,"94.2.202.197",80,10,1877,6,1534,4,343,179.968662,0.11656300000001352,105282.12211420928,23540.9177869451
"244.3.160.239",52699,"94.2.202.197",80,10,1879,6,1535,4,344,179.975081,0.11716499999999996,104809.45674902918,23488.243076003935
"244.3.160.239",52700,"94.2.202.197",80,10,1878,6,1535,4,343,180.026253,0.11698699999999462,104968.92817151106,23455.597630507033
"244.3.160.239",52701,"94.2.202.197",80,10,1875,6,1532,4,343,180.051878,0.11642000000000507,105274.00790241768,23569.83336196427
"244.3.160.239",52702,"94.2.202.197",80,10,1879,6,1535,4,344,180.056075,0.11760400000000004,104418.21706744665,23400.564606646025
"244.3.160.239",52703,"43.106.84.108",80,10,2275,6,1282,4,993,180.341831,0.1383899999999869,74109.40096828506,57402.99154563734
"244.3.160.239",52704,"43.106.84.108",80,10,1570,6,1007,4,563,181.047989,0.28094200000001024,28674.957820474356,16031.778801317838
"244.3.160.239",8080,"244.3.160.204",2768,2,128,1,64,1,64,181.117217,7.199999998874773e-5,0,0
"244.3.160.239",52705,"244.3.31.75",80,14,5936,7,1405,7,4531,181.560795,0.05193599999998355,216420.2094886699,697935.921133924
"244.3.160.239",52706,"244.3.31.75",80,13,3929,7,1388,6,2541,181.631611,0.2756750000000068,40279.314410083345,73739.00426226354
"244.3.160.239",52707,"43.106.84.108",80,10,2275,6,1282,4,993,181.641265,0.14402100000000928,71211.83716263142,55158.62270085257
"244.3.160.239",52708,"43.106.84.108",80,12,2574,7,1671,5,903,181.825624,0.12215199999999982,109437.42222804391,59139.432837775974
"244.3.160.239",52709,"244.3.31.75",80,11,3200,6,1433,5,1767,181.930739,0.26949200000001383,42539.29615721213,52454.24725037951
"244.3.160.239",52710,"43.106.84.231",80,14,4569,7,1469,7,3100,181.996533,0.10605799999999022,110807.29412209436,233834.3170718125
"244.3.160.239",52711,"43.106.84.231",80,11,1572,6,1136,5,436,182.112023,0.1044119999999964,87039.80385396615,33406.12190169827
"244.3.160.239",52712,"43.106.84.231",80,11,1581,6,1145,5,436,182.117232,0.10321799999999826,88744.21128097962,33792.555562014946
"244.3.160.239",52713,"244.3.31.75",80,11,2720,6,1509,5,1211,182.212987,0.006728000000009615,1794292.5089153906,1439952.4375722585
"244.3.160.239",52714,"244.3.31.75",80,43,35918,17,2154,26,33764,182.223474,0.22983399999998255,74975.85213676527,1175248.2226303355
"244.3.160.239",52715,"43.106.84.108",80,22,11377,12,10188,10,1189,182.305394,0.183164000000005,444978.27083923575,51931.60227992259
"244.3.160.239",52716,"94.2.202.203",80,40,24573,27,23172,13,1401,182.410578,0.2933830000000057,631856.6515442148,38202.622510506
"244.3.160.239",52717,"244.3.31.75",80,11,1901,6,1279,5,622,182.444094,0.005223000000000866,1959027.37890069,952709.1709743778
"244.3.160.239",52718,"244.3.31.75",80,11,1912,6,1292,5,620,182.446367,0.012981999999993832,796179.325219913,382067.4780467075
"244.3.160.239",52719,"244.3.31.75",80,11,1903,6,1281,5,622,182.447622,0.005555000000015298,1844824.4824431643,895769.5769552289
"244.3.160.239",52720,"244.3.31.75",80,11,1900,6,1279,5,621,182.450276,0.006920000000008031,1478612.7167612899,717919.0751436756
"244.3.160.239",52721,"244.3.31.75",80,13,3188,7,1296,6,1892,182.476609,0.03774500000000103,274685.38879321015,401006.7558616926
"244.3.160.239",52722,"43.106.84.231",80,14,4569,7,1469,7,3100,182.576556,0.10532899999998335,111574.21033145532,235452.72432097446
"244.3.160.239",52723,"43.106.84.231",80,11,1572,6,1136,5,436,182.68189,0.1033559999999909,87929.09942336004,33747.43604628959
"244.3.160.239",52724,"43.106.84.231",80,11,1581,6,1145,5,436,182.682992,0.10469299999999748,87493.9107676752,33316.45859799685
"244.3.160.239",52725,"94.2.202.203",80,78,67368,29,3649,49,63719,182.708782,0.37169499999998834,78537.5105933653,1371425.496711056
"244.3.160.239",52726,"41.43.180.128",80,59,53014,22,2010,37,51004,182.821276,0.4144059999999854,38802.526990440696,984618.9485673817
"244.3.160.239",8080,"244.3.160.204",3102,2,128,1,64,1,64,183.116895,7.400000001211993e-5,0,0
"244.3.160.239",52727,"41.43.180.128",80,46,37773,18,1676,28,36097,183.321015,0.1800940000000253,74450.00943950447,1603473.7414903298
"244.3.160.239",52728,"41.43.180.128",80,115,108767,41,3125,74,105642,183.490351,0.26023899999998434,96065.53975384744,3247537.8402163046
"244.3.160.239",52729,"41.43.180.128",80,113,106952,40,3068,73,103884,183.786549,0.2606869999999901,94151.22349791486,3188007.0736171403
"244.3.160.239",52730,"41.43.180.128",80,26,17192,11,1217,15,15975,183.786747,0.14202400000002058,68551.79406296535,899847.9130286535
"244.3.160.239",52731,"41.43.180.128",80,25,16268,11,1214,14,15054,183.78701,0.13351799999998093,72739.25613026998,901990.7428213215
"244.3.160.239",52732,"41.43.180.128",80,14,6744,7,967,7,5777,184.077562,0.10588999999998805,73056.94588724972,436452.92284451047
"244.3.160.239",52733,"41.43.180.128",80,58,49579,22,1900,36,47679,184.166147,0.19276700000000346,78851.6706697709,1978720.4241389509
"244.3.160.239",52734,"41.43.180.128",80,13,3389,7,967,6,2422,184.356979,0.0841829999999959,91895.03819061304,230165.23526128725
"244.3.160.239",52735,"41.43.180.128",80,31,22937,13,1361,18,21576,184.357524,0.1583919999999921,68740.84549725076,1089752.0076772098
"244.3.160.239",52736,"41.43.180.128",80,26,18868,11,1265,15,17603,184.357554,0.1384299999999996,73105.54070649446,1017293.9391750372
"244.3.160.239",52737,"41.43.180.128",80,13,3026,7,957,6,2069,184.503444,0.1250829999999894,61207.35831408464,132328.13411895625
"244.3.160.239",52738,"41.43.180.128",80,11,1621,6,893,5,728,184.508602,0.11981500000001688,59625.25560237862,48608.271084581895
"244.3.160.239",52739,"41.43.180.128",80,13,1952,7,956,6,996,184.513168,0.11772799999999961,64963.305245990974,67681.43517260147
"244.3.160.239",52740,"41.43.180.128",80,11,1710,6,893,5,817,184.515738,0.11278500000000236,63341.756439241486,57950.96865717838
"244.3.160.239",52741,"41.43.180.128",80,13,3824,7,957,6,2867,184.519309,0.10922300000001428,70095.12648433937,209992.4008679216
"244.3.160.239",52742,"41.43.180.128",80,13,5375,7,957,6,4418,184.523885,0.10513699999998494,72819.2738997793,336170.9008246865
"244.3.160.239",52743,"41.43.180.128",80,11,1606,6,892,5,714,184.530609,0.09868000000000166,72314.55208755452,57884.069720307096
"244.3.160.239",52744,"41.43.180.128",80,31,24179,13,1341,18,22838,184.531378,0.15335900000002312,69953.50778238241,1191348.4047233777
"244.3.160.239",52745,"41.43.180.128",80,13,4463,7,957,6,3506,184.532105,0.09790499999999724,78198.253408919,286481.79357541277
"244.3.160.239",52746,"197.154.128.255",80,12,2816,7,916,5,1900,184.533261,0.007593999999983225,964972.3465915442,2001580.1948951245
"244.3.160.239",52747,"41.43.180.128",80,11,1613,6,893,5,720,184.533312,0.09729699999999752,73424.66879760097,59200.180889443116
"244.3.160.239",52748,"224.203.77.242",80,11,1735,6,968,5,767,184.607209,0.10018999999999778,77293.14302824804,61243.63708953125
"244.3.160.239",52749,"41.43.180.128",80,56,50303,21,1918,35,48385,184.616851,0.20300600000001623,75583.97288749482,1906741.672659769
"244.3.160.239",52750,"41.43.180.128",80,11,1790,6,893,5,897,184.618247,0.11962400000001594,59720.45743328302,59987.962281808366
"244.3.160.239",52751,"41.43.180.128",80,13,4323,7,957,6,3366,184.618991,0.11885300000000143,64415.706797471736,226565.58942559024
"244.3.160.239",52752,"41.43.180.128",80,11,1945,6,893,5,1052,184.619398,0.11867499999999609,60198.019801982184,70916.36823257027
"244.3.160.239",52753,"41.43.180.128",80,13,3257,7,968,6,2289,184.619757,0.12731999999999744,60823.12284008919,143826.57869934314
"244.3.160.239",52754,"41.43.180.128",80,13,3556,7,967,6,2589,184.620161,0.11832599999999616,65378.699525043114,175041.83357842462
"244.3.160.239",52755,"41.43.180.128",80,13,3994,7,970,6,3024,184.620505,0.12656699999999432,61311.40028601727,191139.87058238787
"244.3.160.239",52756,"94.2.202.203",80,37,24280,24,22767,13,1513,184.673075,0.3982059999999876,457391.40043094696,30396.327528968362
"244.3.160.239",52757,"224.203.77.242",80,11,1912,6,969,5,943,184.707008,0.4329270000000065,17906.021107484365,17425.570592732463
"244.3.160.239",52758,"41.43.180.128",80,11,3230,6,1546,5,1684,184.950812,0.18955199999999195,65248.58613995381,71072.84544610752
"244.3.160.239",52759,"41.43.180.128",80,13,2307,7,872,6,1435,184.957325,0.07689300000001253,90723.47287788047,149298.37566486062
"244.3.160.239",52760,"41.43.180.128",80,13,1801,7,845,6,956,184.962595,0.28764000000001033,23501.59922124794,26588.791544985834
"244.3.160.239",52761,"94.2.202.203",80,82,70513,31,3579,51,66934,185.085059,0.9917409999999904,28870.440971987926,539931.2925451355
"244.3.160.239",8080,"244.3.160.204",3438,2,128,1,64,1,64,185.116655,7.499999998117346e-5,0,0
"244.3.160.239",52762,"224.203.77.242",80,16,3797,8,1218,8,2579,185.203334,0.10425899999998478,93459.5574482915,197891.78871850882
"244.3.160.239",52763,"41.43.180.128",80,11,2050,6,956,5,1094,185.255554,0.21454800000000773,35647.03469619723,40792.736357363785
"244.3.160.239",52764,"224.203.77.242",80,53,36221,20,2171,33,34050,185.53963,0.8410140000000013,20651.26145343594,323894.7270794536
"244.3.160.239",52765,"224.203.77.242",80,29,18050,12,1376,17,16674,185.557016,0.25849999999999795,42584.13926499066,516023.21083172556
"244.3.160.239",52766,"94.2.202.197",80,10,2099,6,1754,4,345,185.820851,0.12151199999999562,115478.30666930431,22713.80604384834
"244.3.160.239",52767,"94.2.202.197",80,10,2093,6,1750,4,343,185.84642,0.11752900000001887,119119.53645481331,23347.429145143407
"244.3.160.239",52768,"94.2.202.197",80,10,2058,6,1714,4,344,185.847456,0.11746100000002002,116736.6189628699,23429.053047390462
"244.3.160.239",52769,"94.2.202.197",80,10,2064,6,1720,4,344,185.853672,0.11749600000001692,117110.36971469683,23422.073942939365
"244.3.160.239",52770,"94.2.202.197",80,10,2065,6,1721,4,344,185.855084,0.11737700000000473,117297.2558508008,23445.819879532526
"244.3.160.239",52771,"94.2.202.197",80,10,2058,6,1715,4,343,185.856594,0.1173740000000123,116891.30471823881,23378.26094364776
"244.3.160.239",52772,"94.2.202.203",80,10,2303,6,1737,4,566,186.016163,0.1216049999999882,114271.61712101763,37235.311048069074
"244.3.160.239",52773,"41.43.180.128",80,11,1853,6,927,5,926,186.671675,0.07820499999999697,94827.6964388503,94725.40118918594
"244.3.160.239",52774,"224.203.77.242",80,65,54967,24,2330,41,52637,186.871504,0.20369300000001545,91510.2629938122,2067307.1730494816
"244.3.160.239",52775,"224.203.77.242",80,35,26414,14,1699,21,24715,186.87934,0.16286999999999807,83453.06072327722,1213974.3353595035
"244.3.160.239",52776,"224.203.77.242",80,40,28767,16,1804,24,26963,186.883481,0.15232900000000882,94742.30120331103,1416040.281233301
"244.3.160.239",52777,"94.2.202.197",80,10,2082,6,1738,4,344,186.933034,0.11861400000000799,117220.56418297219,23201.30844588172
"244.3.160.239",52778,"41.43.180.128",80,11,1864,6,928,5,936,186.934167,0.08952299999998559,82928.40945903506,83643.30954057846
"244.3.160.239",52779,"94.2.202.197",80,10,2196,6,1734,4,462,186.971358,0.11779400000000351,117764.9116253764,31376.81036385461
"244.3.160.239",8080,"244.3.160.204",3769,2,128,1,64,1,64,187.117028,7.199999998874773e-5,0,0
"244.3.160.239",52780,"41.43.180.128",80,11,1849,6,929,5,920,187.125259,0.0766439999999875,96967.7991754242,96028.39100257294
"244.3.160.239",52781,"94.2.202.197",80,10,2065,6,1720,4,345,187.244393,0.11846599999998375,116151.46961999129,23297.823848195927
"244.3.160.239",52782,"41.43.180.128",80,11,1908,6,931,5,977,187.371553,0.07951299999999151,93670.21744872908,98298.39145801107
"244.3.160.239",52783,"117.246.95.43",80,64,58157,19,2033,45,56124,187.409892,0.6187349999999867,26285.889758944217,725661.228151001
"244.3.160.239",52784,"94.2.202.197",80,10,2062,6,1718,4,344,187.680786,0.1170410000000004,117428.93515947364,23513.1278782648
"244.3.160.239",52785,"43.106.84.231",80,79,71098,29,2734,50,68364,187.816044,0.8835829999999874,24753.758277377805,618970.7135605912
"244.3.160.239",52786,"224.203.77.242",80,14,3408,7,1253,7,2155,187.973571,0.09958299999999554,100659.7511623515,173121.91839973463
"244.3.160.239",52787,"224.203.77.242",80,44,33333,17,1906,27,31427,188.071427,0.15039500000000317,101386.3492802266,1671704.5114531382
"244.3.160.239",52788,"224.203.77.242",80,94,84607,34,2971,60,81636,188.26955,0.20942299999998681,113492.78732518155,3118511.338296372
"244.3.160.239",52789,"94.2.202.197",80,10,2030,6,1686,4,344,188.408356,0.11765099999999507,114644.15942066422,23391.216394251773
"244.3.160.239",52790,"117.246.95.43",80,10,1653,6,1111,4,542,188.464374,0.19577400000000011,45399.286932891984,22147.986964561165
"244.3.160.239",52791,"117.246.95.43",80,12,2130,7,1366,5,764,188.479179,0.16068400000000338,68009.26041173839,38037.39015707769
"244.3.160.239",52792,"43.106.84.231",80,11,1654,6,1218,5,436,188.493223,0.10585900000000947,92046.96813685306,32949.489415162505
"244.3.160.239",52793,"224.203.77.242",80,94,85048,34,2972,60,82076,188.521576,0.21618399999999838,109980.3870776754,3037264.552418333
"244.3.160.239",52794,"43.106.84.231",80,11,1647,6,1211,5,436,188.606816,0.10411899999999719,93047.37848039514,33500.12965933302
"244.3.160.239",52795,"94.2.202.197",80,10,2059,6,1714,4,345,188.611106,0.11960600000000454,114643.07810644516,23075.765429827057
"244.3.160.239",52796,"94.2.202.197",80,10,2067,6,1723,4,344,188.613202,0.11775299999999334,117058.5887408455,23370.954455514133
"244.3.160.239",52797,"94.2.202.197",80,10,2079,6,1734,4,345,188.614938,0.11845700000000647,117105.7852216352,23299.593945481054
"244.3.160.239",52798,"94.2.202.197",80,10,2056,6,1711,4,345,188.617798,0.11769699999999261,116298.63123104972,23450.045455705524
"244.3.160.239",52799,"94.2.202.197",80,10,2056,6,1711,4,345,188.619468,0.11984999999998536,114209.4284522459,23028.785982480913
"244.3.160.239",52800,"94.2.202.197",80,10,2067,6,1722,4,345,188.620595,0.11713100000000054,117611.9046196134,23563.36068162986
"244.3.160.239",52801,"48.151.224.205",80,10,2099,6,1686,4,413,188.676436,0.12592200000000275,107113.92766950735,26238.46508155785
"244.3.160.239",52802,"43.106.84.231",80,11,1650,6,1214,5,436,188.683548,0.10373899999999026,93619.56448395408,33622.84193987148
"244.3.160.239",52803,"43.106.84.231",80,11,1649,6,1213,5,436,188.713438,0.10391400000000317,93384.9144484834,33566.21821891077
"244.3.160.239",52804,"117.246.95.43",80,10,2366,6,887,4,1479,188.726668,0.11329299999999876,62634.05506077231,104437.16734485034
"244.3.160.239",52805,"224.203.77.242",80,17,6419,8,1301,9,5118,188.795414,0.11300800000000777,92099.67435933107,362310.6328755237
"244.3.160.239",52806,"43.106.84.231",80,11,1651,6,1215,5,436,188.798563,0.10462300000000369,92905.00176825037,33338.74960572606
"244.3.160.239",52807,"244.3.31.75",80,34,26599,14,1853,20,24746,188.818456,0.17603900000000294,84208.61286419346,1124568.9875538754
"244.3.160.239",52808,"224.203.77.242",80,73,63241,27,2533,46,60708,188.923531,0.21956800000000953,92290.31552867049,2211907.0174159207
"244.3.160.239",52809,"43.106.84.231",80,11,1658,6,1222,5,436,188.985696,0.10404900000000339,93955.73239531068,33522.667204873535
"244.3.160.239",52811,"43.106.84.231",80,11,1655,6,1219,5,436,189.07012,0.1058140000000094,92161.7177311049,32963.50199406213
"244.3.160.239",8080,"244.3.160.204",4108,2,128,1,64,1,64,189.11713,6.799999999884676e-5,0,0
"244.3.160.239",52812,"94.2.202.197",80,10,2060,6,1715,4,345,189.137014,0.11870700000000056,115578.6937585815,23250.524400414357
"244.3.160.239",52813,"94.2.202.197",80,10,2057,6,1712,4,345,189.141255,0.11767100000000141,116392.3141640662,23455.226861333438
"244.3.160.239",52814,"43.106.84.231",80,11,1656,6,1220,5,436,189.155635,0.10419400000000678,93671.42061922341,33476.015893427386
"244.3.160.239",52815,"94.2.202.197",80,10,2056,6,1712,4,344,189.173604,0.11858099999997762,115499.11031280378,23207.76515631104
"244.3.160.239",52816,"94.2.202.197",80,10,2213,6,1750,4,463,189.175428,0.12010499999999524,116564.6725781654,30839.681944966043
"244.3.160.239",52817,"224.203.77.242",80,13,3118,7,1247,6,1871,189.179523,0.09989900000002194,99860.85946804081,149831.32964290646
"244.3.160.239",52818,"224.203.77.242",80,14,3850,7,1244,7,2606,189.183449,0.1017970000000048,97763.19537903406,204799.7485191019
"244.3.160.239",52819,"94.2.202.197",80,10,2051,6,1707,4,344,189.190673,0.11976099999998269,114027.10398211416,22979.100040918143
"244.3.160.239",52820,"43.106.84.26",80,22,11439,10,1477,12,9962,189.235176,0.22000500000001466,53707.87027567197,362246.3125837808
"244.3.160.239",52821,"244.3.31.108",80,39,36275,12,1974,27,34301,189.252394,1.8309439999999881,8625.058985965765,149872.41554083672
"244.3.160.239",52822,"224.203.77.242",80,22,11495,10,1430,12,10065,189.28349,0.10682800000000725,107088.02935559239,753734.9758489772
"244.3.160.239",52823,"224.203.77.242",80,16,3734,8,1349,8,2385,189.413652,0.264790999999974,40756.67224339596,72056.82972609292
"244.3.160.239",52824,"224.203.77.242",80,11,1988,6,1186,5,802,189.419425,0.18733300000002373,50647.776953333356,34249.171261866235
"244.3.160.239",52825,"43.106.84.231",80,11,1661,6,1225,5,436,189.437146,0.10566999999997506,92741.55389422081,33008.4224472492
"244.3.160.239",52826,"224.203.77.242",80,11,1982,6,1131,5,851,189.487359,0.11944900000000302,75747.80868822486,56995.03553817803
"244.3.160.239",52827,"224.203.77.242",80,11,2530,6,1135,5,1395,189.49143,0.11641599999998675,77996.1517317296,95863.11159979101
"244.3.160.239",52828,"224.203.77.242",80,14,4332,7,1200,7,3132,189.495354,0.1825290000000166,52594.3822625398,137271.33770522889
"244.3.160.239",52829,"224.203.77.242",80,11,1995,6,1134,5,861,189.500071,0.10868500000000836,83470.58011684503,63375.810829456415
"244.3.160.239",52830,"43.106.84.231",80,11,1656,6,1220,5,436,189.516129,0.10367800000000216,94137.61839541463,33642.62427901703
"244.3.160.239",52831,"224.203.77.242",80,12,2090,6,1201,6,889,189.529559,0.2571189999999888,37367.911356221906,27660.344043031866
"244.3.160.239",52833,"94.2.202.197",80,10,2042,6,1697,4,345,189.570054,0.12067799999999806,112497.72120850708,22870.780092477868
"244.3.160.239",52834,"94.2.202.197",80,10,2059,6,1715,4,344,189.595467,0.11817099999998959,116102.93557642068,23288.28561999342
"244.3.160.239",52835,"43.106.84.231",80,11,1656,6,1220,5,436,189.595561,0.10304899999999861,94712.22428165369,33847.97523508279
"244.3.160.239",52836,"94.2.202.197",80,10,2051,6,1707,4,344,189.613038,0.11903200000000425,114725.4519792956,23119.83332213104
"244.3.160.239",52837,"224.203.77.242",80,12,2059,6,1139,6,920,189.617326,0.2822320000000218,32285.495620621674,26077.83667337308
"244.3.160.239",52838,"224.203.77.242",80,12,2046,6,1136,6,910,189.621441,0.2785299999999893,32628.44217858166,26137.220407138477
"244.3.160.239",52839,"94.2.202.197",80,10,2054,6,1710,4,344,189.650479,0.11789799999999673,116032.50267180426,23342.211063801562
"244.3.160.239",52840,"43.106.84.231",80,14,4328,7,1228,7,3100,189.683558,0.10604299999999967,92641.66423054828,233867.3934158792
"244.3.160.239",52841,"43.106.84.231",80,11,1641,6,1205,5,436,189.684965,0.10559799999998631,91289.60775773451,33030.928616076555
"244.3.160.239",52842,"43.106.84.231",80,11,1652,6,1216,5,436,189.763418,0.10572500000000673,92012.29605107005,32991.250886732356
"244.3.160.239",52843,"43.106.84.231",80,11,1642,6,1206,5,436,189.764252,0.103746000000001,92996.3564860323,33620.57332330853
"244.3.160.239",52844,"94.2.202.197",80,10,2049,6,1705,4,344,189.777958,0.11883899999997993,114777.13545218576,23157.380994458592
"244.3.160.239",52845,"94.2.202.197",80,10,2048,6,1704,4,344,189.778765,0.11792300000001887,115600.8581871036,23337.262450917628
"244.3.160.239",52846,"94.2.202.197",80,10,2047,6,1703,4,344,189.812335,0.11823100000000863,115232.04574095631,23276.467254779196
"244.3.160.239",52847,"94.2.202.197",80,10,2048,6,1704,4,344,189.826972,0.11774699999998006,115773.65028410328,23372.145362518502
"244.3.160.239",52848,"94.2.202.197",80,10,2049,6,1705,4,344,189.828353,0.11843899999999508,115164.76836177752,23235.58962841728
"244.3.160.239",52849,"94.2.202.197",80,10,2050,6,1706,4,344,189.834978,0.11778599999999528,115871.15616457428,23364.4066357641
"244.3.160.239",52850,"43.106.84.231",80,11,1645,6,1209,5,436,189.841763,0.10350600000001009,93443.85832704439,33698.529553839006
"244.3.160.239",52851,"43.106.84.231",80,11,1655,6,1219,5,436,189.927645,0.10721199999997566,90959.967167875,32533.67160393232
"244.3.160.239",52852,"41.43.180.128",80,11,2344,6,1103,5,1241,189.948812,0.2715729999999894,32492.18442186942,36557.38972578418
"244.3.160.239",52853,"41.43.180.128",80,66,58886,25,3661,41,55225,189.954802,0.8206559999999854,35688.522352850065,538349.8079585208
"244.3.160.239",52854,"94.2.202.197",80,10,2049,6,1705,4,344,189.98702,0.11761200000000827,115974.56041899671,23398.972893920745
"244.3.160.239",52855,"43.106.84.231",80,11,1645,6,1209,5,436,190.015991,0.10377299999998968,93203.43441936691,33611.82581211247
"244.3.160.239",52856,"94.2.202.197",80,10,2040,6,1696,4,344,190.019474,0.11714200000000119,115825.23774564087,23492.85482576678
"244.3.160.239",52857,"94.2.202.197",80,10,2040,6,1696,4,344,190.021999,0.1185260000000028,114472.77390614447,23218.53433001987
"244.3.160.239",52858,"94.2.202.197",80,10,2047,6,1704,4,343,190.083617,0.11647399999998242,117038.99582741261,23558.905850236224
"244.3.160.239",52859,"94.2.202.197",80,10,2047,6,1703,4,344,190.095015,0.11844200000001592,115026.76415459186,23235.001097580505
"244.3.160.239",52860,"94.2.202.197",80,10,2047,6,1702,4,345,190.098008,0.1184780000000103,114924.2897415454,23295.464136799743
"244.3.160.239",52861,"43.106.84.231",80,11,1644,6,1208,5,436,190.124707,0.10365500000000338,93232.35733924735,33650.08923833762
"244.3.160.239",52862,"43.106.84.231",80,11,1662,6,1226,5,436,190.130037,0.10334100000000035,94909.08739029008,33752.334504214086
"244.3.160.239",52863,"43.106.84.231",80,11,1669,6,1233,5,436,190.201836,0.10664900000000443,92490.31870903233,32705.416834661883
"244.3.160.239",52864,"43.106.84.231",80,11,1667,6,1231,5,436,190.205579,0.10462100000000873,94130.2415384978,33339.386929963475
"244.3.160.239",52865,"94.2.202.197",80,10,2051,6,1708,4,343,190.234119,0.11701600000000667,116770.35619059976,23449.78464483356
"244.3.160.239",52866,"43.106.84.231",80,11,1667,6,1231,5,436,190.283755,0.10618199999998978,92746.41653011761,32849.258819765455
"244.3.160.239",52867,"43.106.84.231",80,11,1652,6,1216,5,436,190.285468,0.10493199999999092,92707.65829299776,33240.57484847617
"244.3.160.239",52868,"94.2.202.197",80,10,2047,6,1703,4,344,190.288004,0.11800700000000575,115450.77834365195,23320.650469886245
"244.3.160.239",52869,"94.2.202.197",80,10,2048,6,1705,4,343,190.290417,0.1168970000000229,116683.91832123432,23473.656295708723
"244.3.160.239",52870,"94.2.202.197",80,10,2042,6,1697,4,345,190.293847,0.11822300000000041,114833.83098043488,23345.711071449638
"244.3.160.239",52871,"94.2.202.197",80,10,2049,6,1705,4,344,190.320606,0.11743000000001302,116154.30469214414,23435.238014133483
"244.3.160.239",52872,"94.2.202.197",80,10,2048,6,1704,4,344,190.325559,0.11793700000001195,115587.13550453733,23334.492144108473
"244.3.160.239",52873,"43.106.84.231",80,132,125799,47,3885,85,121914,190.364854,0.695196999999979,44706.75218679157,1402928.9539512247
"244.3.160.239",52874,"43.106.84.231",80,11,1675,6,1239,5,436,190.365118,0.1043679999999938,94971.63881650112,33420.20542695277
"244.3.160.239",52875,"94.2.202.197",80,10,2048,6,1704,4,344,190.40999,0.11762300000000891,115895.70067077839,23396.78464245761
"244.3.160.239",52876,"43.106.84.231",80,11,1655,6,1219,5,436,190.442051,0.1047580000000039,93090.74247312508,33295.786479312985
"244.3.160.239",52877,"94.2.202.197",80,10,2049,6,1706,4,343,190.442182,0.11712900000000559,116521.10066678064,23427.16150568919
"244.3.160.239",52878,"94.2.202.197",80,10,2052,6,1708,4,344,190.516215,0.1179880000000253,115808.38729359825,23324.40587177857
"244.3.160.239",52879,"94.2.202.197",80,10,2050,6,1706,4,344,190.517666,0.11862200000001621,115054.54300212553,23199.74372375802
"244.3.160.239",52880,"43.106.84.231",80,11,1653,6,1217,5,436,190.520628,0.1047580000000039,92938.00950762363,33295.786479312985
"244.3.160.239",52881,"43.106.84.231",80,11,1660,6,1224,5,436,190.597766,0.10316499999998996,94915.91140407069,33809.9161537376
"244.3.160.239",52882,"41.43.180.128",80,11,2129,6,1025,5,1104,190.63182,0.10493099999999345,78146.59156970306,84169.59716385578
"244.3.160.239",52883,"94.2.202.197",80,10,2051,6,1707,4,344,190.637066,0.11726300000000833,116456.17117077876,23468.613288077267
"244.3.160.239",52884,"94.2.202.197",80,10,2051,6,1707,4,344,190.641512,0.11795000000000755,115777.87197964499,23331.92030521258
"244.3.160.239",52885,"94.2.202.197",80,10,2051,6,1707,4,344,190.648341,0.11787200000000553,115854.48622233745,23347.359847969587
"244.3.160.239",52886,"43.106.84.231",80,11,1653,6,1217,5,436,190.673706,0.10353200000000129,94038.55812695474,33690.06683923769
"244.3.160.239",52887,"224.203.77.242",80,23,12734,10,1430,13,11304,190.685369,0.10450000000000159,109473.68421052465,865377.9904306089
"244.3.160.239",52888,"94.2.202.197",80,10,2057,6,1713,4,344,190.702231,0.11876799999998866,115384.6153846264,23171.224572277573
"244.3.160.239",52889,"94.2.202.197",80,10,2047,6,1704,4,343,190.70439,0.11796200000000567,115562.6388158843,23261.72835319737
"244.3.160.239",52890,"41.43.180.128",80,61,54197,23,2128,38,52069,190.70634,0.21229799999997567,80189.16805623204,1962109.864436065
"244.3.160.239",52891,"41.43.180.128",80,13,3469,7,996,6,2473,190.706621,0.08017199999997615,99386.31941329106,246769.44569183612
"244.3.160.239",52892,"41.43.180.128",80,67,60919,25,2230,42,58689,190.707141,0.21573399999999765,82694.42925083758,2176346.7974450253
"244.3.160.239",52893,"43.106.84.108",80,13,5349,7,1150,6,4199,190.726658,0.1368140000000153,67244.58023300956,245530.42817252796
"244.3.160.239",52894,"43.106.84.231",80,11,1644,6,1208,5,436,190.749098,0.10884200000000988,88789.25414820679,32046.45265614086
"244.3.160.239",52895,"43.106.84.231",80,11,1647,6,1211,5,436,190.831727,0.10602000000000089,91378.98509715071,32899.45293340852
"244.3.160.239",52896,"224.203.77.242",80,41,30555,16,1806,25,28749,190.859401,0.14688200000000506,98364.67368363381,1565828.3520104033
"244.3.160.239",52897,"43.106.84.231",80,11,1652,6,1216,5,436,190.909699,0.10768500000000358,90337.55862004621,32390.76937363499
"244.3.160.239",52898,"43.106.84.231",80,11,1669,6,1233,5,436,190.932502,0.10409699999999589,94757.77399925444,33507.20962179638
"244.3.160.239",52899,"41.43.180.128",80,11,1870,6,924,5,946,190.93315,0.22722299999998086,32531.917983657564,33306.487459458935
"244.3.160.239",52900,"41.43.180.128",80,11,2298,6,916,5,1382,190.933884,0.22707099999999514,32271.844489169278,48689.616903965
"244.3.160.239",52901,"41.43.180.128",80,11,2103,6,916,5,1187,190.935366,0.22613700000002268,32405.134940320535,41992.243639913184
"244.3.160.239",52902,"43.106.84.231",80,11,1669,6,1233,5,436,190.989665,0.10554300000001149,93459.5378186988,33048.141515776704
"244.3.160.239",52903,"244.3.31.75",80,59,53220,22,2359,37,50861,190.990223,0.26855800000001295,70271.59868631391,1515084.2648514675
"244.3.160.239",52904,"43.106.84.231",80,11,1655,6,1219,5,436,191.009245,0.10464100000001508,93194.82803106426,33333.01478387532
"244.3.160.239",52905,"43.106.84.231",80,11,1655,6,1219,5,436,191.066605,0.10458499999998594,93244.7291676752,33350.862934459714
"244.3.160.239",52906,"224.203.77.242",80,41,30977,16,1841,25,29136,191.075722,0.1450699999999756,101523.40249536415,1606727.7865860562
"244.3.160.239",52907,"41.43.180.128",80,13,3863,7,1877,6,1986,191.085456,0.20927500000001942,71752.47879583613,75919.24501253627
"244.3.160.239",52908,"43.106.84.231",80,11,1668,6,1232,5,436,191.109801,0.1032769999999914,95432.67135955556,33773.250578544015
"244.3.160.239",8080,"244.3.160.204",4439,2,128,1,64,1,64,191.118352,7.10000000196942e-5,0,0
"244.3.160.239",52909,"43.106.84.231",80,11,1656,6,1220,5,436,191.144522,0.10355400000000259,94250.34281630605,33682.90939992577
"244.3.160.239",52910,"43.106.84.231",80,14,4329,7,1229,7,3100,191.186715,0.22230100000001585,44228.32106018101,111560.45181982192
"244.3.160.239",52911,"43.106.84.231",80,11,1661,6,1225,5,436,191.220374,0.10405400000001919,94181.86710744607,33521.05637456856
"244.3.160.239",52912,"41.43.180.128",80,13,2480,7,1000,6,1480,191.25662,0.25427300000001196,31462.247269665375,46564.12595910476
"244.3.160.239",52914,"94.2.202.203",80,19,8946,12,7623,7,1323,191.260341,0.20509500000000003,297345.1327433628,51605.35361661668
"244.3.160.239",52913,"41.43.180.128",80,16,6248,8,1060,8,5188,191.260416,0.24989000000002193,33934.931369799735,166089.07919483117
"244.3.160.239",52915,"43.106.84.231",80,11,1658,6,1222,5,436,191.279605,0.10396399999999062,94032.54972876074,33550.07502597356
"244.3.160.239",52916,"43.106.84.231",80,11,1665,6,1229,5,436,191.297544,0.1028490000000204,95596.45694171115,33913.79595328402
"244.3.160.239",52917,"224.203.77.242",80,12,2380,6,1208,6,1172,191.341626,0.2848460000000159,33927.10447048391,32916.031820701275
"244.3.160.239",52918,"224.203.77.242",80,12,2369,6,1211,6,1158,191.345391,0.2818670000000054,34370.82028048624,32866.56472733531
"244.3.160.239",52919,"43.106.84.231",80,11,1654,6,1218,5,436,191.356786,0.1042410000000018,93475.69574351581,33460.922285856235
"244.3.160.239",52920,"43.106.84.231",80,11,1650,6,1214,5,436,191.373976,0.11019200000001206,88137.06984172115,31653.84056918486
"244.3.160.239",52921,"41.43.180.128",80,11,2071,6,978,5,1093,191.395236,0.2250310000000013,34768.54300074192,38856.86860921361
"244.3.160.239",52922,"43.106.84.231",80,11,1653,6,1217,5,436,191.4334,0.10583800000000565,91989.6445511015,32956.02713580958
"244.3.160.239",52923,"43.106.84.231",80,11,1655,6,1219,5,436,191.456103,0.10605999999998517,91947.95398832136,32887.04506883356
"244.3.160.239",52924,"94.2.202.203",80,305,290465,105,8541,200,281924,191.473824,1.6318979999999783,41870.26395032098,1382066.7713300893
"244.3.160.239",52925,"43.106.84.231",80,11,1654,6,1218,5,436,191.512066,0.10400200000000837,93690.50595180108,33537.81658044768
"244.3.160.239",52926,"43.106.84.108",80,10,1460,6,1070,4,390,191.944842,0.10339899999999602,82786.10044584889,30174.37305970193
"244.3.160.239",52927,"43.106.84.231",80,11,1656,6,1220,5,436,192.015058,0.10333499999998708,94450.08951469706,33754.29428558026
"244.3.160.239",52928,"43.106.84.108",80,10,1455,6,1065,4,390,192.063206,0.10226000000000113,83317.03500880017,30510.46352434936
"244.3.160.239",52929,"43.106.84.108",80,10,1468,6,1068,4,400,192.070801,0.1027300000000082,83169.47337680636,31149.615496931223
"244.3.160.239",52932,"43.106.84.231",80,79,70925,29,2734,50,68191,192.249829,1.0561239999999827,20709.68939253379,516537.8307850299
"244.3.160.239",52934,"244.3.31.108",80,11,1812,6,1386,5,426,192.500026,0.021478000000001884,516249.18521273055,158673.99199179164
"244.3.160.239",52935,"244.3.31.108",80,15,5084,8,1457,7,3627,192.554394,0.19180800000000886,60769.1024357663,151276.2762762693
"244.3.160.239",52936,"224.203.77.242",80,12,2962,6,1193,6,1769,192.557457,0.21936099999999215,43508.18969643803,64514.65848533015
"244.3.160.239",52937,"224.203.77.242",80,16,4251,8,1344,8,2907,192.687571,0.25480300000000966,42197.305369244445,91270.51094374523
"244.3.160.239",52938,"244.3.31.108",80,11,1811,6,1384,5,427,192.832714,0.01996499999998491,554570.4983725704,171099.42399211528
"244.3.160.239",52939,"43.106.84.108",80,36,28913,15,1643,21,27270,192.865607,0.21433799999999792,61323.70368296862,1017831.6490776349
"244.3.160.239",52940,"244.3.31.108",80,18,8984,9,1525,9,7459,192.934109,0.1921649999999886,63487.10743371958,310524.80940859957
"244.3.160.239",52941,"94.2.202.197",80,12,2734,7,2004,5,730,193.024815,0.24951699999999732,64252.135125062305,23405.218882881978
"244.3.160.239",52942,"43.106.84.108",80,10,2290,6,1297,4,993,193.073928,0.13268600000000674,78199.65934612147,59870.672113106106
"244.3.160.239",52943,"43.106.84.231",80,11,1654,6,1218,5,436,193.110227,0.10371799999998643,93947.04872829474,33629.64962687727
"244.3.160.239",8080,"244.3.160.204",4773,2,128,1,64,1,64,193.117307,7.299999998622297e-5,0,0
"244.3.160.239",52944,"244.3.31.108",80,24,14781,11,1655,13,13126,193.149604,0.19663799999997877,67331.84837112577,534016.8227911764
"244.3.160.239",52945,"43.106.84.108",80,10,1463,6,1073,4,390,193.197853,0.10321299999998246,83167.81800743568,30228.750254333565
"244.3.160.239",52946,"43.106.84.108",80,10,1453,6,1063,4,390,193.208508,0.10346900000001824,82188.86816339678,30153.959156843597
"244.3.160.239",52947,"43.106.84.231",80,11,1647,6,1211,5,436,193.251215,0.10538499999998407,91929.59149785514,33097.68942449615
"244.3.160.239",52948,"43.106.84.108",80,10,1456,6,1066,4,390,193.275367,0.10203300000000581,83580.80228945061,30578.342301018514
"244.3.160.239",52949,"43.106.84.108",80,10,1452,6,1062,4,390,193.285314,0.1027909999999963,82653.15056765967,30352.851903377847
"244.3.160.239",52950,"43.106.84.231",80,11,1650,6,1214,5,436,193.30472,0.1042759999999987,93137.44293989145,33449.69120411258
"244.3.160.239",52951,"43.106.84.231",80,11,1649,6,1213,5,436,193.328149,0.10342600000001312,93825.53709897675,33724.59536286386
"244.3.160.239",52952,"43.106.84.108",80,10,1458,6,1068,4,390,193.350676,0.10289299999999457,83037.71879525771,30322.76248141433
"244.3.160.239",52953,"43.106.84.108",80,10,1466,6,1076,4,390,193.360911,0.10275500000000193,83772.07921755475,30363.485961753115
"244.3.160.239",52954,"43.106.84.231",80,11,1651,6,1215,5,436,193.41175,0.10469399999999496,92841.99667603175,33316.14037098752
"244.3.160.239",52955,"43.106.84.108",80,10,1456,6,1066,4,390,193.425868,0.10381499999999733,82146.12531907932,30053.460482589995
"244.3.160.239",52956,"43.106.84.108",80,10,1458,6,1068,4,390,193.43626,0.10245000000000459,83396.77891654092,30453.879941433483
"244.3.160.239",52957,"43.106.84.231",80,11,1658,6,1222,5,436,193.596292,0.10539199999999482,92758.46364050858,33095.49111887213
"244.3.160.239",52958,"43.106.84.231",80,11,1655,6,1219,5,436,193.678442,0.10364500000000021,94090.40474697265,33653.33590621827
"244.3.160.239",52959,"43.106.84.231",80,11,1656,6,1220,5,436,193.762906,0.1034270000000106,94366.07462267106,33724.269291380806
"244.3.160.239",52960,"43.106.84.108",80,10,1585,6,1022,4,563,193.825884,0.25308499999999867,32305.35195685261,17796.392516348355
"244.3.160.239",52961,"43.106.84.26",80,22,11439,10,1477,12,9962,193.8588,0.2175670000000025,54309.70689488693,366305.5518529882
"244.3.160.239",52962,"43.106.84.108",80,10,2290,6,1297,4,993,193.914085,0.13485299999999256,76943.04168242881,58908.589352854135
"244.3.160.239",52963,"43.106.84.231",80,11,1661,6,1225,5,436,194.058469,0.10387599999998542,94343.25541993699,33578.497439259205
"244.3.160.239",52964,"43.106.84.231",80,11,1656,6,1220,5,436,194.137346,0.1043499999999824,93531.38476283322,33425.97029229121
"244.3.160.239",52965,"43.106.84.231",80,11,1656,6,1220,5,436,194.240618,0.10379100000000108,94035.128286652,33605.99666637727
"244.3.160.239",52966,"43.106.84.231",80,14,4328,7,1228,7,3100,194.321474,0.1062610000000177,92451.60501028941,233387.60222467198
"244.3.160.239",52967,"43.106.84.231",80,11,1642,6,1206,5,436,194.326846,0.10560499999999706,91359.31063870336,33028.739169547815
"244.3.160.239",52969,"43.106.84.231",80,11,1641,6,1205,5,436,194.404321,0.10679199999998445,90268.93400256014,32661.622593457447
"244.3.160.239",52970,"43.106.84.231",80,11,1645,6,1209,5,436,194.408479,0.10626099999998928,91021.16486764641,32824.836958059415
"244.3.160.239",52971,"43.106.84.108",80,12,2589,7,1686,5,903,194.419498,0.12156300000000897,110954.81355345792,59425.976654076214
"244.3.160.239",52972,"43.106.84.231",80,11,1652,6,1216,5,436,194.483484,0.10347300000000814,94014.8637808823,33709.276816171616
"244.3.160.239",52973,"41.43.180.128",80,11,1936,6,1020,5,916,194.523047,0.07845600000001696,104007.34169468538,93402.67156110962
"244.3.160.239",52974,"43.106.84.231",80,11,1655,6,1219,5,436,194.578185,0.10455600000000231,93270.59183595187,33360.11324075063
"244.3.160.239",52975,"43.106.84.231",80,14,4584,7,1484,7,3100,194.580648,0.10655600000001186,111415.59367842898,232741.46927434625
"244.3.160.239",52976,"43.106.84.231",80,11,1645,6,1209,5,436,194.674801,0.10298699999998462,93914.76594134643,33868.35231631683
"244.3.160.239",52977,"43.106.84.231",80,11,1572,6,1136,5,436,194.680799,0.10359299999998939,87727.93528521166,33670.2286834087
"244.3.160.239",52978,"244.3.31.75",80,13,3297,7,1419,6,1878,194.742213,0.03572500000001355,317760.6717983399,420545.83624896576
"244.3.160.239",52979,"43.106.84.231",80,11,1581,6,1145,5,436,194.749508,0.10527600000000348,87009.38485504482,33131.95790113496
"244.3.160.239",52980,"41.43.180.128",80,11,2389,6,1169,5,1220,194.777058,0.2329639999999813,40143.54149139245,41894.88504662001
"244.3.160.239",52981,"41.43.180.128",80,129,124269,46,5854,83,118415,194.78358,1.4210589999999854,32955.704161474285,666629.6051043691
"244.3.160.239",52982,"43.106.84.231",80,11,1644,6,1208,5,436,194.799646,0.10385800000000245,93050.12613375737,33584.317048276665
"244.3.160.239",52983,"43.106.84.231",80,11,1662,6,1226,5,436,194.82733,0.10764900000000921,91110.92532210388,32401.601501172343
"244.3.160.239",52984,"43.106.84.231",80,11,1669,6,1233,5,436,194.875625,0.10418999999998846,94673.19320473263,33477.301084560764
"244.3.160.239",52985,"43.106.84.231",80,11,1667,6,1231,5,436,194.907843,0.10433899999998175,94384.65003499863,33429.49424472738
"244.3.160.239",52986,"43.106.84.231",80,11,1667,6,1231,5,436,194.968185,0.10501299999998537,93778.86547381154,33214.93529373017
"244.3.160.239",52987,"43.106.84.231",80,11,1669,6,1233,5,436,194.99363,0.10365000000001601,95166.42547031815,33651.71249396489
"244.3.160.239",52988,"43.106.84.231",80,11,1675,6,1239,5,436,195.046187,0.1043549999999982,94983.46988644694,33424.36874131628
"244.3.160.239",52989,"43.106.84.231",80,11,1669,6,1233,5,436,195.073281,0.10394499999998175,94896.33941028171,33556.20760979953
"244.3.160.239",8080,"244.3.160.204",5109,2,128,1,64,1,64,195.117643,7.000000002221896e-5,0,0
"244.3.160.239",52990,"43.106.84.231",80,145,139376,51,4141,94,135235,195.129502,0.6894920000000013,48046.96791260803,1569097.2484089707
"244.3.160.239",52991,"43.106.84.231",80,11,1655,6,1219,5,436,195.152696,0.10505700000001639,92825.79932796938,33201.02420590209
"244.3.160.239",52992,"43.106.84.231",80,11,1655,6,1219,5,436,195.239785,0.10350599999998167,94216.7603810574,33698.52955384826
"244.3.160.239",52993,"43.106.84.108",80,24,15259,11,2368,13,12891,195.307656,0.7773849999999811,24368.877711816487,132660.13622594016
"244.3.160.239",52994,"43.106.84.231",80,11,1644,6,1208,5,436,195.315365,0.10286499999998,93948.37894329343,33908.52087688405
"244.3.160.239",52996,"43.106.84.231",80,11,1655,6,1219,5,436,195.392391,0.10727099999999723,90909.9383803661,32515.777796422986
"244.3.160.239",52997,"43.106.84.231",80,11,1668,6,1232,5,436,195.473964,0.10528700000000413,93610.79715444085,33128.496395565104
"244.3.160.239",52998,"43.106.84.231",80,11,1653,6,1217,5,436,195.553455,0.10351899999997727,94050.36756539512,33694.297665170314
"244.3.160.239",52999,"43.106.84.108",80,13,5188,7,1150,6,4038,195.584444,0.13671100000001957,67295.24325035061,236294.08021297026
"244.3.160.239",53000,"43.106.84.231",80,11,1660,6,1224,5,436,195.629565,0.10556599999998184,92757.1377148105,33040.94121213838
"244.3.160.239",53002,"43.106.84.231",80,11,1653,6,1217,5,436,195.697431,0.1049730000000011,92747.65892181703,33227.591856953346
"244.3.160.239",53003,"43.106.84.231",80,11,1647,6,1211,5,436,195.708307,0.10498200000000679,92282.48652149296,33224.74328932364
"244.3.160.239",53004,"43.106.84.231",80,11,1652,6,1216,5,436,195.774688,0.1033339999999896,94141.32812047322,33754.62093793283
"244.3.160.239",53005,"43.106.84.231",80,11,1652,6,1216,5,436,195.786999,0.10289799999998195,94540.22429980861,33897.64621276032
"244.3.160.239",53006,"43.106.84.231",80,11,1656,6,1220,5,436,195.850148,0.10310000000001196,94665.37342384935,33831.23181376911
"244.3.160.239",53007,"43.106.84.231",80,14,4329,7,1229,7,3100,195.862526,0.2880830000000003,34129.05308539549,86086.30151727097
"244.3.160.239",53008,"43.106.84.231",80,11,1661,6,1225,5,436,195.925326,0.1063039999999944,92188.44069837933,32811.559301627254
"244.3.160.239",53009,"41.43.180.128",80,11,2157,6,1053,5,1104,195.974352,0.16743999999999915,50310.559006211435,52747.25274725302
"244.3.160.239",53010,"43.106.84.231",80,11,1658,6,1222,5,436,196.003262,0.10453099999998017,93522.49571899106,33368.09176225868
"244.3.160.239",53011,"43.106.84.231",80,11,1665,6,1229,5,436,196.024339,0.10525499999999965,93411.23937105156,33138.568239038636
"244.3.160.239",53012,"41.43.180.128",80,71,66096,26,2462,45,63634,196.047353,0.2295660000000055,85796.67720829534,2217540.9250498237
"244.3.160.239",53013,"41.43.180.128",80,95,90713,34,2924,61,87789,196.048702,0.25048400000000015,93387.20237619962,2803819.8048577937
"244.3.160.239",53014,"43.106.84.231",80,11,1654,6,1218,5,436,196.084733,0.10493099999999345,92861.0229579496,33240.89163355174
"244.3.160.239",53016,"43.106.84.231",80,11,1650,6,1214,5,436,196.127258,0.11217599999997674,86578.23420341262,31093.99515048427
"244.3.160.239",53017,"43.106.84.231",80,11,1653,6,1217,5,436,196.161605,0.10577999999998156,92040.08319154564,32974.09718283804
"244.3.160.239",53018,"43.106.84.231",80,14,4584,7,1484,7,3100,196.22977,0.10587300000000255,112134.34964532708,234242.9136795916
"244.3.160.239",53019,"43.106.84.231",80,11,1655,6,1219,5,436,196.239917,0.10504000000000246,92840.82254379067,33206.397562832426
"244.3.160.239",53020,"43.106.84.231",80,11,1654,6,1218,5,436,196.308438,0.10488800000001675,92899.0923651747,33254.51910608881
"244.3.160.239",53021,"43.106.84.231",80,11,1572,6,1136,5,436,196.317194,0.10343299999999545,87863.6411976874,33722.31299488706
"244.3.160.239",53022,"41.43.180.128",80,11,1968,6,980,5,988,196.31896,0.21131499999998482,37101.010340016386,37403.87573054714
"244.3.160.239",53023,"83.217.193.163",80,10,1356,6,981,4,375,196.33134,0.1414959999999894,55464.46542658865,21202.012777747954
"244.3.160.239",53024,"41.43.180.128",80,11,1763,6,980,5,783,196.349279,0.29111700000001406,26930.752927515816,21517.121981882534
"244.3.160.239",53025,"41.43.180.128",80,11,1697,6,980,5,717,196.350149,0.2906910000000096,26970.219236232773,19732.29305344786
"244.3.160.239",53026,"43.106.84.231",80,11,1581,6,1145,5,436,196.385239,0.11179399999997486,81936.41877025654,31200.24330465664
"244.3.160.239",53028,"117.246.95.43",80,10,1493,6,985,4,508,196.482956,0.1563639999999964,50395.23163899735,25990.637231076806
"244.3.160.239",53029,"41.43.180.128",80,15,4071,8,2010,7,2061,196.517226,0.23311499999999796,68978.83019110799,70729.03931535999
"244.3.160.239",53030,"43.106.84.108",80,10,1458,6,1068,4,390,196.555473,0.10299599999999032,82954.67785157484,30292.438541305422
"244.3.160.239",53031,"117.246.95.43",80,10,1721,6,1102,4,619,196.673721,0.12416200000001254,71004.01088899268,39883.3781672291
"244.3.160.239",53032,"43.106.84.108",80,10,1461,6,1071,4,390,196.721005,0.10242600000000834,83650.63558080274,30461.015757715286
"244.3.160.239",53033,"244.3.31.75",80,13,3588,7,1708,6,1880,196.816728,0.03946799999999939,346204.5201175689,381068.20715516957
"244.3.160.239",53035,"117.246.95.43",80,10,1790,6,1109,4,681,196.832441,0.166575000000023,53261.29371153399,32705.98829355694
"244.3.160.239",53036,"117.246.95.43",80,76,67808,28,2542,48,65266,197.026651,0.29082400000001485,69925.45319505599,1795340.136989978
"244.3.160.239",8080,"244.3.160.204",5440,2,128,1,64,1,64,197.117819,6.8999999996322e-5,0,0
"244.3.160.239",53037,"41.43.180.128",80,11,2135,6,1042,5,1093,197.123585,0.10770000000002256,77400.18570100515,81188.48653665895
"244.3.160.239",53039,"43.106.84.108",80,10,1460,6,1070,4,390,197.259654,0.10246399999999767,83541.53653966461,30449.718925672147
"244.3.160.239",53040,"43.106.84.231",80,11,1656,6,1220,5,436,197.301598,0.10595899999998437,92111.09957626478,32918.39296332085
"244.3.160.239",53041,"43.106.84.108",80,10,1455,6,1065,4,390,197.376409,0.10162900000000263,83834.33862381583,30699.89865097481
"244.3.160.239",53042,"43.106.84.108",80,10,1468,6,1068,4,400,197.38343,0.105827000000005,80735.54007956,30238.02999234457
"244.3.160.239",53043,"117.246.95.43",80,10,1706,6,1006,4,700,197.40707,0.15401699999998186,52253.971964139986,36359.62263906361
"244.3.160.239",53044,"117.246.95.43",80,10,1583,6,1041,4,542,197.407423,0.14360300000001303,57993.21741188725,30194.355271126693
"244.3.160.239",53045,"244.3.31.108",80,11,1812,6,1387,5,425,197.544867,0.007328000000001111,1514192.1397377616,463973.7991265672
"244.3.160.239",53046,"244.3.31.108",80,11,2320,6,1343,5,977,197.729118,0.07282200000000216,147537.83197384968,107330.20241135602
"244.3.160.239",53047,"43.106.84.108",80,36,28752,15,1643,21,27109,198.017389,0.21406500000000506,61401.91063461888,1013112.8395580542
"244.3.160.239",53048,"94.2.202.98",80,12,2849,7,1824,5,1025,198.186423,0.13215200000001914,110418.30619285282,62049.760881400296
"244.3.160.239",53049,"43.106.84.108",80,10,2290,6,1297,4,993,198.219876,0.13596699999999373,76312.63468341935,58425.941588770555
"244.3.160.239",53050,"94.2.202.203",80,12,3194,7,1919,5,1275,198.28763,0.9165069999999957,16750.55400558869,11129.211233520364
"244.3.160.239",53051,"43.106.84.108",80,10,1463,6,1073,4,390,198.338031,0.10206900000000019,84099.97158784728,30567.557240690065
"244.3.160.239",53052,"43.106.84.108",80,10,1453,6,1063,4,390,198.34258,0.10225099999999543,83167.89077857802,30513.149015658913
"244.3.160.239",53053,"43.106.84.108",80,10,1456,6,1066,4,390,198.412963,0.10212000000001353,83509.59655306375,30552.29142185259
"244.3.160.239",53054,"43.106.84.108",80,10,1452,6,1062,4,390,198.417385,0.10237599999999247,82988.20035946535,30475.89278737428
"244.3.160.239",53055,"43.106.84.108",80,10,1458,6,1068,4,390,198.488197,0.10158399999997414,84107.7335013602,30713.49818869895
"244.3.160.239",53056,"43.106.84.108",80,10,1476,6,1076,4,400,198.492505,0.10323999999999955,83378.53545137579,30995.738086013305
"244.3.160.239",53057,"43.106.84.108",80,10,1466,6,1066,4,400,198.562818,0.10151300000001129,84008.94466717614,31523.056160291235
"244.3.160.239",53058,"43.106.84.108",80,10,1458,6,1068,4,390,198.568338,0.10338799999999537,82640.15166170525,30177.58347197102
"244.3.160.239",53059,"43.106.84.108",80,10,1585,6,1022,4,563,198.636699,0.24238800000000538,33731.04279089649,18581.77797580697
"244.3.160.239",53060,"82.242.98.77",80,47,40636,18,2553,29,38083,199.095166,0.559597999999994,36497.6286548562,544433.6827508376
"244.3.160.239",8080,"244.3.160.204",5779,2,128,1,64,1,64,199.118991,6.8999999996322e-5,0,0
"244.3.160.239",53061,"94.2.202.203",80,54,43842,21,3117,33,40725,199.167854,0.3215930000000071,77539.0011598494,1013081.7524013047
"244.3.160.239",53062,"94.2.202.197",80,17,7361,9,2082,8,5279,199.294479,0.15702300000000946,106073.63252516509,268954.22963513277
"244.3.160.239",53063,"94.2.202.197",80,132,120045,47,4515,85,115530,199.294557,0.4065610000000106,88842.75668349658,2273311.9999212315
"244.3.160.239",53064,"43.106.84.108",80,10,2290,6,1297,4,993,199.324514,0.14026300000000447,73975.31779585258,56636.46150445768
"244.3.160.239",53065,"94.2.202.197",80,14,4172,8,2025,6,2147,199.417717,0.1190639999999803,136061.2779681741,144258.55002354065
"244.3.160.239",53066,"43.106.84.108",80,12,2750,7,1686,5,1064,199.462662,0.12018800000001306,112224.1821146748,70822.37827402964
"244.3.160.239",53067,"94.2.202.197",80,104,92776,38,3944,66,88832,199.50354,0.3629180000000076,86939.74947508621,1958172.3695159378
"244.3.160.239",53068,"43.106.84.231",80,14,4584,7,1484,7,3100,199.588287,0.10612199999999916,111871.24253218083,233693.29639471736
"244.3.160.239",53069,"43.106.84.231",80,11,1572,6,1136,5,436,199.670167,0.10408100000000786,87316.60917938253,33512.360565326395
"244.3.160.239",53070,"43.106.84.231",80,11,1581,6,1145,5,436,199.673698,0.1042099999999948,87899.4338355288,33470.876115537605
"244.3.160.239",53071,"94.2.202.197",80,29,19339,13,2343,16,16996,199.674723,0.20107400000000553,93219.41175885238,676208.7589643428
"244.3.160.239",53072,"43.106.84.108",80,12,3022,7,2153,5,869,199.81901,0.1084069999999997,158882.72897506662,64128.70017618806
"244.3.160.239",53073,"94.2.202.197",80,146,134343,52,4855,94,129488,199.847618,0.43140900000000215,90030.57423465855,2401210.915859416
"244.3.160.239",53074,"43.106.84.231",80,14,4584,7,1484,7,3100,199.927166,0.10756299999999896,110372.52586856182,230562.55403810082
"244.3.160.239",53075,"43.106.84.231",80,11,1572,6,1136,5,436,200.010314,0.10432400000001962,87113.2241861728,33434.30083201703
"244.3.160.239",53076,"43.106.84.231",80,11,1581,6,1145,5,436,200.014213,0.10288499999998635,89031.44287312256,33901.92933858641
"244.3.160.239",53077,"94.2.202.197",80,20,10511,10,2158,10,8353,200.323094,0.15948499999998944,108248.42461674228,418998.65191086574
"244.3.160.239",53078,"94.2.202.197",80,14,3962,8,2030,6,1932,200.452382,0.11911100000000374,136343.41076810277,129761.31507584953
"244.3.160.239",53079,"94.2.202.197",80,39,28856,16,2552,23,26304,200.545852,0.2410419999999931,84698.93213631063,873009.6829598411
"244.3.160.239",53080,"176.41.89.210",80,15,4774,9,4029,6,745,200.640996,0.7639609999999948,42190.635385838046,7801.445361739723
"244.3.160.239",53081,"94.2.202.197",80,18,8707,9,2097,9,6610,200.76257,0.16040499999999724,104585.26853901242,329665.5341167726
"244.3.160.239",53082,"94.2.202.197",80,12,2576,7,1970,5,606,200.892216,0.22962499999999864,68633.64180729492,21112.68372346229
"244.3.160.239",53083,"94.2.202.197",80,12,2577,7,1952,5,625,200.892552,0.2288029999999992,68250.85335419577,21852.860320887477
"244.3.160.239",53085,"94.2.202.197",80,19,8339,10,2152,9,6187,201.030269,0.303781999999984,56672.21889381499,162932.6293197181
"244.3.160.239",53086,"94.2.202.197",80,12,3584,7,1967,5,1617,201.031587,0.30261999999999034,51999.20692617971,42746.67900337193
"244.3.160.239",8080,"244.3.160.204",6110,2,128,1,64,1,64,201.119032,7.700000000454565e-5,0,0
"244.3.160.239",53087,"94.2.202.197",80,12,3115,7,1962,5,1153,201.191985,0.25396299999999883,61804.27857601333,36320.25137520049
"244.3.160.239",53088,"94.2.202.197",80,12,3081,7,1958,5,1123,201.192993,0.2529749999999922,61919.16197252885,35513.39065125122
"244.3.160.239",53089,"94.2.202.197",80,12,3089,7,1966,5,1123,201.302176,0.25369899999998324,61994.72603361085,35412.04340577059
"244.3.160.239",53090,"94.2.202.197",80,12,2583,7,1959,5,624,201.302274,0.2533650000000023,61855.425966490475,19702.800307856076
"244.3.160.239",53091,"94.2.202.197",80,12,2626,7,1958,5,668,201.410465,0.2535780000000045,61771.92027699454,21074.383424429187
"244.3.160.239",53092,"94.2.202.197",80,12,3351,7,1962,5,1389,201.411928,0.25232900000000313,62204.50285143525,44037.744373416695
"244.3.160.239",53093,"224.203.77.242",80,338,322026,116,8298,222,313728,201.493586,1.808907000000005,36698.40406389041,1387480.9484401317
"244.3.160.239",53094,"94.2.202.197",80,12,2583,7,1960,5,623,201.520363,0.2534440000000018,61867.7104212366,19665.093669607348
"244.3.160.239",53095,"94.2.202.197",80,12,3107,7,1965,5,1142,201.521921,0.2524980000000028,62257.918874604264,36182.46481160207
"244.3.160.239",53096,"94.2.202.197",80,12,2582,7,1958,5,624,201.630652,0.14458099999998808,108340.6533362011,34527.3583665932
"244.3.160.239",53097,"94.2.202.197",80,12,3359,7,1961,5,1398,201.631579,0.14368500000000495,109183.28287573135,77836.93496189313
"244.3.160.239",53099,"176.41.89.210",80,10,1577,6,766,4,811,201.700955,0.8729450000000156,7019.91534403644,7432.312459547719
"244.3.160.239",53100,"94.2.202.197",80,12,2673,7,1959,5,714,201.740397,0.1934699999999907,81004.80694681735,29523.9572026685
"244.3.160.239",53101,"244.3.31.108",80,13,3286,7,1182,6,2104,201.841882,0.16414499999999066,57607.60303390623,102543.48289622564
"244.3.160.239",53102,"94.2.202.197",80,12,3535,7,1824,5,1711,201.856028,0.2980739999999855,48954.28651945728,45921.48258486371
"244.3.160.239",53103,"176.41.89.210",80,20,10367,10,1099,10,9268,202.334801,1.2947059999999908,6790.730868629683,57267.05522334841
"244.3.160.239",53104,"41.43.180.128",80,11,1940,6,1024,5,916,202.372997,0.07835600000001364,104548.47108069036,93521.8745213988
"244.3.160.239",53105,"198.123.241.156",80,25,15845,11,1436,14,14409,202.576215,0.5359610000000146,21434.395413098504,215075.35063184984
"244.3.160.239",53106,"41.43.180.128",80,11,1941,6,1025,5,916,202.761206,0.08454100000000153,96994.35776723544,86679.83581930504
"244.3.160.239",53107,"41.43.180.128",80,11,1942,6,1026,5,916,203.057029,0.08645899999999074,94935.17158422928,84756.93681399028
"244.3.160.239",53108,"198.123.241.156",80,70,63013,26,2423,44,60590,203.074043,0.7615040000000022,25454.88927175687,636529.8146825212
"244.3.160.239",8080,"244.3.160.204",6444,2,128,1,64,1,64,203.118314,0.0002819999999985612,0,0
"244.3.160.239",53109,"41.43.180.128",80,11,1944,6,1028,5,916,203.282378,0.07889800000000946,104235.84881744802,92879.41392683111
"244.3.160.239",53110,"176.41.89.210",80,273,249624,96,6776,177,242848,203.353543,9.522029000000003,5692.904316926569,204030.46451549343
"244.3.160.239",53111,"41.43.180.128",80,11,1946,6,1030,5,916,203.527718,0.08882800000000657,92763.54302696661,82496.51010941886
"244.3.160.239",53112,"117.246.95.43",80,14,3670,8,2877,6,793,203.550648,0.16334100000000262,140907.67168071476,38838.99327174376
"244.3.160.239",53113,"224.203.77.242",80,43,32149,17,1862,26,30287,203.663394,0.15589199999999437,95553.33179380943,1554255.5102250837
"244.3.160.239",53114,"198.123.241.156",80,11,1662,6,1218,5,444,203.716348,0.21081999999998402,46219.523764352234,16848.49634759638
"244.3.160.239",53115,"41.43.180.128",80,11,1947,6,1031,5,916,203.761818,0.07848899999999048,105084.78895133076,93363.40124094955
"244.3.160.239",53116,"41.43.180.128",80,11,1948,6,1032,5,916,203.851716,0.08675999999999817,95159.05947441417,84462.88612263894
"244.3.160.239",53117,"41.43.180.128",80,11,1949,6,1033,5,916,204.134093,0.08055899999999383,102583.19989077115,90964.3863503837
"244.3.160.239",53118,"41.43.180.128",80,11,1950,6,1034,5,916,204.198074,0.07883100000000809,104933.33840746853,92958.35394704175
"244.3.160.239",53119,"224.203.77.242",80,11,2034,6,1185,5,849,204.24158,0.13797700000000646,68707.1033578028,49225.5955702739
"244.3.160.239",53120,"224.203.77.242",80,11,2892,6,1183,5,1709,204.309483,0.1160549999999887,81547.54211366095,117806.21257163699
"244.3.160.239",53121,"224.203.77.242",80,12,2080,6,1191,6,889,204.369509,0.27730600000001004,34359.15558985256,25646.758454558294
"244.3.160.239",53122,"41.43.180.128",80,11,2392,6,1172,5,1220,204.372247,0.2677710000000104,35014.99415545237,36449.055349532326
"244.3.160.239",53123,"41.43.180.128",80,132,124727,48,8704,84,116023,204.383392,1.2798480000000154,54406.46076721545,725229.8710471782
"244.3.160.239",8080,"244.3.160.204",6780,2,128,1,64,1,64,205.118375,6.800000002726847e-5,0,0
"244.3.160.239",53124,"117.246.95.43",80,14,3655,8,2809,6,846,205.299356,0.8723400000000083,25760.597931998745,7758.4428089964185
"244.3.160.239",53125,"41.43.180.128",80,11,2160,6,1056,5,1104,205.456333,0.13411700000000337,62989.777582258685,65852.94929054317
"244.3.160.239",53126,"94.2.202.203",80,20,11002,13,9979,7,1023,205.634126,1.112702999999982,71746.00949220169,7355.062402096635
"244.3.160.239",53127,"41.43.180.128",80,15,4098,8,2025,7,2073,205.829694,0.1680290000000184,96411.9288932162,98697.24868920355
"244.3.160.239",53128,"117.246.95.43",80,108,90804,39,3231,69,87573,206.206772,0.7959089999999946,32476.074526108103,880231.2827220256
"244.3.160.239",53129,"41.43.180.128",80,11,2138,6,1045,5,1093,206.355925,0.25414599999999155,32894.47797722679,34405.420506324284
"244.3.160.239",53130,"117.246.95.43",80,10,1484,6,1000,4,484,206.636912,0.07242899999999963,110452.99534716814,53459.249748029375
"244.3.160.239",53131,"117.246.95.43",80,10,1484,6,1000,4,484,206.637965,0.07462999999998488,107195.49778911458,51882.62092993146
"244.3.160.239",53132,"117.246.95.43",80,10,1490,6,992,4,498,206.638053,0.07336799999998789,108167.04830445576,54301.602878648155
"244.3.160.239",53133,"117.246.95.43",80,10,1485,6,987,4,498,206.639021,0.0751189999999724,105113.22035707212,53035.84978502727
"244.3.160.239",53134,"117.246.95.43",80,10,1488,6,990,4,498,206.639183,0.0746120000000019,106149.1449096633,53396.23653031548
"244.3.160.239",53135,"117.246.95.43",80,10,1491,6,993,4,498,206.640094,0.07423399999998992,107012.95902148717,53668.13050624432
"244.3.160.239",53136,"128.71.90.164",80,10,1403,6,783,4,620,206.643827,0.24275400000001923,25803.900244690114,20432.207090303793
"244.3.160.239",53137,"94.2.202.203",80,118,106527,42,3927,76,102600,206.714674,1.0868110000000115,28906.590014270805,755237.111144432
"244.3.160.239",53138,"117.246.95.43",80,10,1488,6,990,4,498,206.764154,0.07247800000001803,109274.53848061521,54968.40420540039
"244.3.160.239",53139,"117.246.95.43",80,10,1488,6,990,4,498,206.764837,0.07265499999999747,109008.32702498487,54834.49177620451
"244.3.160.239",53140,"117.246.95.43",80,10,1484,6,986,4,498,206.765978,0.07391900000001783,106711.40031653698,53896.833019914215
"244.3.160.239",53141,"117.246.95.43",80,10,1485,6,987,4,498,206.766358,0.07289800000000923,108315.72882656589,54651.70512221866
"244.3.160.239",53142,"128.71.90.164",80,10,1565,6,784,4,781,206.812122,0.3057380000000194,20514.296554565026,20435.797970810316
"244.3.160.239",53143,"117.246.95.43",80,10,1483,6,998,4,485,206.975639,0.07380299999999806,108179.88428654945,52572.38865628906
"244.3.160.239",53144,"117.246.95.43",80,10,1473,6,988,4,485,206.976602,0.07451999999997838,106065.48577566148,52066.55931295123
"244.3.160.239",53145,"117.246.95.43",80,10,1468,6,983,4,485,206.976894,0.07452299999999923,105524.4689558939,52064.463320049384
"244.3.160.239",53146,"117.246.95.43",80,10,1469,6,984,4,485,206.977711,0.07533000000000811,104500.19912384378,51506.70383644739
"244.3.160.239",53147,"117.246.95.43",80,10,1470,6,985,4,485,206.977981,0.07422399999998675,106165.12179350894,52274.197025230285
"244.3.160.239",53148,"117.246.95.43",80,10,1479,6,994,4,485,206.979112,0.0729960000000176,108937.47602605735,53153.59745738211
"244.3.160.239",53149,"128.71.90.164",80,10,1715,6,863,4,852,207.039377,0.2842540000000042,24288.136666502134,23978.554391494574
"244.3.160.239",8080,"244.3.160.204",7111,2,128,1,64,1,64,207.118918,7.199999998874773e-5,0,0
"244.3.160.239",53150,"117.246.95.43",80,10,1467,6,982,4,485,207.124327,0.07257900000001882,108240.67567750951,53458.98951485958
"244.3.160.239",53151,"117.246.95.43",80,10,1469,6,984,4,485,207.124851,0.07430299999998624,105944.57828084273,52218.61835996822
"244.3.160.239",53152,"117.246.95.43",80,10,1475,6,990,4,485,207.125982,0.07347000000001458,107799.10167413132,52810.67102217545
"244.3.160.239",53153,"117.246.95.43",80,10,1472,6,987,4,485,207.126777,0.07487399999999411,105457.16804231938,51820.39159121064
"244.3.160.239",53154,"117.246.95.43",80,10,1477,6,992,4,485,207.127074,0.07455300000000875,106447.76199480997,52043.51266883351
"244.3.160.239",53155,"117.246.95.43",80,10,1474,6,989,4,485,207.127791,0.07478499999999144,105796.61696865555,51882.06191081693
"244.3.160.239",53156,"117.246.95.43",80,12,2009,7,1245,5,764,207.131311,0.1645069999999862,60544.536098772915,37153.43420037149
"244.3.160.239",53157,"128.71.90.164",80,10,1715,6,990,4,725,207.252214,0.24573899999998616,32229.316469915015,23602.277212816552
"244.3.160.239",53158,"117.246.95.43",80,10,1479,6,994,4,485,207.349898,0.07272299999999632,109346.42410242156,53353.13449665438
"244.3.160.239",53159,"117.246.95.43",80,10,1472,6,987,4,485,207.350762,0.07497299999999996,105317.91444920178,51751.9640403879
"244.3.160.239",53160,"117.246.95.43",80,10,1473,6,988,4,485,207.351074,0.07423299999999244,106475.55669312576,52267.859307860315
"244.3.160.239",53161,"117.246.95.43",80,10,1472,6,987,4,485,207.351845,0.0755450000000053,104520.484479442,51360.11648685853
"244.3.160.239",53162,"117.246.95.43",80,10,1479,6,994,4,485,207.352194,0.07443000000000666,106838.64033318943,52129.517667602486
"244.3.160.239",53163,"117.246.95.43",80,10,1480,6,995,4,485,207.352888,0.07342599999998356,108408.4656661371,52842.31743525276
"244.3.160.239",53164,"117.246.95.43",80,10,1472,6,986,4,486,207.465543,0.07268100000001709,108529.05160906076,53494.03558012528
"244.3.160.239",53165,"117.246.95.43",80,10,1471,6,986,4,485,207.466238,0.0729469999999992,108133.30226054651,53189.30182187125
"244.3.160.239",53166,"117.246.95.43",80,10,1476,6,991,4,485,207.467259,0.07515399999999772,105490.06040929611,51627.325225538465
"244.3.160.239",53167,"117.246.95.43",80,10,1472,6,987,4,485,207.467995,0.07522699999998395,104962.31406279241,51577.22626185848
"244.3.160.239",53168,"117.246.95.43",80,10,1470,6,985,4,485,207.468287,0.07469699999998625,105492.85781224749,51943.183795878205
"244.3.160.239",53169,"117.246.95.43",80,10,1471,6,986,4,485,207.469293,0.0730039999999974,108048.87403430333,53147.772724784096
"244.3.160.239",53170,"117.246.95.43",80,10,1468,6,983,4,485,207.578418,0.07211799999998902,109043.5120219806,53800.7154940596
"244.3.160.239",53171,"117.246.95.43",80,10,1650,6,939,4,711,207.579106,0.27990199999999277,26837.9647162228,20321.398203657518
"244.3.160.239",53172,"117.246.95.43",80,10,1475,6,990,4,485,207.579465,0.07266500000000065,108993.32553498837,53395.72008532258
"244.3.160.239",53173,"117.246.95.43",80,10,1470,6,985,4,485,207.583156,0.07409599999999728,106348.52083783591,52364.500107969965
"244.3.160.239",53174,"117.246.95.43",80,10,1656,6,940,4,716,207.583867,0.27548799999999574,27297.01475200414,20792.194215356343
"244.3.160.239",53175,"117.246.95.43",80,10,1475,6,990,4,485,207.584248,0.07414099999999735,106823.4849813232,52332.71738984015
"244.3.160.239",53176,"94.2.202.197",80,10,1833,6,1490,4,343,207.609363,0.11741399999999658,101521.11332550077,23370.29655748105
"244.3.160.239",53177,"94.2.202.197",80,10,1833,6,1489,4,344,207.613447,0.11796099999997978,100982.52812371921,23329.744576601348
"244.3.160.239",53178,"94.2.202.197",80,10,1839,6,1496,4,343,207.622011,0.11789400000000683,101514.92018253097,23275.145469657837
"244.3.160.239",53179,"94.2.202.197",80,10,1839,6,1495,4,344,207.622407,0.1178199999999947,101510.77915464723,23357.664233577692
"244.3.160.239",53180,"117.246.95.43",80,10,1482,6,997,4,485,207.691856,0.07257799999999293,109895.56063822063,53459.72608780041
"244.3.160.239",53181,"117.246.95.43",80,10,1472,6,987,4,485,207.69393,0.0746029999999962,105840.24771122343,52008.63236063158
"244.3.160.239",53182,"117.246.95.43",80,10,1475,6,990,4,485,207.694101,0.07466300000001524,106076.63769200786,51966.83765719577
"244.3.160.239",53183,"117.246.95.43",80,10,1474,6,989,4,485,207.694982,0.07357999999999265,107529.2198967218,52731.72057624881
"244.3.160.239",53184,"94.2.202.197",80,10,1840,6,1495,4,345,207.768166,0.118393999999995,101018.63270098573,23311.99216176594
"244.3.160.239",53185,"117.246.95.43",80,10,1472,6,987,4,485,207.800407,0.07445799999999281,106046.36170728145,52109.914314115
"244.3.160.239",53186,"117.246.95.43",80,10,1474,6,989,4,485,207.800649,0.07463300000000572,106012.08580653857,51987.72660886876
"244.3.160.239",53187,"117.246.95.43",80,10,1475,6,990,4,485,207.801444,0.0736789999999985,107493.3155987481,52660.86673272003
"244.3.160.239",53188,"117.246.95.43",80,10,1472,6,987,4,485,207.806384,0.0720269999999914,109625.55708277371,53868.688130846254
"244.3.160.239",53189,"117.246.95.43",80,10,1474,6,989,4,485,207.808001,0.072952000000015,108454.87443796432,53185.656321954186
"244.3.160.239",53190,"117.246.95.43",80,10,1474,6,989,4,485,207.809048,0.07396600000001285,106968.06640887198,52456.534083218314
"244.3.160.239",53192,"94.2.202.197",80,10,1826,6,1482,4,344,207.842193,0.11886099999998123,99746.76302573486,23153.094791398646
"244.3.160.239",53193,"94.2.202.197",80,10,1833,6,1490,4,343,207.880791,0.11693900000000212,101933.48668963976,23465.22545942714
"244.3.160.239",53194,"117.246.95.43",80,10,1470,6,985,4,485,207.92091,0.07270600000001082,108381.70164771583,53365.609440753484
"244.3.160.239",53195,"117.246.95.43",80,10,1476,6,991,4,485,207.921989,0.07305999999999813,108513.55050643586,53107.03531344237
"244.3.160.239",53196,"117.246.95.43",80,10,1471,6,986,4,485,207.923002,0.0775470000000098,101718.95753541727,50034.1728242164
"244.3.160.239",53197,"117.246.95.43",80,10,1475,6,990,4,485,207.923945,0.07290199999999913,108638.99481495835,53222.1338234897
"244.3.160.239",53198,"117.246.95.43",80,10,1476,6,991,4,485,207.924126,0.07591600000000653,104431.21344643181,51109.12060698227
"244.3.160.239",53199,"117.246.95.43",80,10,1473,6,988,4,485,207.925004,0.07465799999999945,105869.43127327357,51970.317983337736
"244.3.160.239",53200,"94.2.202.197",80,13,5607,7,1478,6,4129,207.967466,0.15709999999998558,75264.1629535397,210260.98026736494
"244.3.160.239",53201,"117.246.95.43",80,10,1472,6,987,4,485,208.029974,0.0720879999999795,109532.7932527223,53823.10509378958
"244.3.160.239",53202,"117.246.95.43",80,10,1472,6,987,4,485,208.033787,0.07236900000000901,109107.49077642385,53614.11654160645
"244.3.160.239",53203,"117.246.95.43",80,10,1556,6,1014,4,542,208.147481,0.17531099999999356,46272.05366463199,24733.18844795911
"244.3.160.239",53204,"94.2.202.197",80,10,1834,6,1490,4,344,208.190747,0.12051999999999907,98904.74610023308,22834.384334550457
"244.3.160.239",53205,"94.2.202.197",80,10,1816,6,1472,4,344,208.191002,0.11671200000000681,100897.93680169403,23579.409143874145
"244.3.160.239",53206,"94.2.202.197",80,10,1826,6,1482,4,344,208.191797,0.12016199999999344,98666.79982024805,22902.415072986056
"244.3.160.239",53207,"94.2.202.197",80,10,1823,6,1479,4,344,208.192087,0.11989200000002143,98688.81993792651,22953.991926062692
"244.3.160.239",53208,"128.71.90.164",443,28,15343,13,1764,15,13579,208.196729,0.676792000000006,20851.310299175926,160510.17151502828
"244.3.160.239",53209,"94.2.202.197",80,10,1828,6,1485,4,343,208.281135,0.11675999999999931,101747.17368962034,23501.199040767526
"244.3.160.239",53210,"94.2.202.197",80,10,1824,6,1480,4,344,208.28458,0.11769599999999514,100598.1511691178,23382.272974443596
"244.3.160.239",53211,"94.2.202.197",80,10,1815,6,1471,4,344,208.290122,0.11764600000000769,100028.9002600958,23392.21052989324
"244.3.160.239",53212,"94.2.202.197",80,10,1822,6,1479,4,343,208.290627,0.11727999999999383,100886.76671214719,23396.99863574475
"244.3.160.239",53213,"94.2.202.197",80,10,2017,6,1403,4,614,208.366652,0.31732900000000086,35370.23089601004,15479.202972309455
"244.3.160.239",53214,"94.2.202.197",80,10,1821,6,1478,4,343,208.371377,0.11709200000001374,100980.4256481964,23434.56427424314
"244.3.160.239",53215,"94.2.202.197",80,10,1822,6,1478,4,344,208.393224,0.11817299999998454,100056.6965381394,23287.891481136638
"244.3.160.239",53216,"94.2.202.197",80,10,1823,6,1479,4,344,208.393932,0.11781199999998648,100431.19546397105,23359.25033103857
"244.3.160.239",53217,"128.71.90.164",443,21,9255,11,1596,10,7659,208.777888,0.5417539999999974,23567.89243826545,113099.30337385657
"244.3.160.239",8080,"244.3.160.204",7450,2,128,1,64,1,64,209.119017,7.099999999127249e-5,0,0
"244.3.160.239",53218,"128.71.90.164",443,28,15040,14,1806,14,13234,209.345029,0.7324929999999767,19724.420574668235,144536.53482013257
"244.3.160.239",53219,"128.71.90.164",443,23,8645,12,1680,11,6965,209.367016,0.7095589999999845,18941.342439459288,78527.64886359163
"244.3.160.239",53220,"128.71.90.164",443,19,5718,11,1610,8,4108,209.374043,0.5863620000000083,21965.95277320123,56047.28819398177
"244.3.160.239",53221,"128.71.90.164",443,19,5789,11,1617,8,4172,209.377605,0.5827310000000239,22198.921972573058,57275.140673824855
"244.3.160.239",53222,"128.71.90.164",443,19,6461,11,1528,8,4933,209.922644,0.7054080000000056,17328.97840682258,55944.928325167406
"244.3.160.239",53223,"94.2.202.203",80,15,6264,9,5305,6,959,211.103226,0.9477709999999888,44778.74929703536,8094.782389416949
"244.3.160.239",8080,"244.3.160.204",7781,2,128,1,64,1,64,211.119732,7.199999998874773e-5,0,0
"244.3.160.239",53224,"94.2.202.203",80,18,8284,11,7015,7,1269,211.495728,0.19088399999998273,294000.54483353806,53184.13277174052
"244.3.160.239",53225,"94.2.202.203",80,222,209341,77,6961,145,202380,211.65329,1.2295770000000061,45290.37221743715,1316745.5149209783
"244.3.160.239",53226,"94.2.202.203",80,76,67432,28,2978,48,64454,212.019323,1.0482919999999751,22726.492236896367,491878.2171379847
"244.3.160.239",53227,"94.2.202.203",80,37,26453,16,2687,21,23766,212.521976,0.3937219999999968,54596.89831911901,482899.1013964207
"244.3.160.239",53228,"94.2.202.197",80,25,19738,11,2354,14,17384,212.905158,0.1647260000000017,114323.17909740907,844262.5936403394
"244.3.160.239",53229,"94.2.202.197",80,10,1833,6,1490,4,343,212.955,0.11687099999997486,101992.79547537511,23478.878421512527
"244.3.160.239",53230,"94.2.202.197",80,10,1832,6,1489,4,343,212.957462,0.1184599999999989,100557.15009285929,23163.937193989746
"244.3.160.239",53231,"94.2.202.197",80,10,1840,6,1496,4,344,212.958501,0.11782599999997956,101573.50669633252,23356.474801830474
"244.3.160.239",53232,"94.2.202.197",80,7,1647,5,1431,2,216,212.960569,0.07902000000001408,144874.7152619332,21867.881548971047
"244.3.160.248",35868,"41.177.26.55",80,24,14631,11,1522,13,13109,0.000711,23.834908000000002,510.84736723128947,4399.933072953333
"244.3.160.248",35884,"41.177.26.55",80,16,6507,8,1050,8,5457,0.930178,0.024265000000000092,346177.6220894279,1799134.5559447696
"244.3.160.248",35599,"41.177.26.72",80,2,128,1,64,1,64,2.505096,0.00013100000000010326,0,0
"244.3.160.248",35617,"41.177.26.55",80,2,128,1,64,1,64,2.625105,0.00011399999999994748,0,0
"244.3.160.248",35526,"41.177.26.55",80,2,128,1,64,1,64,3.5551180000000002,0.00015900000000002024,0,0
"244.3.160.248",35805,"41.177.26.193",80,4,256,2,128,2,128,3.7926159999999998,10.919803000000002,93.7745854938958,93.7745854938958
"244.3.160.248",35943,"41.177.26.55",80,11,2390,6,1416,5,974,5.682427,17.03312,665.057253163249,457.4616981504269
"244.3.160.248",35948,"41.177.26.55",80,27,13768,13,3718,14,10050,5.9119969999999995,19.073806,1559.4160913663482,4215.204873112371
"244.3.160.248",35955,"41.177.26.55",80,15,3754,8,2500,7,1254,6.189302,19.306691,1035.910296590959,519.6126047700251
"244.3.160.248",35958,"41.177.26.55",80,15,3764,8,2509,7,1255,6.241291,19.744551,1016.5842717821236,508.494723430277
"244.3.160.248",35959,"41.177.26.55",80,11,1741,6,1315,5,426,6.243447,17.032206,617.6534032056682,200.09152073430772
"244.3.160.248",35962,"41.177.26.193",80,24,7860,13,6366,11,1494,6.3638069999999995,30.868719999999996,1649.8254543758214,387.1880661070495
"244.3.160.248",35692,"41.177.26.55",80,2,128,1,64,1,64,7.375198,0.00010599999999971743,0,0
"244.3.160.248",35833,"41.177.26.193",80,78,75678,27,1728,51,73950,7.820098,26.055780999999996,530.5540448010368,22705.134035322146
"244.3.160.248",35745,"41.177.26.55",80,2,128,1,64,1,64,8.141049,0.00012100000000003774,0,0
"244.3.160.248",35732,"41.177.26.72",80,2,128,1,64,1,64,8.975286,0.00011199999999966792,0,0
"244.3.160.248",36046,"41.177.98.71",33456,11,765,6,391,5,374,10.006778,0.038402999999998855,81451.96989818747,77910.5799026141
"244.3.160.248",36067,"41.177.26.55",80,11,2410,6,1490,5,920,11.244968,1.9130269999999996,6230.9627621565205,3847.3058665664425
"244.3.160.248",36126,"41.177.26.72",80,13,3320,7,1290,6,2030,13.15745,15.00678,687.6891644976471,1082.17752242653
"244.3.160.248",36185,"41.177.26.193",80,2209,2255665,745,51543,1464,2204122,14.836149,26.822907,15372.830394557905,657384.973224565
"244.3.160.248",36190,"41.177.26.193",80,1472,1508549,494,32955,978,1475594,16.018078,17.857754000000003,14763.334739631868,661043.4884476513
"244.3.160.248",36199,"41.177.26.55",80,11,1509,6,733,5,776,17.407803,0.02463200000000043,238064.30659304553,252029.87983110957
"244.3.160.248",36213,"41.177.26.55",80,16,7089,8,1050,8,6039,19.081619,0.0324460000000002,258891.69697343122,1488997.1028786201
"244.3.160.248",36219,"41.177.26.55",80,16,6798,8,1049,8,5749,20.637346,0.03862699999999819,217257.35884227077,1190669.738783808
"244.3.160.248",36222,"41.177.26.55",80,24,12221,11,1042,13,11179,21.188862,11.284827999999997,738.6909220060777,7924.976791848314
"244.3.160.248",36245,"41.177.26.55",80,22,12106,10,985,12,11121,22.435391,7.606208000000002,1035.9958602236486,11696.761382281416
"244.3.160.248",36261,"41.177.26.193",80,2569,2628098,864,59109,1705,2568989,23.407681,18.251282,25908.974503818416,1126053.0630122311
"244.3.160.248",35636,"41.177.26.55",80,2,128,1,64,1,64,23.835554,0.00012700000000265277,0,0
"244.3.160.248",35550,"41.177.26.55",80,2,128,1,64,1,64,23.835614,9.500000000173259e-5,0,0
"244.3.160.248",35502,"41.177.26.55",80,2,128,1,64,1,64,23.835676,0.00018200000000234695,0,0
"244.3.160.248",36280,"41.177.26.193",80,19,5674,10,4504,9,1170,24.83221,35.44421,1016.5835266183109,264.0769818258046
"244.3.160.248",36298,"41.177.26.55",80,16,6855,8,1050,8,5805,26.51777,0.029329000000000605,286405.9463329751,1583415.731869448
"244.3.160.248",36307,"41.177.26.55",80,11,2399,6,1493,5,906,28.164315,17.041744000000005,700.86723518438,425.3085834407557
"244.3.160.248",35250,"41.177.26.193",80,2,128,1,64,1,64,33.875837,9.900000000584441e-5,0,0
"244.3.160.248",36331,"41.177.26.193",80,11,3515,6,1781,5,1734,35.773888,35.222758999999996,404.51118550934643,393.83626932802173
"244.3.160.248",36332,"41.177.26.55",80,16,7364,8,1050,8,6314,36.041425,0.24272100000000307,34607.6359276696,208107.25071171988
"244.3.160.248",36333,"41.177.26.55",80,11,1509,6,733,5,776,36.493273,0.028795999999999822,203639.39436032908,215585.4979858327
"244.3.160.248",36334,"41.177.26.193",80,14,3120,7,2220,7,900,36.616862,0.030751000000002193,577542.1937497555,234138.72719584685
"244.3.160.248",36335,"41.177.26.193",80,11,2521,6,1783,5,738,36.702949,0.021959000000002504,649574.2064756306,268864.70239989646
"244.3.160.248",36336,"41.177.26.55",80,11,2346,6,1450,5,896,36.773899,18.446945,628.8304106723363,388.5738261809747
"244.3.160.248",36337,"41.177.26.193",80,63,52089,24,3001,39,49088,36.797421,2.579309000000002,9307.91929156219,152251.63018467338
"244.3.160.248",36345,"41.177.26.55",80,22,12112,10,988,12,11124,40.063518,11.249707999999998,702.5960140476536,7910.60532415597
"244.3.160.248",36355,"41.177.26.55",80,25,14375,11,1054,14,13321,40.463334,17.032889999999995,495.0422388684482,6256.601199209296
"244.3.160.248",36356,"41.177.26.55",80,24,12676,11,1051,13,11625,41.46752,17.048679999999997,493.1760112806388,5454.967774631234
"244.3.160.248",36359,"41.177.26.193",80,1111,1129864,377,27946,734,1101918,41.805522,18.470834999999994,12103.838294262283,477257.47103474225
"244.3.160.248",36360,"41.177.26.193",80,90,79771,33,4985,57,74786,41.82188,29.174691000000003,1366.9382136729398,20507.089518103207
"244.3.160.248",36361,"41.177.26.72",80,11,1542,6,989,5,553,42.804621,0.01277300000000281,619431.6135597165,346355.5938306605
"244.3.160.248",36362,"41.177.26.72",80,11,1621,6,1059,5,562,42.818788,0.12158000000000158,69682.51357131016,36979.76640894836
"244.3.160.248",36363,"41.177.26.72",80,13,3897,7,1187,6,2710,42.942009,0.009039000000001352,1050558.6901204316,2398495.408783799
"244.3.160.248",36366,"41.177.26.72",80,13,3024,7,994,6,2030,43.419428,17.236841,461.33743416209506,942.1679993451237
"244.3.160.248",36368,"41.177.26.55",80,16,6557,8,1050,8,5507,43.652313,0.026063000000000613,322295.97513716004,1690365.652457467
"244.3.160.248",36396,"41.177.26.55",80,11,2459,6,1521,5,938,45.279455,2.115873999999998,5750.815029628424,3546.5249821114144
"244.3.160.248",36402,"41.177.26.55",80,11,1645,6,973,5,672,46.130101,0.026786999999998784,290588.7184081963,200694.36667040893
"244.3.160.248",36405,"41.177.26.72",80,13,3532,7,1502,6,2030,46.367869,17.178533,699.477656211971,945.3659401533297
"244.3.160.248",36407,"41.177.26.72",80,13,3354,7,1324,6,2030,47.394945,16.960749,624.5007222263592,957.5048837760644
"244.3.160.248",36410,"41.177.26.55",80,11,1645,6,973,5,672,47.944593,0.031144000000004723,249935.78217309335,172617.5186231436
"244.3.160.248",36418,"41.177.26.55",80,24,12883,11,1048,13,11835,49.760381,17.045984999999995,491.8460270849706,5554.387147471973
"244.3.160.248",36424,"41.177.26.193",80,2239,2302059,750,49339,1489,2252720,52.850804,18.145685,21752.389066601783,993170.5526685821
"244.3.160.248",36427,"41.177.26.55",80,11,1509,6,733,5,776,55.15306,0.03088399999999325,189871.77826710534,201010.23183529844
"244.3.160.248",36434,"41.177.26.55",80,11,2376,6,1500,5,876,56.000814,22.165912999999996,541.3717900995101,316.1611254181139
"244.3.160.248",36437,"41.177.26.55",80,25,13818,11,1046,14,12772,57.596663,14.147147999999994,591.4973109774495,7222.374431934977
"244.3.160.248",36459,"41.177.26.193",80,102,93204,38,6235,64,86969,59.259159,22.49754,2217.1312952438357,30925.69232013811
"244.3.160.248",36460,"41.177.26.193",80,14,3430,7,2530,7,900,59.549556,0.04211999999999705,480531.8138651809,170940.17094018293
"244.3.160.248",36473,"41.177.26.193",80,124,117073,44,4468,80,112605,60.217059,0.60304,59273.016715309095,1493831.2549747943
"244.3.160.248",36474,"41.177.26.55",80,24,12538,11,1038,13,11500,60.321197,11.478091000000006,723.4652521921978,8015.270135077336
"244.3.160.248",36509,"41.177.26.55",80,11,2129,6,1353,5,776,63.491242,17.015702000000005,636.1183335251168,364.8394876685075
"244.3.160.248",36526,"41.177.26.55",80,22,12101,10,979,12,11122,63.996016,17.040776000000008,459.60348284608614,5221.358463957273
"244.3.160.248",36527,"41.177.26.55",80,22,12106,10,985,12,11121,64.112948,10.179095000000004,774.1356181467996,8740.266202447267
"244.3.160.248",36572,"41.177.98.71",33456,11,759,6,391,5,368,65.403256,0.037853999999995835,82633.27521530999,77772.49432029175
"244.3.160.248",36639,"41.177.98.71",33456,11,763,6,391,5,372,68.151328,0.027367999999995618,114294.06606257311,108740.13446362455
"244.3.160.248",36742,"41.177.26.55",80,22,12097,10,977,12,11120,71.284991,17.04184199999999,458.6358681180124,5220.092992295085
"244.3.160.248",36751,"41.177.26.55",80,22,9134,11,3090,11,6044,74.012605,22.144408000000013,1116.3089119383994,2183.485781150707
"244.3.160.248",36753,"41.177.26.55",80,11,1509,6,733,5,776,74.219213,0.022306999999997856,262877.123772832,278298.2920159859
"244.3.160.248",36755,"41.177.26.55",80,11,2223,6,1437,5,786,74.31226,15.549694000000002,739.3071529253243,404.38094794662834
"244.3.160.248",36832,"41.177.26.55",80,11,2341,6,1453,5,888,79.68172,18.812314999999998,617.8931194805106,377.62497597983025
"244.3.160.248",36833,"41.177.26.55",80,11,2013,6,1241,5,772,79.906522,17.030642,582.9492511204216,362.6404688678207
"244.3.160.248",36841,"41.177.26.55",80,11,2317,6,1381,5,936,81.927894,1.9668460000000039,5617.114913928176,3807.1104702655853
"244.3.160.248",36843,"41.177.26.55",80,22,12052,10,992,12,11060,82.129362,17.061048999999997,465.1531098703252,5186.0820515784235
"244.3.160.248",36863,"41.177.26.72",80,13,3468,7,1438,6,2030,83.894495,17.182542999999995,669.5167298577401,945.1453140550851
"244.3.160.248",36898,"41.177.26.193",80,14,3464,7,2564,7,900,85.768723,0.04630600000000129,442966.3542521364,155487.40983889342
"244.3.160.248",36899,"41.177.26.193",80,1232,1262521,414,27835,818,1234686,85.778157,17.918915000000013,12427.09170728249,551232.4825470735
"244.3.160.248",36901,"41.177.26.193",80,213,208035,74,6387,139,201648,85.896992,0.665931999999998,76728.55486746418,2422445.534979555
"244.3.160.248",36904,"41.177.26.211",2641,13,1061,7,511,6,550,86.087557,0.18102799999999775,22582.14198908484,24305.632277879966
"244.3.160.248",36907,"41.177.26.211",2641,16,1405,8,643,8,762,86.312761,0.6920840000000084,7432.623785551953,8808.179353951147
"244.3.160.248",36917,"41.177.98.71",33456,11,762,6,391,5,371,87.484287,0.04931799999999953,63425.118617949425,60180.86702623846
"244.3.160.248",36941,"41.177.26.55",80,22,12097,10,977,12,11120,88.950214,3.370560999999995,2318.90180892736,26393.23246189585
"244.3.160.248",36944,"41.177.26.55",80,16,6271,8,1050,8,5221,89.025172,0.03238299999999583,259395.36176392186,1289812.5559708914
"244.3.160.248",36979,"41.177.26.55",80,14,5913,7,803,7,5110,91.458613,0.03784000000000276,169767.44186045273,1080338.2663846991
"244.3.160.248",37001,"41.177.26.193",80,661,668703,224,17909,437,650794,92.562429,17.594777000000008,8142.871034966794,295903.2672025339
"244.3.160.248",37005,"41.177.26.72",80,11,1361,6,807,5,554,93.047425,0.012196000000002982,529353.8865200412,363397.83535576554
"244.3.160.248",37006,"41.177.26.72",80,11,1439,6,876,5,563,93.061679,0.16633099999999956,42132.855571120344,27078.536171850177
"244.3.160.248",37007,"41.177.26.55",80,11,1509,6,733,5,776,93.110563,0.024039999999999395,243926.78868553025,258236.27287854228
"244.3.160.248",37008,"41.177.26.72",80,13,3659,7,1003,6,2656,93.229846,0.011191000000010831,717004.7359478361,1898668.572958577
"244.3.160.248",37025,"41.177.26.55",80,11,2299,6,1407,5,892,95.973765,17.024086999999994,661.1808316064177,419.1707901868689
"244.3.160.248",37032,"41.177.26.55",80,16,6129,8,1050,8,5079,96.774414,0.03338400000001229,251617.54133707486,1217109.9928104791
"244.3.160.248",37038,"41.177.26.55",80,16,6653,8,1050,8,5603,97.20818,0.027933000000004427,300719.57899254176,1604696.953424011
"244.3.160.248",37045,"41.177.98.168",80,11,1230,6,639,5,591,97.55586,0.03329500000000962,153536.56705206554,142003.30379932825
"244.3.160.248",37048,"41.177.26.55",80,16,7201,8,1051,8,6150,97.892774,0.02656199999999842,316542.4290339771,1852270.1603795995
"244.3.160.248",37049,"41.177.26.55",80,25,13969,11,1054,14,12915,98.137153,17.030169,495.1213343801814,6066.880487210667
"244.3.160.248",37050,"41.177.26.55",80,11,2245,6,1269,5,976,98.161889,15.117192000000003,671.5532884678582,516.4980374662172
"244.3.160.248",37073,"41.177.26.55",80,31,17456,14,2877,17,14579,100.242787,17.57498199999999,1309.5888234764627,6636.251462448158
"244.3.160.248",37074,"41.177.26.72",80,13,3424,7,1394,6,2030,100.377342,0.18459000000000003,60414.97372555392,87978.76374668183
"244.3.160.248",37075,"41.177.26.55",80,53,40759,21,2592,32,38167,100.40768,17.409745,1191.0570775160693,17538.22356387184
"244.3.160.248",37076,"41.177.26.55",80,166,156094,59,5012,107,151082,100.407983,21.249503000000004,1886.9147198407413,56879.25971727432
"244.3.160.248",37077,"41.177.26.55",80,28,13936,13,2077,15,11859,100.408092,17.409571999999997,954.4174894132954,5449.415987940428
"244.3.160.248",37078,"41.177.26.55",80,50,36971,20,2530,30,34441,100.408508,17.408991999999998,1162.6175714251578,15826.763548400737
"244.3.160.248",37079,"41.177.26.55",80,23,10018,11,1941,12,8077,100.50954,21.028220000000005,738.4362537580449,3072.823092016347
"244.3.160.248",37130,"41.177.26.193",80,269,260835,95,10440,174,250395,106.258701,17.668786999999995,4726.979843041859,113372.80821824388
"244.3.160.248",37131,"41.177.26.193",80,30,11538,15,5493,15,6045,106.369765,17.397729999999996,2525.846762767327,2779.672980325595
"244.3.160.248",37132,"41.177.26.193",80,360,348392,126,12635,234,335757,106.389636,19.897897,5079.933824162423,134991.95417485575
"244.3.160.248",37133,"41.177.26.193",80,22,5615,11,3742,11,1873,106.417116,17.36041200000001,1724.3830388357133,863.1131565310772
"244.3.160.248",37134,"41.177.26.193",80,166,154459,60,7334,106,147125,106.432648,18.884893000000005,3106.8219449270896,62324.94936561196
"244.3.160.248",37135,"41.177.26.193",80,24,8927,12,3812,12,5115,106.439909,17.367554999999996,1755.917859479933,2356.117484585482
"244.3.160.248",37138,"41.177.98.168",80,11,1230,6,639,5,591,106.6344,0.023887999999999465,213998.66041527607,197923.64367046658
"244.3.160.248",37215,"41.177.26.55",80,11,1509,6,733,5,776,112.282839,0.026910999999998353,217903.45955186946,230686.33644236112
"244.3.160.248",37222,"41.177.26.193",80,14,3440,7,2540,7,900,114.898888,0.039224000000004366,518050.17336318933,183561.08504994898
"244.3.160.248",37227,"41.177.26.193",80,4645,4767004,1556,101235,3089,4665769,115.019327,5.440550000000002,148859.94982124964,6860731.359880893
"244.3.160.248",37237,"41.177.26.55",80,24,12683,11,1053,13,11630,115.599857,17.027833,494.7194396374453,5463.9953304686505
"244.3.160.248",37250,"41.177.26.55",80,24,12219,11,1041,13,11178,117.537516,16.76234699999999,496.8278010233295,5334.813794273561
"244.3.160.248",37301,"41.177.26.55",80,25,16618,11,1249,14,15369,122.532914,0.4923390000000012,20294.95936742768,249730.3687093643
"244.3.160.248",37306,"41.177.98.71",33456,11,763,6,391,5,372,123.302531,0.023792999999997733,131467.2382633673,125078.80469046709
"244.3.160.248",37367,"41.177.26.55",80,11,2540,6,1648,5,892,125.866589,19.61128199999999,672.2660966274417,363.8721833687366
"244.3.160.248",37430,"41.177.26.55",80,24,12672,11,1049,13,11623,127.117218,17.040604000000016,492.4708067859562,5456.614096542582
"244.3.160.248",37484,"41.177.26.55",80,22,12100,10,980,12,11120,128.655083,15.001074000000017,522.6292464126229,5930.242061335069
"244.3.160.248",37504,"41.177.26.55",80,11,1506,6,730,5,776,131.228459,0.023966000000001486,243678.54460484177,259033.63097720165
"244.3.160.248",37505,"41.177.26.55",80,22,12116,10,990,12,11126,131.284332,17.04421099999999,464.6739001294929,5222.183649334079
"244.3.160.248",37508,"41.177.26.72",80,13,2989,7,959,6,2030,131.436463,15.746057000000008,487.23308952838136,1031.3693136002234
"244.3.160.248",37510,"41.177.26.55",80,22,12109,10,983,12,11126,131.822468,17.02563600000002,461.89170260658636,5227.881061241994
"244.3.160.248",37516,"41.177.98.168",80,11,1234,6,643,5,591,133.01871,0.024745999999993273,207871.97930984394,191061.18160515983
"244.3.160.248",37541,"41.177.26.55",80,11,2091,6,1203,5,888,135.787823,0.09993000000000052,96307.41519063295,71089.76283398342
"244.3.160.248",37575,"41.177.26.55",80,22,12040,10,981,12,11059,138.47089,17.027136000000013,460.91133588173574,5195.9413491499645
"244.3.160.248",37578,"41.177.98.168",80,11,1234,6,643,5,591,139.059414,0.021164999999996326,243042.75927242584,223387.66832037896
"244.3.160.248",37627,"41.177.98.71",33456,11,758,6,391,5,367,141.091068,0.03891899999999282,80372.05478045625,75438.73172487838
"244.3.160.248",37630,"41.177.26.55",80,16,6577,8,1286,8,5291,141.529902,15.852643,648.976956082339,2670.0910378162175
"244.3.160.248",37643,"41.177.26.55",80,16,7115,8,942,8,6173,144.681535,5.545704000000001,1358.8896919128752,8904.910900401463
"244.3.160.248",37657,"41.177.26.55",80,11,2644,6,1662,5,982,147.959167,15.061075999999986,882.8054516158084,521.6094786322045
"244.3.160.248",37730,"41.177.26.55",80,11,1506,6,730,5,776,150.240988,0.01904500000000553,306642.1632973644,325964.82016267773
"244.3.160.248",37744,"41.177.26.55",80,11,2543,6,1649,5,894,151.321184,26.27733600000002,502.0295816897112,272.17370893305144
"244.3.160.248",37748,"41.177.98.168",80,11,1225,6,634,5,591,151.809743,0.023450999999994337,216280.75561814953,201611.87156202897
"244.3.160.248",37756,"41.177.26.55",80,22,12106,10,982,12,11124,152.889288,17.029000999999994,461.3306441170567,5225.908437024581
"244.3.160.248",37762,"41.177.26.193",80,272,297993,66,8075,206,289918,153.524457,52.93399099999999,1220.3878600425198,43815.7780319266
"244.3.160.248",37787,"41.177.26.55",80,17,8689,8,1050,9,7639,157.889892,0.04797400000001062,175094.84303994122,1273856.6723639152
"244.3.160.248",37788,"41.177.26.55",80,22,12101,10,979,12,11122,157.928708,1.8409420000000125,4254.343700127406,48331.77797019102
"244.3.160.248",37803,"41.177.26.55",80,22,13335,10,1573,12,11762,164.239376,17.07915300000002,736.8046881481761,5509.406701842878
"244.3.160.248",37804,"41.177.26.55",80,65,51823,25,3090,40,48733,164.521572,18.24705,1354.7395332396195,21365.864619212418
"244.3.160.248",37805,"41.177.26.55",80,164,152853,59,5236,105,147617,164.534443,18.08408399999999,2316.2909440146386,65302.505783538756
"244.3.160.248",37806,"41.177.26.55",80,54,39668,22,3611,32,36057,164.546642,26.93225800000002,1072.6170824592568,10710.42762177608
"244.3.160.248",37807,"41.177.26.55",80,21,7125,11,2892,10,4233,164.559609,18.088966999999997,1279.0116760122346,1872.0803681050447
"244.3.160.248",37810,"41.177.98.71",33456,11,766,6,391,5,375,165.303553,0.026392000000015514,118520.76386776907,113670.80933609566
"244.3.160.248",37825,"41.177.26.55",80,11,2458,6,1436,5,1022,166.716271,2.0016809999999907,5739.176222385112,4084.566921502496
"244.3.160.248",37836,"41.177.26.72",80,13,3525,7,1495,6,2030,168.717688,17.161333999999982,696.9155195044868,946.3133809994034
"244.3.160.248",37847,"41.177.26.55",80,11,1506,6,730,5,776,169.485071,0.02825599999999895,206681.76670442446,219705.54926388134
"244.3.160.248",37858,"41.177.26.55",80,11,2166,6,715,5,1451,170.393162,0.014221000000020467,402222.06595821446,816257.6471403765
"244.3.160.248",37904,"41.177.26.55",80,23,10982,11,2167,12,8815,174.255416,17.223439000000013,1006.5353382678097,4094.4204000141867
"244.3.160.248",37907,"41.177.26.55",80,11,2292,6,1408,5,884,174.72286,15.092578000000003,746.327101970253,468.57468618018726
"244.3.160.248",37912,"41.177.26.55",80,24,12222,11,1046,13,11176,175.692003,16.20657299999999,516.3337122536642,5516.773965723663
"244.3.160.248",37959,"41.177.26.193",80,15,5626,8,1932,7,3694,178.383211,17.065525000000008,905.6855854126957,1731.6783398108166
"244.3.160.248",38056,"41.177.26.55",80,11,2466,6,1532,5,934,182.194315,20.164624000000003,607.7971005063123,370.5499294209502
"244.3.160.248",38109,"41.177.26.193",80,276,263195,98,12743,178,250452,186.140147,26.118945999999994,3903.0671452056304,76711.21185364832
"244.3.160.248",38154,"41.177.26.55",80,11,1506,6,730,5,776,188.281755,0.02207799999999338,264516.71347050235,281184.88993576687
"244.3.160.248",38158,"41.177.26.72",80,13,3318,7,1288,6,2030,188.618831,16.861334,611.1023006839198,963.1503652083519
"244.3.160.248",38162,"41.177.26.55",80,24,14133,11,1471,13,12662,190.713464,17.085645,688.7653348761489,5928.71969422284
"244.3.160.248",38206,"41.177.26.193",80,65,49102,27,6619,38,42483,194.894661,17.334434999999985,3054.7289254019556,19606.292330843222
"244.3.160.248",38207,"41.177.26.193",80,174,160490,63,8924,111,151566,194.898687,17.33060499999999,4119.417642950147,69964.55115098409
"244.3.160.248",38209,"41.177.26.193",80,31,13072,15,5862,16,7210,194.99824,17.230932999999993,2721.616989631381,3347.468184108198
"244.3.160.248",38210,"41.177.26.193",80,16,4235,8,2104,8,2131,195.320452,17.02863100000002,988.4529179121905,1001.1374372960446
"244.3.160.248",38211,"41.177.26.193",80,16,3195,8,2103,8,1092,195.343539,17.025513000000018,988.1640570830366,513.1122921230034
"244.3.160.248",38260,"41.177.26.193",80,335,321199,197,240471,138,80728,198.110383,11.028609999999986,174434.31221160258,58558.96617978157
"244.3.160.248",38324,"41.177.26.55",80,11,2396,6,1380,5,1016,203.854686,0.02707900000001473,407696.000590642,300158.79463774804
"244.3.160.248",38358,"41.177.26.72",80,11,2774,6,808,5,1966,206.41567,5.169831999999985,1250.3307651003008,3042.2652032019696
"244.3.160.248",38376,"41.177.26.55",80,11,3540,6,2046,5,1494,207.540927,2.525414999999981,6481.310992450794,4732.687498886357
"244.3.160.248",38390,"41.177.26.55",80,11,1506,6,730,5,776,208.180221,0.02420000000000755,241322.3140495115,256528.92561975468
"244.3.160.248",38400,"41.177.26.193",80,43,34363,18,6247,25,28116,208.818405,0.4303949999999759,116116.59057378177,522608.30167639634
"244.3.160.248",38401,"41.177.26.193",80,14,4686,7,3069,7,1617,208.921124,0.2367760000000203,103692.94185220585,54633.91559954933
"244.3.160.248",38402,"41.177.26.193",80,61,52536,23,5413,38,47123,208.927182,0.19105000000001837,226663.17717872723,1973221.669719779
"244.3.160.248",38403,"41.177.26.193",80,235,232514,81,7898,154,224616,208.936825,0.21216899999998873,297800.3384094913,8469323.98229758
"244.3.160.248",38404,"41.177.26.193",80,158,153187,55,6126,103,147061,208.944506,0.21126499999999737,231974.06101342206,5568778.548268831
"244.3.160.248",38405,"41.177.26.193",80,16,7998,8,3139,8,4859,208.95524699999999,0.15832100000000082,158614.46049481668,245526.49364266143
"244.3.160.248",38417,"41.177.26.55",80,20,12303,9,929,11,11374,211.161747,0.10711299999999824,69384.66852763084,849495.3927161176
"244.3.160.248",38421,"41.177.26.55",80,11,1646,6,974,5,672,211.504471,0.024610999999993055,316606.3955142903,218438.909430804
"244.3.160.254",51807,"41.177.26.211",2641,26,2126,14,1022,12,1104,105.677842,0.17595099999999775,46467.48242408457,50195.79314695633
"244.3.160.254",51819,"41.177.26.211",2641,32,2806,16,1284,16,1522,105.892489,0.6163470000000046,16665.936558464506,19755.10548441042
"244.3.160.254",51947,"41.177.230.224",25,44,21292,25,19521,19,1771,116.729423,0.2517600000000044,620305.0524308756,56275.81823959228
"244.3.160.254",52186,"41.177.26.55",80,22,4968,12,3124,10,1844,134.52577,0.022598000000016327,1105938.5786344784,652801.1328431428
"244.3.160.254",2784,"244.3.160.204",1092,2,128,1,64,1,64,171.115356,6.799999999884676e-5,0,0
"244.3.160.254",2785,"244.3.160.204",1093,2,128,1,64,1,64,171.115614,6.8999999996322e-5,0,0
"244.3.160.254",4000,"244.3.160.204",1094,7,448,3,192,4,256,171.115872,0.15718499999999835,9771.924801985024,13029.233069313366
"244.3.160.254",4001,"244.3.160.204",1095,2,128,1,64,1,64,171.116228,6.700000000137152e-5,0,0
"244.3.160.254",4002,"244.3.160.204",1424,2,128,1,64,1,64,173.114351,7.099999999127249e-5,0,0
"244.3.160.254",2048,"244.3.160.204",1425,2,128,1,64,1,64,173.114611,6.700000000137152e-5,0,0
"244.3.160.254",2784,"244.3.160.204",1428,2,128,1,64,1,64,173.115464,6.700000000137152e-5,0,0
"244.3.160.254",2785,"244.3.160.204",1429,2,128,1,64,1,64,173.115721,6.700000000137152e-5,0,0
"244.3.160.254",4000,"244.3.160.204",1760,7,448,3,192,4,256,175.114188,0.15561199999999076,9870.704058813531,13160.938745084708
"244.3.160.254",4001,"244.3.160.204",1761,2,128,1,64,1,64,175.114471,6.8999999996322e-5,0,0
"244.3.160.254",4002,"244.3.160.204",1762,2,128,1,64,1,64,175.114765,6.600000000389628e-5,0,0
"244.3.160.254",2048,"244.3.160.204",1763,2,128,1,64,1,64,175.115028,6.700000000137152e-5,0,0
"244.3.160.254",2784,"244.3.160.204",2091,2,128,1,64,1,64,177.114702,7.200000001716944e-5,0,0
"244.3.160.254",2785,"244.3.160.204",2092,2,128,1,64,1,64,177.114972,6.799999999884676e-5,0,0
"244.3.160.254",4000,"244.3.160.204",2093,7,448,3,192,4,256,177.115231,0.15620000000001255,9833.546734954396,13111.39564660586
"244.3.160.254",4001,"244.3.160.204",2094,2,128,1,64,1,64,177.115538,6.900000002474371e-5,0,0
"244.3.160.254",4002,"244.3.160.204",2095,2,128,1,64,1,64,177.115796,9.099999999762076e-5,0,0
"244.3.160.254",2784,"244.3.160.204",2432,2,128,1,64,1,64,179.115116,5.7999999995672624e-5,0,0
"244.3.160.254",2785,"244.3.160.204",2433,2,128,1,64,1,64,179.11536,6.499999997799932e-5,0,0
"244.3.160.254",4000,"244.3.160.204",2434,7,448,3,192,4,256,179.11561,0.15977799999998865,9613.338507179393,12817.784676239191
"244.3.160.254",4001,"244.3.160.204",2435,2,128,1,64,1,64,179.115912,7.199999998874773e-5,0,0
"244.3.160.254",4002,"244.3.160.204",2761,2,128,1,64,1,64,181.11527,6.799999999884676e-5,0,0
"244.3.160.254",2784,"244.3.160.204",2765,2,128,1,64,1,64,181.116334,6.799999999884676e-5,0,0
"244.3.160.254",2785,"244.3.160.204",2766,2,128,1,64,1,64,181.116592,6.400000000894579e-5,0,0
"244.3.160.254",4000,"244.3.160.204",3095,7,448,3,192,4,256,183.115073,0.16300799999999072,9422.850412250242,12563.80054966699
"244.3.160.254",4001,"244.3.160.204",3096,2,128,1,64,1,64,183.115309,6.799999999884676e-5,0,0
"244.3.160.254",4002,"244.3.160.204",3097,2,128,1,64,1,64,183.115555,7.099999999127249e-5,0,0
"244.3.160.254",4000,"244.3.160.204",3433,7,448,3,192,4,256,185.115323,0.1524430000000052,10075.897220600142,13434.529627466856
"244.3.160.254",4001,"244.3.160.204",3434,2,128,1,64,1,64,185.115577,6.8999999996322e-5,0,0
"244.3.160.254",4002,"244.3.160.204",3435,2,128,1,64,1,64,185.115833,7.199999998874773e-5,0,0
"244.3.160.254",4000,"244.3.160.204",3766,7,448,3,192,4,256,187.11622,0.1592640000000074,9644.364074743373,12859.152099657831
"244.3.160.254",4001,"244.3.160.204",3767,2,128,1,64,1,64,187.116505,6.900000002474371e-5,0,0
"244.3.164.68",7107,"244.3.160.239",80,10,2115,5,1568,5,547,15.639399000000001,104.61895,119.90179599393801,41.82798623002812
"244.3.164.68",2774,"244.3.160.239",80,10,2121,5,1574,5,547,97.034449,104.62310200000002,120.35582733916642,41.82632627352226
"244.3.165.213",7352,"244.3.160.239",80,673,431692,280,19672,393,412020,0.792443,2.905119,54171.96335158732,1134604.1246503156
"244.3.165.213",9823,"244.3.160.239",80,14,3263,7,1140,7,2123,0.827248,0.16379200000000005,55680.37510989546,103692.48803360357
"244.3.165.213",14870,"244.3.160.239",80,36,17137,18,2200,18,14937,0.831137,0.14199700000000004,123946.28055522297,841538.9057515297
"244.3.165.213",13814,"244.3.160.239",80,56,27736,28,2874,28,24862,0.832681,0.17730500000000005,129674.85406502915,1121773.2156453566
"244.3.165.213",10335,"244.3.160.239",80,60,30546,30,3012,30,27534,1.023374,0.1717200000000001,140321.45352900063,1282739.3431167009
"244.3.165.213",3652,"244.3.160.239",80,14,4059,7,1410,7,2649,1.205709,0.0729200000000001,154690.0713110256,290619.85737794806
"244.3.165.213",11007,"244.3.160.239",80,15,4327,8,1472,7,2855,1.456014,0.07888000000000006,149290.06085192686,289553.7525354967
"244.3.165.213",6010,"244.3.160.239",80,234,141682,103,8172,131,133510,1.540753,4.559125,14339.593672031366,234273.02388067887
"244.3.165.213",11999,"244.3.160.239",80,87,46204,43,3934,44,42270,6.158103,0.21593100000000032,145750.2628154362,1566055.8233880245
"244.3.165.213",6722,"244.3.160.239",80,80,40500,40,3729,40,36771,6.4017669999999995,0.2073470000000004,143874.7606669011,1418723.2031329097
"244.3.165.213",7235,"244.3.160.239",80,14,4359,7,1393,7,2966,6.628959,0.07689799999999991,144919.2436734377,308564.5920570109
"244.3.165.213",9190,"244.3.160.239",80,42,19360,21,2410,21,16950,6.713243,0.2316419999999999,83231.88368257918,585386.0698837001
"244.3.165.213",3382,"244.3.160.239",80,15,4226,8,1504,7,2722,6.7149149999999995,0.10067500000000074,119513.2853240617,216299.975167617
"244.3.165.213",3908,"244.3.160.239",80,12,2019,6,1335,6,684,6.716695,0.09904600000000041,107828.68566120748,55247.05692304563
"244.3.165.213",7122,"244.3.160.239",80,13,2187,7,1437,6,750,6.955252,0.16849200000000053,68228.75863542462,35609.9992877999
"244.3.165.213",15028,"244.3.160.239",80,13,2185,7,1438,6,747,6.9583770000000005,0.1653709999999995,69564.7967297775,36136.92848201933
"244.3.165.213",9166,"244.3.160.239",80,13,3103,7,1449,6,1654,6.961571,0.1627390000000002,71230.62081000858,81308.10684593112
"244.3.165.213",13546,"244.3.160.239",80,13,2142,7,1433,6,709,6.988223,0.13642800000000044,84029.67132846602,41575.0432462543
"244.3.165.213",13996,"244.3.160.239",80,13,2198,7,1447,6,751,6.995172,0.12953999999999954,89362.3591168754,46379.49668056215
"244.3.165.213",9471,"244.3.160.239",80,13,2275,7,1449,6,826,7.004098,0.12111200000000011,95713.05898672294,54561.0674417068
"244.3.165.213",5819,"244.3.160.239",80,13,3345,7,1446,6,1899,7.04203,0.09917200000000026,116645.82745129643,153188.39995159884
"244.3.165.213",9988,"244.3.160.239",80,13,3387,7,1443,6,1944,7.063786,0.08646999999999938,133502.948999654,179854.28472302662
"244.3.165.213",8422,"244.3.160.239",80,13,2492,7,1447,6,1045,7.071178,4.335132,2670.2762453369355,1928.4303223062182
"244.3.165.213",14635,"244.3.160.239",80,13,2468,7,1435,6,1033,7.111751,0.16154699999999966,71062.91048425551,51155.39131026895
"244.3.165.213",4909,"244.3.160.239",80,13,3212,7,1449,6,1763,7.111826,0.16180700000000048,71640.90552324662,87165.57380088598
"244.3.165.213",14841,"244.3.160.239",80,13,2493,7,1449,6,1044,7.26109,0.1608830000000001,72052.36103255156,51913.502358857026
"244.3.165.213",6422,"244.3.160.239",80,13,2423,7,1449,6,974,7.26382,0.15832900000000016,73214.63534791471,49213.978487832246
"244.3.165.213",8887,"244.3.160.239",80,13,3257,7,1439,6,1818,7.275537,0.1470900000000004,78265.0078183423,98878.23781358326
"244.3.165.213",8014,"244.3.160.239",80,13,2148,7,1453,6,695,7.348536,0.08755299999999977,132765.29644900837,63504.391625644064
"244.3.165.213",9915,"244.3.160.239",80,13,2207,7,1447,6,760,7.350868,0.08546699999999952,135444.08953163287,71138.5681023089
"244.3.165.213",6644,"244.3.160.239",80,13,2212,7,1448,6,764,7.387259,0.1672519999999995,69260.75622414102,36543.65867074844
"244.3.165.213",14925,"244.3.160.239",80,13,2197,7,1446,6,751,7.389798,4.311193,2683.2480011913176,1393.581776552337
"244.3.165.213",10857,"244.3.160.239",80,13,2232,7,1438,6,794,7.391997,0.16303100000000015,70563.26710870932,38961.915218578026
"244.3.165.213",7975,"244.3.160.239",80,13,2510,7,1436,6,1074,7.424208,0.14547899999999991,78966.7237195747,59060.070525642914
"244.3.165.213",5106,"244.3.160.239",80,13,2782,7,1450,6,1332,7.466391,0.10398700000000005,111552.40558916013,102474.34775500778
"244.3.165.213",15985,"244.3.160.239",80,13,2779,7,1445,6,1334,7.468413,0.10268999999999995,112571.81809329054,103924.43275878864
"244.3.165.213",3788,"244.3.160.239",80,13,2786,7,1462,6,1324,7.503001,0.08026899999999948,145710.04995702047,131956.29695150143
"244.3.165.213",13152,"244.3.160.239",80,13,2461,7,1435,6,1026,7.505049,0.07858000000000054,146093.15347416545,104454.0595571385
"244.3.165.213",14573,"244.3.160.239",80,13,2661,7,1437,6,1224,7.541334,0.08728300000000022,131709.49669465955,112186.79467937599
"244.3.165.213",2574,"244.3.160.239",80,13,2472,7,1439,6,1033,7.543405,4.305441,2673.8259797312285,1919.4317144283245
"244.3.165.213",11532,"244.3.160.239",80,13,2756,7,1451,6,1305,7.573418,0.14361900000000016,80824.9604857295,72692.33179453964
"244.3.165.213",14108,"244.3.160.239",80,13,2806,7,1447,6,1359,7.573719,0.1433220000000004,80769.17709772379,75857.16079876063
"244.3.165.213",9173,"244.3.160.239",80,10,2080,5,1335,5,745,7.964244,4.314087,2475.61071438754,1381.5205859316236
"244.3.165.213",15120,"244.3.160.239",80,13,2127,7,1441,6,686,8.017888,4.311302000000001,2673.902222576845,1272.9333273335985
"244.3.165.213",13817,"244.3.160.239",80,13,2634,7,1438,6,1196,8.021624,0.13781200000000027,83476.03982236654,69427.91629175965
"244.3.165.213",5378,"244.3.160.239",80,29,11987,15,2032,14,9955,8.089954,0.2884619999999991,56354.04316686444,276084.89159750764
"244.3.165.213",14562,"244.3.160.239",80,13,2595,7,1436,6,1159,8.307021,4.3173639999999995,2660.8828905786036,2147.606734109054
"244.3.165.213",3888,"244.3.160.239",80,10,1875,5,1282,5,593,11.398705,0.0775509999999997,132248.4558548573,61172.64767701278
"244.3.165.213",5084,"244.3.160.239",80,13,2574,7,1473,6,1101,11.476588,0.3019860000000012,39021.67650155952,29166.9150225506
"244.3.165.213",5239,"244.3.160.239",80,18,6627,9,1612,9,5015,11.693026,0.29543300000000094,43651.18317858857,135800.6722336363
"244.3.165.213",6791,"244.3.160.239",80,14,4318,7,1472,7,2846,11.762468,0.2264280000000003,52007.702227639624,100552.93514936302
"244.3.165.213",9132,"244.3.160.239",80,16,6094,8,1542,8,4552,11.840636,0.2949180000000009,41828.57607877431,123478.3906034894
"244.3.165.213",3798,"244.3.160.239",80,13,3002,7,1473,6,1529,11.989231,0.2931600000000003,40196.479738026974,41724.655478237095
"244.3.165.213",14918,"244.3.160.239",80,13,2613,7,1473,6,1140,11.989236,0.29364400000000046,40130.22571549217,31058.015828690473
"244.3.165.213",10205,"244.3.160.239",80,13,2893,7,1473,6,1420,12.135961,0.32339699999999993,36438.185882985934,35127.10383831638
"244.3.165.213",7139,"244.3.160.239",80,13,2428,7,1473,6,955,12.219945,0.23977700000000013,49145.66451327689,31862.93931444632
"244.3.165.213",4891,"244.3.160.239",80,13,2408,7,1473,6,935,12.220203,0.23983600000000038,49133.57460931629,31187.978451942112
"244.3.165.213",6037,"244.3.160.239",80,13,2535,7,1473,6,1062,12.278866,0.30843299999999907,38206.02853780249,27545.69063621605
"244.3.165.213",4601,"244.3.160.239",80,13,2538,7,1473,6,1065,12.323004,0.2639440000000004,44645.83396478034,32279.574455187416
"244.3.165.213",16141,"244.3.160.239",80,13,2535,7,1473,6,1062,12.440393,0.33247599999999977,35443.15980702369,25553.724178587345
"244.3.165.213",7804,"244.3.160.239",80,13,2719,7,1473,6,1246,12.44051,0.33270100000000014,35419.19020381662,29960.835705333004
"244.3.165.213",10780,"244.3.160.239",80,13,3132,7,1473,6,1659,12.440657,0.33312600000000003,35374.00262963563,39840.7809657607
"244.3.165.213",11277,"244.3.160.239",80,21,7402,11,1752,10,5650,12.579312,0.21866100000000088,64099.222083498855,206712.6739564889
"244.3.165.213",6814,"244.3.160.239",80,21,7447,11,1752,10,5695,12.579537,0.33604500000000037,41708.69972771499,135577.08045053476
"244.3.165.213",5379,"244.3.160.239",80,13,2769,7,1473,6,1296,12.620998,0.2846189999999993,41402.71731683418,36427.645378558795
"244.3.165.213",14486,"244.3.160.239",80,21,7852,11,1752,10,6100,12.7699,0.37167800000000106,37710.060859130645,131296.4447720873
"244.3.165.213",12423,"244.3.160.239",80,27,11435,14,1962,13,9473,12.77041,0.39750699999999917,39486.097100176936,190648.21499998783
"244.3.165.213",14808,"244.3.160.239",80,32,14277,16,2102,16,12175,12.770701,0.3987759999999998,42169.03725399725,244247.397034927
"244.3.165.213",15883,"244.3.160.239",80,17,6462,9,1612,8,4850,12.795362,0.31576199999999943,40840.88649045808,122877.3569967256
"244.3.165.213",6185,"244.3.160.239",80,22,8306,11,1752,11,6554,12.88498,0.2519569999999991,55628.53979052001,208099.00102001606
"244.3.165.213",5434,"244.3.160.239",80,26,10706,13,1892,13,8814,12.91117,0.2321030000000004,65212.427241353944,303796.1594636859
"244.3.165.213",14958,"244.3.160.239",80,17,5425,9,1624,8,3801,13.110309,0.22301899999999897,58255.126244849365,136347.1273747983
"244.3.165.213",9860,"244.3.160.239",80,13,2629,7,1443,6,1186,13.136861,0.08065600000000117,143126.36381670096,117635.38980360869
"244.3.165.213",3966,"244.3.160.239",80,13,2233,7,1441,6,792,13.138579,0.07987699999999975,144321.89491342983,79321.95750967137
"244.3.165.213",10081,"244.3.160.239",80,13,2133,7,1440,6,693,13.144117,0.07149099999999997,161139.16437034038,77548.22285322631
"244.3.165.213",9940,"244.3.160.239",80,13,2633,7,1444,6,1189,13.1443,0.07405800000000085,155985.84892921586,128439.87145210365
"244.3.165.213",15954,"244.3.160.239",80,13,2262,7,1442,6,820,13.169892,0.08854099999999931,130289.9221829445,74089.96961859535
"244.3.165.213",11944,"244.3.160.239",80,13,2214,7,1442,6,772,13.214283,0.11210999999999949,102898.93854250337,55088.75211845534
"244.3.165.213",13773,"244.3.160.239",80,13,2199,7,1444,6,755,13.21477,0.11189200000000099,103242.41232617076,53980.6241733095
"244.3.165.213",2368,"244.3.160.239",80,13,2257,7,1441,6,816,13.214803,0.11216600000000021,102776.24235508067,58199.45438011508
"244.3.165.213",15041,"244.3.160.239",80,13,2252,7,1441,6,811,13.214851,0.11262800000000084,102354.65426004115,57605.568775082145
"244.3.165.213",10730,"244.3.160.239",80,13,3484,7,1473,6,2011,13.245578,0.2281259999999996,51655.6639751717,70522.43058660577
"244.3.165.213",12225,"244.3.160.239",80,13,3483,7,1473,6,2010,13.320132,0.3017150000000015,39056.72571797869,53295.32837280188
"244.3.165.213",4048,"244.3.160.239",80,13,2997,7,1473,6,1524,13.320178,0.30216399999999943,38998.68945340948,40348.949577050946
"244.3.165.213",4512,"244.3.160.239",80,13,2256,7,1440,6,816,13.320242,0.14712499999999906,78300.76465590534,44370.43330501303
"244.3.165.213",10756,"244.3.160.239",80,9,1860,5,1327,4,533,13.320461,4.524979,2346.0882359896036,942.3248152090871
"244.3.165.213",4427,"244.3.160.239",80,15,3659,8,1543,7,2116,13.333739,0.3550430000000002,34767.6196967691,47678.731871914075
"244.3.165.213",5219,"244.3.160.239",80,14,4179,7,1473,7,2706,13.393881,0.39571299999999887,29779.158127228657,54706.314930265275
"244.3.165.213",7559,"244.3.160.239",80,12,3294,6,1403,6,1891,13.469711,0.32029200000000024,35043.02324129229,47231.90089043744
"244.3.165.213",7092,"244.3.160.239",80,13,2873,7,1473,6,1400,13.61732,0.44319100000000056,26588.987592257028,25271.27130289195
"244.3.165.213",8904,"244.3.160.239",80,9,1861,5,1327,4,534,13.617466,4.574794000000001,2320.5416462468033,933.812538881532
"244.3.165.213",9005,"244.3.160.239",80,14,4158,7,1473,7,2685,13.678694,0.3837860000000006,30704.611424074825,55968.69088502438
"244.3.165.213",6642,"244.3.160.239",80,14,3870,7,1473,7,2397,13.790221,0.2727909999999998,43197.906089277174,70295.57426747956
"244.3.165.213",3334,"244.3.160.239",80,14,4252,7,1473,7,2779,13.790445,0.27240399999999987,43259.2766626041,81614.07321478396
"244.3.165.213",14090,"244.3.160.239",80,14,4720,7,1473,7,3247,13.999787,0.24089000000000027,48918.59354892269,107833.45095271688
"244.3.165.213",12013,"244.3.160.239",80,15,4530,8,1543,7,2987,14.063294,0.2948759999999986,41861.66388583696,81037.45303110499
"244.3.165.213",12395,"244.3.160.239",80,14,4552,7,1473,7,3079,14.063535,0.29502699999999926,39942.1069935973,83490.66356638566
"244.3.165.213",10343,"244.3.160.239",80,13,3166,7,1473,6,1693,14.063639,0.2949280000000005,39955.51456626695,45923.07274995923
"244.3.165.213",14968,"244.3.160.239",80,13,2841,7,1473,6,1368,14.241162,0.2712770000000013,43438.99409091056,40342.52811701673
"244.3.165.213",4492,"244.3.160.239",80,15,4180,8,1502,7,2678,14.358888,0.08120199999999933,147976.65082140957,263835.8661116743
"244.3.165.213",2179,"244.3.160.239",80,9,1804,5,1301,4,503,18.259584,0.07290000000000063,142770.91906721413,55198.90260630954
"244.3.165.213",14185,"244.3.160.239",80,10,2853,5,1725,5,1128,18.287623,0.009747000000000838,1415820.2523852275,925823.3302553836
"244.3.165.213",7240,"244.3.160.239",80,25,13674,14,8846,11,4828,18.299523,0.15503400000000056,456467.6135557345,249132.44836616394
"244.3.165.213",8948,"244.3.160.239",80,18,9534,10,8544,8,990,18.459438,0.11088900000000024,616400.1839677502,71422.77412547667
"244.3.165.213",14314,"244.3.160.239",80,10,2461,5,1626,5,835,18.572287,0.0779980000000009,166773.50701299842,85643.22162106622
"244.3.165.213",15349,"244.3.160.239",80,20,10768,11,8547,9,2221,18.652218,0.13369399999999843,511436.5640941314,132900.50413631284
"244.3.165.213",10151,"244.3.160.239",80,20,11647,11,9703,9,1944,18.788,0.16677299999999917,465447.0447854292,93252.50490187306
"244.3.165.213",2753,"244.3.160.239",80,12,3416,6,2608,6,808,18.956445,0.13377800000000306,155959.87382080403,48318.856613193886
"244.3.165.213",7600,"244.3.160.239",80,669,432967,274,20795,395,412172,19.092503,3.2939869999999978,50504.145887643186,1001028.8443761321
"244.3.165.213",2127,"244.3.160.239",80,13,2574,7,1473,6,1101,20.742769,0.115591000000002,101945.653208293,76199.7041292129
"244.3.165.213",9780,"244.3.160.239",80,19,6697,10,1682,9,5015,20.746463,0.11405400000000299,117979.20283374233,351763.19988776324
"244.3.165.213",14947,"244.3.160.239",80,15,4388,8,1542,7,2846,20.757819,0.10270299999999821,120113.33651402796,221687.77932485318
"244.3.165.213",4932,"244.3.160.239",80,17,6164,9,1612,8,4552,20.760667,0.10346899999999692,124636.3645149792,351950.8258512316
"244.3.165.213",6251,"244.3.160.239",80,13,3002,7,1473,6,1529,20.763246,0.1212370000000007,97198.05010021637,100893.29165188786
"244.3.165.213",8290,"244.3.160.239",80,29,11987,15,2032,14,9955,20.767073,0.16976700000000022,95754.76977268832,469113.54974759463
"244.3.165.213",9380,"244.3.160.239",80,13,3484,7,1473,6,2011,20.84704,0.10751499999999936,109603.31116588449,149634.93466028085
"244.3.165.213",9672,"244.3.160.239",80,13,3483,7,1473,6,2010,20.860436,0.12831800000000015,91834.34903910586,125313.67384154975
"244.3.165.213",15701,"244.3.160.239",80,13,2997,7,1473,6,1524,20.860772,0.12833499999999987,91822.18412747896,95001.3636186544
"244.3.165.213",7114,"244.3.160.239",80,13,2764,7,1473,6,1291,20.864219,0.12510300000000285,94194.38382772381,82555.97387752304
"244.3.165.213",13079,"244.3.160.239",80,15,3659,8,1543,7,2116,20.879315,0.12778800000000246,96597.48959213513,132469.40244780164
"244.3.165.213",13872,"244.3.160.239",80,13,2613,7,1473,6,1140,20.934378,4.473889,2633.950015299888,2038.4949201913594
"244.3.165.213",6215,"244.3.160.239",80,13,2893,7,1473,6,1420,20.949863,0.11807699999999954,99799.28351838246,96208.40637888873
"244.3.165.213",12233,"244.3.160.239",80,13,2428,7,1473,6,955,20.98236,0.11191600000000079,105293.25565602699,68265.48482790616
"244.3.165.213",11351,"244.3.160.239",80,13,2408,7,1473,6,935,20.982365,0.1377069999999989,85572.99193214647,54318.226379196836
"244.3.165.213",3143,"244.3.160.239",80,12,2465,6,1403,6,1062,20.982369,0.1138670000000026,98571.14001422487,74613.36471497278
"244.3.165.213",7861,"244.3.160.239",80,13,2538,7,1473,6,1065,20.990943,0.12005499999999714,98155.0122860379,70967.4732414327
"244.3.165.213",7680,"244.3.160.239",80,15,4790,8,1543,7,3247,21.058813,0.11465899999999962,107658.36087878005,226550.03096137315
"244.3.165.213",15247,"244.3.160.239",80,13,2535,7,1473,6,1062,21.086498,0.20364100000000107,57866.53964574883,41720.478685529706
"244.3.165.213",16134,"244.3.160.239",80,13,2719,7,1473,6,1246,21.096635,0.1935120000000019,60895.448344288125,51511.01740460489
"244.3.165.213",12953,"244.3.160.239",80,12,3062,6,1403,6,1659,21.09669,0.19384600000000063,57901.6332552643,68466.72100533391
"244.3.165.213",12223,"244.3.160.239",80,18,7192,9,1612,9,5580,21.099467,0.19108899999999807,67486.87784226266,233608.42330013998
"244.3.165.213",5726,"244.3.160.239",80,21,7447,11,1752,10,5695,21.173382,0.24504500000000107,57197.65757309857,185925.03417739517
"244.3.165.213",14604,"244.3.160.239",80,13,2769,7,1473,6,1296,21.290825,0.15112199999999731,77976.73402946103,68606.82097907773
"244.3.165.213",13799,"244.3.160.239",80,21,7852,11,1752,10,6100,21.290914,0.16038199999999847,87391.35314436865,304273.546906763
"244.3.165.213",11241,"244.3.160.239",80,22,11085,11,1752,11,9333,21.291048,4.399289,3185.9693691412413,16971.833403079454
"244.3.165.213",10844,"244.3.160.239",80,33,14347,17,2172,16,12175,21.291053,0.2871839999999999,60504.76349657365,339155.3847010977
"244.3.165.213",4014,"244.3.160.239",80,16,6392,8,1542,8,4850,21.312838,0.13073100000000082,94361.70456892338,296792.6505572493
"244.3.165.213",4323,"244.3.160.239",80,18,8026,9,1612,9,6414,21.419583,0.16122500000000173,79987.59497596441,318263.2966351338
"244.3.165.213",15074,"244.3.160.239",80,27,10776,14,1962,13,8814,21.44371,0.2645879999999998,59322.418250260824,266497.34681844997
"244.3.165.213",4343,"244.3.160.239",80,14,4179,7,1473,7,2706,21.445132,0.1356800000000007,86851.41509433919,159551.88679245202
"244.3.165.213",9898,"244.3.160.239",80,12,3294,6,1403,6,1891,21.475484,0.10506299999999769,106831.1394115935,143989.7965982347
"244.3.165.213",9675,"244.3.160.239",80,13,2873,7,1473,6,1400,21.564459,0.14585300000000245,80793.67582428748,76789.64436795823
"244.3.165.213",5200,"244.3.160.239",80,15,4962,8,1543,7,3419,21.581042,0.12883599999999973,95811.72964078383,212300.90968362926
"244.3.165.213",9634,"244.3.160.239",80,14,4158,7,1473,7,2685,21.581231,0.12879600000000124,91493.5246436216,166775.36569458517
"244.3.165.213",3647,"244.3.160.239",80,14,3870,7,1473,7,2397,21.581326,0.1289820000000006,91361.58533748853,148671.90770805159
"244.3.165.213",3492,"244.3.160.239",80,15,4322,8,1543,7,2779,21.710247,0.10920600000000036,113034.08237642584,203578.55795469048
"244.3.165.213",13625,"244.3.160.239",80,14,4460,7,1473,7,2987,21.710572,0.10908000000000229,108030.80308030576,219068.57352401447
"244.3.165.213",15928,"244.3.160.239",80,14,4552,7,1473,7,3079,21.710721,0.10912400000000133,107987.24386935831,225724.8634580816
"244.3.165.213",5109,"244.3.160.239",80,12,3096,6,1403,6,1693,21.710725,0.10922199999999904,102763.17957920655,124004.32147369687
"244.3.165.213",10480,"244.3.160.239",80,13,2841,7,1473,6,1368,21.820007,0.21826400000000135,53989.66389326654,50141.113513909455
"244.3.165.213",11333,"244.3.160.239",80,17,5413,9,1612,8,3801,22.258334,0.2014099999999992,64028.598381411306,150975.6218658464
"244.3.165.213",13791,"244.3.160.239",80,14,7904,6,1569,8,6335,22.610161,0.2887299999999975,43473.14099677937,175527.30925085873
"244.3.165.213",9281,"244.3.160.239",80,1851,1439032,593,42665,1258,1396367,22.925206,2.043175999999999,167053.64589247337,5467436.9706770275
"244.3.176.18",3072,"15.123.218.235",53,1,64,0,0,1,64,123.540137,0,0,0
"244.3.176.118",3389,"244.3.153.55",2637,121,25727,48,15945,73,9782,0.097923,186.920818,682.4280000743416,418.6585573362941
"244.3.176.118",3389,"244.3.153.239",2091,2,172,1,108,1,64,11.60623,0.2568509999999993,3363.8179333543667,1993.373590135921
"244.3.177.142",3640,"41.177.98.176",80,36,24130,14,2980,22,21150,30.108952,25.209156000000004,945.6881460053639,6711.847076514579
"244.3.177.186",2077,"244.3.41.84",23,3,192,2,128,1,64,197.97821,0.021658000000002176,47280.45064179043,23640.225320895213
"244.3.177.193",2206,"41.177.98.176",80,133,104959,51,8921,82,96038,89.794909,51.87716099999999,1375.7113655467772,14810.062562984127
"244.3.177.210",12906,"244.3.160.239",80,16,6418,7,1507,9,4911,181.557842,0.05537100000000805,217731.30338982947,709541.095519212
"244.3.177.210",7072,"244.3.160.239",80,12,4094,5,1362,7,2732,181.629102,0.2787930000000074,39082.76032755381,78395.08165556316
"244.3.177.210",5055,"244.3.160.239",80,11,3308,5,1471,6,1837,181.92809,0.2727690000000109,43142.73249525983,53877.09013853998
"244.3.177.210",13576,"244.3.160.239",80,10,2703,5,1547,5,1156,182.210201,0.010150999999979149,1219190.227566291,911043.2469726132
"244.3.177.210",12230,"244.3.160.239",80,58,38963,21,2512,37,36451,182.220737,0.23370599999998376,85988.37856110411,1247755.7272813718
"244.3.177.210",11905,"244.3.160.239",80,10,1877,5,1317,5,560,182.440666,0.009108999999995149,1156658.2500829522,491821.2756616957
"244.3.177.210",6967,"244.3.160.239",80,10,1890,5,1330,5,560,182.441025,0.018872000000015987,563798.2195840921,237388.7240354072
"244.3.177.210",10557,"244.3.160.239",80,10,1879,5,1319,5,560,182.44142,0.013043000000010352,809016.3305981465,343479.26090596063
"244.3.177.210",13716,"244.3.160.239",80,10,1877,5,1317,5,560,182.441778,0.01631100000000174,645944.4546624288,274661.27153451793
"244.3.185.67",2753,"41.177.98.176",80,120,97727,44,6177,76,91550,94.29897,33.105168000000006,1492.6974543672454,22123.434020935943
"244.3.185.67",2754,"41.177.98.176",80,18,5852,9,4054,9,1798,95.44325,18.194243999999998,1782.5417752999247,790.5797020200456
"244.3.185.68",5402,"244.3.160.239",80,10,2383,5,1511,5,872,0.182015,0.01578299999999999,765887.3471456635,441994.55109928426
"244.3.185.68",8865,"244.3.160.239",80,10,2427,5,1509,5,918,0.457324,0.010185,1185272.4594992637,721060.3829160531
"244.3.185.68",8732,"244.3.160.239",80,10,2473,5,1545,5,928,0.46789,0.23836400000000008,51853.46780554109,31145.642798409146
"244.3.185.68",9419,"244.3.160.239",80,12,2475,6,1861,6,614,0.706639,0.20002299999999995,74431.44038435581,24557.175924768657
"244.3.185.68",16261,"244.3.160.239",80,9,2828,5,1531,4,1297,0.907065,0.24625399999999997,49737.26315105542,42135.35617695551
"244.3.185.72",1122,"244.3.41.84",23,3,192,1,64,2,128,139.531565,0.29013499999999226,1764.695745084232,3529.391490168464
"244.3.185.75",2816,"41.177.98.176",80,289,246966,107,17080,182,229886,56.02343,29.679620000000007,4603.832528853131,61964.67474987886
"244.3.185.75",2818,"41.177.98.176",80,97,70193,44,13648,53,56545,60.872584,24.830608999999995,4397.1535293395345,18217.837508536344
"244.3.185.75",2844,"41.177.98.176",80,58,37122,25,10797,33,26325,182.220681,18.326418999999987,4713.195742168727,11491.606734518084
"244.3.185.75",2845,"41.177.98.176",80,41,19891,20,12748,21,7143,185.128344,15.938859000000008,6398.450478795248,3585.200170225483
"244.3.185.150",2150,"41.177.98.176",80,104,84298,40,11645,64,72653,79.709648,28.783293,3236.599787244635,20193.10299207252
"244.3.185.150",2152,"41.177.98.176",80,173,153227,57,13577,116,139650,81.755808,31.737048,3422.372490346298,35201.7616761332
"244.3.186.223",2593,"244.3.41.84",23,46,12050,20,1415,26,10635,23.176541,80.021706,141.46161792651608,1063.2115241332147
"244.3.188.64",1261,"244.3.41.84",23,7,1433,3,194,4,1239,139.540252,2.0958809999999914,740.5000570165989,4729.276137337969
"244.3.188.176",1189,"244.3.41.84",23,4,256,2,128,2,128,18.486542,0.3312980000000003,3090.872869742646,3090.872869742646
"244.3.188.192",2501,"244.3.41.84",23,4,256,2,128,2,128,139.537751,0.280838000000017,3646.2302110111095,3646.2302110111095
"244.3.194.118",1394,"244.3.41.84",23,4,256,2,128,2,128,139.541942,0.20991799999998761,4878.095256243202,4878.095256243202
"244.3.197.47",53945,"253.37.253.43",623,1,127,0,0,1,127,70.84442,0,0,0
"244.3.199.218",2254,"41.177.98.176",80,4,256,2,128,2,128,13.30342,2.8975560000000016,353.40128025135647,353.40128025135647
"244.3.199.218",2256,"41.177.98.176",80,139,116995,49,5153,90,111842,16.20155,33.80784799999999,1219.3618475804792,26465.334321190752
"244.3.199.218",2265,"41.177.98.176",80,34,24234,13,1841,21,22393,187.060531,15.266493999999994,964.727068310511,11734.455861313021
"244.3.210.98",2674,"68.83.160.23",1984,6,390,3,198,3,192,21.075834,0.9855270000000012,1607.2619015004136,1558.5569953943404
"244.3.210.98",2675,"68.83.160.23",1984,6,390,3,198,3,192,31.557946,0.8992689999999968,1761.430673135631,1708.0539860709148
"244.3.210.98",2678,"85.210.77.218",80,21,8112,13,909,8,7203,32.484569,177.823578,40.894464512461894,324.05151582317166
"244.3.210.98",2679,"197.203.154.194",80,17,1529,12,860,5,669,32.686285,174.547752,39.41614785162057,30.662096410156
"244.3.210.98",2680,"122.136.142.255",80,56,48189,22,1496,34,46693,32.757599,0.15049100000000237,79526.35041298026,2482168.368872518
"244.3.210.98",2681,"77.197.64.193",80,10,1570,6,474,4,1096,32.892456,100.26368,37.82027549756801,87.44941338678174
"244.3.210.98",2682,"77.197.64.193",80,28,16572,13,963,15,15609,33.060663,101.43943999999999,75.94679150436951,1231.0004865957462
"244.3.210.98",2683,"68.83.160.23",1984,6,390,3,198,3,192,44.388042,0.9712189999999978,1630.9400866333995,1581.5176597657207
"244.3.210.98",2684,"68.83.160.23",1984,6,390,3,198,3,192,47.848775,0.9157689999999974,1729.693842006013,1677.27887709674
"244.3.210.98",2685,"68.83.160.23",1984,6,390,3,198,3,192,53.919407,0.9550249999999991,1658.5953247297207,1608.3348603439715
"244.3.210.98",2693,"68.83.160.23",1984,6,390,3,198,3,192,89.745505,1.0033460000000076,1578.7176108740036,1530.877683271761
"244.3.210.98",2695,"68.83.160.23",1984,6,390,3,198,3,192,110.656366,1.0961669999999941,1445.0352911554612,1401.2463429386291
"244.3.210.98",2700,"68.83.160.23",1984,6,390,3,198,3,192,130.761878,1.0183529999999905,1555.452775216467,1508.3178426341497
"244.3.210.197",3534,"68.83.160.23",1984,2,142,1,78,1,64,69.045826,0.005074999999990837,122955.66502485254,100886.69950757132
"244.3.210.230",3188,"253.23.23.108",445,3,198,3,198,0,0,0.283023,9.138301,173.3363783924386,0
"244.3.210.230",3190,"253.23.23.108",139,3,198,3,198,0,0,0.283222,9.037525,175.2692247047726,0
"244.3.210.230",3191,"68.83.160.23",1984,6,390,3,198,3,192,29.395938,1.0558189999999996,1500.2571463480015,1454.7948085798803
"244.3.210.230",3193,"253.23.23.108",1433,3,198,3,198,0,0,61.492239,9.085329000000002,174.34701594185523,0
"244.3.210.230",3200,"253.23.23.108",445,3,198,3,198,0,0,82.748864,9.052358999999996,174.98201297584427,0
"244.3.210.230",3202,"253.23.23.108",139,3,198,3,198,0,0,82.749065,8.951594999999998,176.95170525476192,0
"244.3.210.230",3206,"253.23.23.108",1433,3,198,3,198,0,0,103.972467,9.15395500000001,173.03995923073668,0
"244.3.210.230",3212,"68.83.160.23",1984,6,390,3,198,3,192,116.765876,0.8893179999999887,1781.140154590394,1727.1662105118974
"244.3.210.230",3213,"253.23.23.108",445,3,198,3,198,0,0,125.095579,9.05240400000001,174.98114313059804,0
"244.3.210.230",3215,"253.23.23.108",139,3,198,3,198,0,0,125.095787,9.152716999999996,173.06336468176616,0
"244.3.210.230",3216,"68.83.160.23",1984,6,390,3,198,3,192,128.144142,1.1802640000000224,1342.0726210406908,1301.4037537364275
"244.3.210.230",3217,"253.23.23.108",1433,3,198,3,198,0,0,146.323186,9.048381000000006,175.05894148356472,0
"244.3.210.230",3219,"253.23.23.108",445,3,198,3,198,0,0,167.442394,8.951619999999991,176.95121106570673,0
"244.3.210.230",3221,"253.23.23.108",139,3,198,3,198,0,0,167.442617,9.152564999999981,173.06623880846553,0
"244.3.210.230",3222,"68.83.160.23",1984,6,390,3,198,3,192,168.126017,1.1294910000000016,1402.4016127618527,1359.9045941933118
"244.3.210.230",3223,"68.83.160.23",1984,6,390,3,198,3,192,169.637583,1.0270669999999882,1542.255763255969,1495.5207401270002
"244.3.210.230",3224,"253.23.23.108",1433,3,198,3,198,0,0,188.773215,9.045620000000014,175.11237482892247,0
"244.3.210.230",3229,"68.83.160.23",1984,6,390,3,198,3,192,193.051814,0.9532419999999888,1661.6976591463851,1611.343184626798
"244.3.210.230",3230,"253.23.23.108",445,2,132,2,132,0,0,209.889533,3.017216999999988,349.99139935907965,0
"244.3.210.230",3232,"253.23.23.108",139,2,132,2,132,0,0,209.889728,3.01701300000002,350.0150645688278,0
"244.3.210.254",19813,"41.177.244.77",2904,29,5476,14,3984,15,1492,2.881044,10.199268,3124.930142045488,1170.2800632359106
"244.3.210.254",19813,"41.177.244.128",2743,12,804,6,402,6,402,5.255709,200.554588,16.035534425171065,16.035534425171065
"244.3.210.254",19813,"41.177.244.220",2860,13,902,6,424,7,478,6.066628,199.43278899999999,17.008236293581596,19.174379595122648
"244.3.210.254",52502,"41.177.244.142",548,48,3844,19,1602,29,2242,14.308638,196.295884,65.28919373571786,91.37226738793973
"244.3.210.254",19813,"41.177.244.38",2157,10,670,5,332,5,338,17.178728,160.243521,16.574773091762008,16.874317183781802
"244.3.210.254",19813,"41.177.244.142",4944,13,902,6,424,7,478,25.459747,175.363424,19.342688016858062,21.806143566174892
"244.3.210.254",19813,"244.3.106.254",4227,10,670,5,332,5,338,26.884611,160.53797,16.544372649037484,16.84336733546587
"244.3.210.254",19813,"244.3.3.185",1742,10,670,5,332,5,338,28.470373,160.352256,16.563533724152904,16.86287469507133
"244.3.210.254",19813,"41.177.244.141",4752,13,902,6,424,7,478,29.077571,180.345984,18.80829239868186,21.203688128702662
"244.3.210.254",19813,"41.177.244.90",3965,10,670,5,332,5,338,29.195702,160.426987,16.55581800585708,16.855019536083415
"244.3.210.254",19813,"244.3.77.218",1214,10,670,5,338,5,332,31.559759,160.509071,16.846399914681456,16.54735139548593
"244.3.210.255",2557,"68.83.160.23",1984,6,390,3,198,3,192,25.751568,0.8932900000000004,1773.2203427778206,1719.4863929966746
"244.3.210.255",1152,"242.194.160.18",80,12,6291,6,558,6,5733,40.237076,120.05447799999999,37.18311948347316,382.02656630600654
"244.3.210.255",2558,"68.83.39.67",110,3,198,3,198,0,0,53.515116,9.001162999999998,175.97725982742455,0
"244.3.210.255",2559,"68.83.39.67",110,3,198,3,198,0,0,58.501964,9.045614,175.11249098181725,0
"244.3.210.255",2561,"68.83.39.67",110,3,198,3,198,0,0,78.501961,8.951619000000008,176.9512308332156,0
"244.3.210.255",2564,"68.83.160.23",1984,6,390,3,198,3,192,124.17439,1.019356000000002,1553.922280341703,1506.8337263919543
"244.3.210.255",2568,"68.83.160.23",1984,6,390,3,198,3,192,181.424308,1.0788390000000163,1468.245030073974,1423.7527564353688
"244.3.210.255",2572,"48.151.229.15",25,31,5269,13,3801,18,1468,188.200923,0.6841500000000167,44446.39333479392,17165.826207702572
"244.3.210.255",2573,"41.177.244.254",25,26,5388,11,4019,15,1369,188.200999,0.3389940000000138,94845.33649562733,32307.35647238463
"244.3.210.255",2574,"48.151.229.15",25,26,4946,12,3734,14,1212,188.271626,0.6299649999999986,47418.50737739409,15391.331264435361
"244.3.210.255",2582,"68.83.160.23",1984,6,390,3,198,3,192,205.715935,1.0683119999999917,1482.7129153281178,1437.7822209242356
"244.3.213.210",10983,"244.3.160.239",80,123,88853,40,3664,83,85189,2.877347,0.6954530000000001,42148.06751858141,979954.0731005544
"244.3.213.210",6978,"244.3.160.239",80,12,3134,6,1816,6,1318,3.352081,0.2770999999999999,52428.72609166368,38051.24503789247
"244.3.213.210",7657,"244.3.160.239",80,15,6122,7,1620,8,4502,3.5690020000000002,0.18982999999999972,68271.61144181647,189727.65105620847
"244.3.213.210",2232,"244.3.160.239",80,14,4445,7,2512,7,1933,3.636186,0.23325899999999988,86153.1602210419,66295.40553633518
"244.3.213.210",10081,"244.3.160.239",80,12,2563,6,1574,6,989,3.918674,0.1707149999999995,73760.36083531052,46346.249597282156
"244.3.213.210",13719,"244.3.160.239",80,10,2417,5,1586,5,831,5.054221,0.06015899999999963,210907.7610997536,110507.15603650395
"244.3.213.210",9325,"244.3.160.239",80,10,2551,5,1668,5,883,5.12346,0.34005300000000016,39240.94185318169,20773.232407889347
"244.3.213.210",11794,"244.3.160.239",80,289,217267,89,7066,200,210201,5.473969,3.105072,18205.052894103585,541568.1182272102
"244.3.213.210",15655,"244.3.160.239",80,14,3399,7,1998,7,1401,5.494947,0.24399999999999977,65508.196721311535,45934.42622950824
"244.3.213.210",12438,"244.3.160.239",80,18,11047,7,1689,11,9358,7.984341,0.31381199999999954,43057.62685939359,238563.2161931351
"244.3.213.210",5984,"244.3.160.239",80,26,18100,10,1874,16,16226,8.230229,0.36328100000000063,41268.32947497935,357321.19213501335
"244.3.213.210",10154,"244.3.160.239",80,13,4145,6,1621,7,2524,8.563111,0.18553500000000156,69895.16802759528,108831.21782951913
"244.3.213.210",15358,"244.3.160.239",80,12,2338,6,1638,6,700,8.748641,0.1828479999999999,71666.08330416525,30626.531326566346
"244.3.213.210",12473,"244.3.160.239",80,12,3105,6,1639,6,1466,8.748912,0.18258200000000002,71814.30809170673,64234.15232607814
"244.3.213.210",4812,"244.3.160.239",80,21,14103,8,1782,13,12321,8.750639,0.3232420000000005,44103.179661058835,304935.6209898462
"244.3.213.210",12927,"244.3.160.239",80,12,2362,6,1654,6,708,8.754043,0.17745500000000014,74565.38277309734,31917.951029838525
"244.3.213.210",13867,"244.3.160.239",80,12,2380,6,1647,6,733,8.754612999999999,0.17779700000000176,74106.98718201021,32981.43388246113
"244.3.213.210",3671,"244.3.160.239",80,12,2870,6,1648,6,1222,8.759483,0.18226100000000045,72335.82609554412,53637.366194632836
"244.3.213.210",5695,"244.3.160.239",80,14,5690,6,1413,8,4277,8.867395,0.17665299999999995,63989.855819035074,193690.45529937226
"244.3.213.210",15830,"244.3.160.239",80,18,8469,8,1544,10,6925,8.87565,0.3360479999999999,36756.653811360295,164857.4013236205
"244.3.213.210",14746,"244.3.160.239",80,17,8747,7,1472,10,7275,8.879565,0.2759400000000003,42675.94404580702,210915.41639486823
"244.3.213.210",14534,"244.3.160.239",80,14,5189,6,1421,8,3768,8.881301,0.26646199999999887,42662.74365575598,113126.8248380637
"244.3.213.210",5887,"244.3.160.239",80,15,7388,6,1420,9,5968,8.887297,0.33380099999999935,34032.25274939267,143031.32704815172
"244.3.213.210",10994,"244.3.160.239",80,14,6217,6,1703,8,4514,8.89601,0.17424600000000012,78188.30848340846,207247.22518737862
"244.3.213.210",13558,"244.3.160.239",80,13,4434,6,1413,7,3021,8.899203,0.18118199999999973,62390.30367255035,133390.73417889213
"244.3.213.210",11953,"244.3.160.239",80,16,6905,7,1488,9,5417,8.908137,0.24922699999999942,47763.68531499407,173881.64203717935
"244.3.213.210",13581,"244.3.160.239",80,16,8693,6,1407,10,7286,8.917419,0.27748999999999846,40563.623914375516,210054.41637536604
"244.3.213.210",4515,"244.3.160.239",80,16,6385,7,1475,9,4910,8.923132,0.3010699999999993,39193.54302986026,130467.99747567042
"244.3.213.210",11061,"244.3.160.239",80,12,3367,6,1664,6,1703,8.924097,0.18217199999999956,73073.79838833648,74786.46553806312
"244.3.213.210",14872,"244.3.160.239",80,12,2385,6,1649,6,736,8.926767,0.21023899999999962,62747.63483464069,28006.221490779593
"244.3.213.210",3921,"244.3.160.239",80,12,2388,6,1649,6,739,8.927667,0.20984100000000083,62866.646651512085,28173.71247754241
"244.3.213.210",2283,"244.3.160.239",80,12,2408,6,1642,6,766,8.928257,0.2100200000000001,62546.424150080915,29178.173507285006
"244.3.213.210",8482,"244.3.160.239",80,12,2381,6,1642,6,739,8.929459,0.20910100000000043,62821.31601474873,28273.418108952075
"244.3.213.210",13235,"244.3.160.239",80,13,5604,5,1354,8,4250,8.930283,0.2648229999999998,40902.79167594963,128387.64004637068
"244.3.213.210",11460,"244.3.160.239",80,11,2285,5,1575,6,710,8.932927,0.21463100000000068,58705.40602242901,26464.024302174344
"244.3.213.210",13201,"244.3.160.239",80,12,2380,6,1642,6,738,9.10457,0.23542099999999877,55797.91097650621,25078.4764315844
"244.3.213.210",5692,"244.3.160.239",80,12,2343,6,1641,6,702,9.107903,0.23239399999999932,56490.2708331542,24165.85626134933
"244.3.213.210",12535,"244.3.160.239",80,14,6366,6,1672,8,4694,9.108227,0.23232800000000076,57573.77500774748,161633.55256361642
"244.3.213.210",2826,"244.3.160.239",80,14,5533,6,1672,8,3861,9.109605,0.2316869999999991,57733.06227798734,133317.7951287734
"244.3.213.210",9271,"244.3.160.239",80,28,21769,10,1928,18,19841,9.110434,0.4868769999999998,31679.459083094924,326012.52472390374
"244.3.213.210",5448,"244.3.160.239",80,17,8718,7,1715,10,7003,9.149229,0.25144199999999906,54565.26753684767,222810.82714900537
"244.3.213.210",12662,"244.3.160.239",80,12,3480,6,1664,6,1816,9.333239,0.18384099999999926,72410.39811576337,79024.80948210714
"244.3.213.210",13066,"244.3.160.239",80,12,2439,6,1654,6,785,9.333996,0.18308699999999867,72271.65227460222,34300.63303238376
"244.3.213.210",7339,"244.3.160.239",80,12,3406,6,1660,6,1746,9.334416,0.18267100000000092,72699.00531556697,76465.33932589152
"244.3.213.210",9147,"244.3.160.239",80,13,4244,6,1663,7,2581,9.334948,0.18212699999999948,73047.92809413232,113371.43861151866
"244.3.213.210",14954,"244.3.160.239",80,13,3887,6,1662,7,2225,9.394497,0.21347300000000047,62284.22329755974,83382.9102509449
"244.3.213.210",5023,"244.3.160.239",80,12,3103,6,1664,6,1439,9.509973,0.1822979999999994,73023.29153364296,63149.34886833667
"244.3.213.210",12038,"244.3.160.239",80,12,3045,6,1663,6,1382,9.510308,0.1844859999999997,72113.87313942533,59928.66667389405
"244.3.213.210",6055,"244.3.160.239",80,12,3490,6,1666,6,1824,9.510873,0.1839259999999996,72463.9257092528,79336.2547981255
"244.3.213.210",8405,"244.3.160.239",80,12,3137,6,1667,6,1470,9.511215,0.1835880000000003,72640.91334945627,64056.47427936456
"244.3.213.210",8402,"244.3.160.239",80,12,3188,6,1661,6,1527,9.55964,0.22158199999999972,59968.77002644627,55130.831926781124
"244.3.213.210",12399,"244.3.160.239",80,13,3976,6,1664,7,2312,9.599445,0.18214800000000153,73083.42666403083,101543.79954761977
"244.3.213.210",6469,"244.3.160.239",80,12,2842,6,1663,6,1179,9.692957,0.23664600000000036,56218.99377128699,39857.00159732252
"244.3.213.210",9110,"244.3.160.239",80,17,9062,7,1716,10,7346,9.693663,0.241301,56891.60011769533,243546.44199568176
"244.3.213.210",11782,"244.3.160.239",80,28,19956,11,1979,17,17977,9.694134,0.37400700000000064,42330.75851521488,384527.56231835164
"244.3.213.210",11083,"244.3.160.239",80,12,2423,6,1648,6,775,9.694555,0.235398,56007.27278906363,26338.371608934656
"244.3.213.210",8238,"244.3.160.239",80,12,2408,6,1648,6,760,9.775442,0.17312899999999942,76151.30913942808,35118.32217594984
"244.3.213.210",14583,"244.3.160.239",80,12,2389,6,1645,6,744,9.776091,0.172485,76296.48954981593,34507.348465083924
"244.3.213.210",9797,"244.3.160.239",80,12,2387,6,1645,6,742,9.922769,0.18765199999999993,70129.81476349842,31633.022829492904
"244.3.213.210",7482,"244.3.160.239",80,12,2428,6,1646,6,782,9.923946,0.18647999999999954,70613.4706134708,33547.83354783363
"244.3.213.210",2685,"244.3.160.239",80,10,2118,5,1519,5,599,10.107916,0.17412200000000055,69790.14713821321,27520.933598281576
"244.3.213.210",14622,"244.3.160.239",80,13,5551,6,1708,7,3843,12.904854,0.30014899999999933,45524.056385328724,102429.12686698962
"244.3.213.210",5662,"244.3.160.239",80,39,23818,14,2222,25,21596,13.228477,0.43266700000000036,41084.71411038971,399309.39960755006
"244.3.213.210",2062,"244.3.160.239",80,46,28830,16,2426,30,26404,13.22925,0.468043999999999,41466.18693968952,451307.9966840734
"244.3.213.210",14037,"244.3.160.239",80,12,3449,6,1758,6,1691,13.550152,0.22154799999999852,63480.60014082769,61061.259862422994
"244.3.213.210",13923,"244.3.160.239",80,12,2509,6,1768,6,741,13.552954,0.21921999999999997,64519.66061490741,27041.32834595384
"244.3.213.210",2716,"244.3.160.239",80,12,2470,6,1761,6,709,13.699737,0.2189559999999986,64341.69422167052,25904.747985896876
"244.3.213.210",8726,"244.3.160.239",80,410,431427,127,9485,283,421942,15.217842,4.6240700000000015,16409.786184032677,729992.4092844613
"244.3.218.224",1926,"244.3.41.84",23,38,14976,20,1488,18,13488,6.786392,71.988367,165.36005046482023,1498.9088445359512
"244.3.223.164",50417,"41.177.98.176",80,127,99215,49,10125,78,89090,38.618623,111.009339,729.6683389854254,6420.360722983856
"244.3.223.164",50418,"41.177.98.176",80,49,33957,21,4421,28,29536,40.535823,109.09218100000001,324.2028867311764,2165.948080183675
"244.3.223.164",50419,"41.177.98.176",80,44,25589,21,4403,23,21186,40.536224,109.091827,322.8839498672985,1553.626927524094
"244.3.223.164",50420,"41.177.98.176",80,24,10324,12,2626,12,7698,40.600356,109.027848,192.6847166606462,564.8465151765629
"244.3.223.164",50421,"41.177.98.176",80,19,6051,10,2490,9,3561,40.602087,109.02614899999999,182.70846198557376,261.2951137070796
"244.3.223.164",50422,"41.177.98.176",80,82,65996,33,2885,49,63111,40.603842,109.02442599999999,211.69568001211033,4630.962239599409
"244.3.235.177",4908,"244.3.210.197",80,212,180730,80,27795,132,152935,185.648954,6.854534000000001,32439.84200822404,178492.07546421097
"244.3.235.177",4909,"244.3.210.197",80,137,104762,59,25346,78,79416,186.160653,6.110108999999994,33185.66002668695,103979.81443538905
"244.3.241.24",3772,"244.3.41.84",23,4,256,2,128,2,128,139.527368,0.13312500000000682,7692.018779342329,7692.018779342329
"244.3.241.92",2543,"244.3.41.84",23,4,838,2,201,2,637,64.496613,0.1951970000000074,8237.83152404975,26106.95861104324
"244.3.241.244",1391,"244.3.41.84",23,4,256,2,128,2,128,139.534127,0.16878699999998048,6066.817942140795,6066.817942140795
"244.41.38.43",54439,"41.177.98.127",210,12,1048,5,511,7,537,176.684154,2.009402999999992,2034.435103361554,2137.9484354308306
"244.56.202.67",63638,"41.177.98.143",8001,35,4695,18,1751,17,2944,126.012384,7.821191999999996,1791.0313415141843,3011.305693556687
"244.79.81.193",2370,"244.3.61.177",445,2,132,2,132,0,0,98.800044,3.2442740000000043,325.49655177090426,0
"244.92.254.121",51875,"41.177.26.91",80,306,331731,84,6500,222,325231,198.195687,6.200914000000012,8385.860536043541,419591.04738430417
"244.102.167.142",1684,"41.177.26.176",80,1,64,1,64,0,0,115.33603600000001,0,0,0
"244.102.167.142",1688,"41.177.26.176",80,1,64,1,64,0,0,125.335918,0,0,0
"244.108.194.56",2405,"41.177.26.15",80,9717,8543133,3898,252020,5819,8291113,0.002857,72.03545199999999,27988.44102484427,920781.3952496613
"244.108.194.56",2402,"41.177.26.15",80,8498,7471857,3408,222815,5090,7249042,0.055596,72.208754,24685.649609741224,803120.5745497284
"244.108.194.56",2406,"41.177.26.176",80,3,192,2,128,1,64,13.795408,2.869524,356.85361056398204,178.42680528199102
"244.108.194.56",2404,"41.177.26.176",80,3,192,2,128,1,64,14.045479,2.621081,390.678502495726,195.339251247863
"244.108.194.56",2407,"41.177.26.176",80,6,1046,4,916,2,130,18.4,0.7862710000000028,9319.941852109481,1322.6991711509088
"244.108.194.56",2408,"41.177.26.176",80,55,26437,25,5935,30,20502,19.189575,22.484965,2111.633262493404,7294.474329846634
"244.108.194.56",2409,"41.177.26.176",80,88,59119,38,6095,50,53024,21.441404,20.231236000000003,2410.134506858602,20967.18163932248
"244.108.194.56",2410,"41.177.26.176",80,6,930,4,800,2,130,50.241842,0.6953820000000022,9203.574438222417,1495.5808462111427
"244.108.194.56",2426,"41.177.26.176",80,101,49136,45,9548,56,39588,53.683008,32.521570999999994,2348.7180247227298,9738.27494372889
"244.108.194.56",2427,"41.177.26.176",80,155,113889,63,9795,92,104094,55.911735,25.292655000000003,3098.1326396932227,32924.65737582709
"244.108.194.56",2428,"41.177.26.15",80,20440,18018278,8163,534194,12277,17484084,72.15473,140.904109,30329.50586274244,992679.8657092392
"244.108.194.56",2429,"41.177.26.15",80,20362,17953813,8130,532258,12232,17421555,72.177741,140.898895,30220.705421430022,989166.3096435212
"244.123.225.23",46051,"41.177.26.46",80,69,53842,29,2403,40,51439,186.710391,1.5583480000000236,12336.140579639277,264069.38629882014
"244.135.40.13",50722,"244.3.210.197",80,55,38353,28,2339,27,36014,49.792811,0.5791260000000023,32310.757935233312,497494.5003332589
"244.135.40.84",38962,"41.177.26.46",80,10,1208,5,718,5,490,20.120748,0.238309000000001,24103.160182787793,16449.23187961841
"244.160.160.144",53261,"41.177.98.143",8001,3,298,2,158,1,140,88.177907,0.240752999999998,5250.19418241937,4652.070794548808
"246.4.108.202",13029,"244.3.210.197",80,1,64,1,64,0,0,51.533921,0,0,0
"246.4.108.202",13030,"244.3.210.197",80,1,64,1,64,0,0,56.533988,0,0,0
"249.197.210.41",2176,"244.3.210.197",80,119,103524,47,3358,72,100166,38.382472,46.266155000000005,580.6404271113516,17319.960995245874
"252.23.215.66",62409,"41.177.98.142",80,19,9022,9,835,10,8187,94.550384,16.864822000000004,396.09075032040056,3883.586793860023
"252.72.165.156",51754,"244.3.210.197",80,214,202300,81,10975,133,191325,106.638687,80.73020299999999,1087.5731354224392,18959.44693710234
"252.72.165.156",51757,"244.3.210.197",80,100,91768,40,6577,60,85191,107.48541,79.857268,658.8755327818126,8534.326518658263
"252.72.165.156",51756,"244.3.210.197",80,82,71744,35,7826,47,63918,107.485448,79.85723399999999,783.999105203168,6403.227038892933
"252.72.165.156",51758,"244.3.210.197",80,57,44080,28,8163,29,35917,107.485648,79.883027,817.495310987652,3596.959339059598
"252.72.165.156",51755,"244.3.210.197",80,142,133437,55,8350,87,125087,107.485894,79.882744,836.225655943917,12527.060913180449
"252.72.165.156",51759,"244.3.210.197",80,82,69072,37,7975,45,61097,107.496537,79.87210599999999,798.7769847961691,6119.483064588281
"252.201.84.41",12379,"41.177.26.176",80,2,140,1,70,1,70,1.003781,0.0003249999999999087,0,0
"252.201.84.41",12381,"41.177.26.176",80,2,140,1,70,1,70,1.003785,0.000256000000000034,0,0
"252.201.84.41",12378,"41.177.26.176",80,2,140,1,70,1,70,1.003789,0.0003420000000000645,0,0
"252.201.84.41",12377,"41.177.26.176",80,2,140,1,70,1,70,1.007513,0.00023499999999998522,0,0
"252.201.84.41",12376,"41.177.26.176",80,2,140,1,70,1,70,1.007594,0.00029999999999996696,0,0
"252.201.84.41",12380,"41.177.26.176",80,2,140,1,70,1,70,1.007711,0.00026900000000007473,0,0
"253.37.253.31",1132,"253.37.253.254",1024,8,512,4,256,4,256,16.063871,180.37313,11.354241066837394,11.354241066837394
"253.37.253.31",3887,"253.160.108.127",80,1,64,1,64,0,0,59.750137,0,0,0
"253.37.253.31",3904,"253.160.108.127",80,11,3345,6,1227,5,2118,66.75853,0.021437000000005924,457899.8927087413,790409.1057515192
"253.37.253.31",3905,"253.160.108.127",80,5,935,3,805,2,130,68.82602,0.14978800000000092,42994.0983256333,6943.146313456309
"253.37.253.31",3912,"253.160.108.83",80,16,8737,9,2825,7,5912,190.667606,0.016771000000005643,1347564.247808264,2820106.13559025
"253.37.253.43",2004,"41.177.127.188",515,19,11556,19,11556,0,0,12.806345,0.17726500000000023,521524.2715708114,0
"253.37.253.43",2005,"41.177.127.188",515,25,13122,25,13122,0,0,13.014276,21.475321,4888.215640641646,0
"253.37.253.43",2000,"253.108.213.210",515,11,1257,11,1257,0,0,31.936205,0.41665100000000166,24135.307487561437,0
"253.37.253.43",2000,"253.108.213.38",515,11,1257,11,1257,0,0,31.953726,0.3546200000000006,28357.114657943664,0
"253.37.253.43",2000,"253.77.13.210",515,11,1257,11,1257,0,0,31.967079,0.31473100000000187,31951.094744400583,0
"253.37.253.43",2000,"253.211.127.68",515,11,1257,11,1257,0,0,31.977256,0.28700600000000165,35037.595032856254,0
"253.37.253.43",2000,"253.211.127.145",515,11,1257,11,1257,0,0,31.983813,0.2890709999999963,34787.301389624445,0
"253.37.253.43",2000,"253.108.84.210",515,11,1257,11,1257,0,0,32.009612,0.4317190000000011,23292.92896536862,0
"253.37.253.43",2000,"253.108.164.4",515,11,1160,11,1160,0,0,32.01934,0.1910740000000004,48567.570679422526,0
"253.37.253.43",2000,"253.77.13.41",515,11,1257,11,1257,0,0,32.030215,0.4233730000000051,23752.105117709158,0
"253.37.253.43",2000,"253.77.84.38",515,11,1257,11,1257,0,0,32.041065,0.43013399999999535,23378.76103725841,0
"253.37.253.43",2000,"253.108.84.17",515,11,1257,11,1257,0,0,32.052819,0.2330430000000021,43150.83482447406,0
"253.37.253.43",2000,"253.116.84.93",515,11,1257,11,1257,0,0,32.060294,0.3321420000000046,30276.207164405165,0
"253.37.253.43",2000,"253.116.185.210",515,11,1257,11,1257,0,0,32.202434,0.3927660000000017,25603.030812239234,0
"253.37.253.43",2000,"253.116.185.116",515,11,1257,11,1257,0,0,32.218437,0.4374520000000004,22987.664932381133,0
"253.37.253.43",2000,"253.108.13.57",515,11,1257,11,1257,0,0,32.242581,0.4204870000000014,23915.126983711663,0
"253.37.253.43",2000,"253.77.185.38",515,11,1257,11,1257,0,0,32.265738,0.3327990000000014,30216.436948428203,0
"253.37.253.43",2000,"253.77.84.17",515,11,1530,11,1530,0,0,32.276553,0.3535970000000006,34615.67830043801,0
"253.37.253.43",2000,"253.116.13.159",515,11,1257,11,1257,0,0,32.300976,0.4724950000000021,21282.764896982942,0
"253.37.253.43",2000,"253.108.185.116",515,11,1257,11,1257,0,0,32.31741,0.3976499999999987,25288.570350811096,0
"253.37.253.43",2000,"253.108.185.210",515,11,1257,11,1257,0,0,32.337322,0.3051329999999979,32956.120773564544,0
"253.37.253.43",2000,"253.108.13.113",515,11,1234,11,1234,0,0,32.354302,0.2564340000000058,38497.23515602368,0
"253.37.253.43",2000,"253.77.185.116",515,11,1257,11,1257,0,0,32.371384,0.42786000000000257,23503.015004908008,0
"253.37.253.43",2000,"253.160.251.121",515,11,1947,11,1947,0,0,97.53773,0.4190940000000012,37165.88641211746,0
"253.37.253.43",2000,"253.116.23.22",515,14,5295,14,5295,0,0,101.795754,5.797059000000004,7307.153506631546,0
"253.37.253.43",2000,"253.116.23.22",515,15,4749,15,4749,0,0,201.972896,0.20051800000001663,189469.2745788251,0
"253.37.253.43",2000,"253.213.108.203",515,11,1347,11,1347,0,0,212.967296,0.04328599999999483,248948.85182279,0
"253.37.253.121",2775,"253.160.108.127",80,1,64,1,64,0,0,175.238752,0,0,0
"253.37.253.121",2792,"253.160.108.127",80,10,3281,6,1227,4,2054,182.245403,0.02458399999997596,399284.08721158473,668402.2128220008
"253.37.253.121",2793,"253.160.108.127",80,5,935,3,805,2,130,184.426606,0.16547300000001997,38918.7359871352,6285.0132650032
"253.37.253.167",62141,"41.177.230.224",25,33,13607,18,12090,15,1517,117.206201,5.107290000000006,18937.636202369533,2376.2112588084847
"253.37.253.251",1081,"253.37.253.254",1024,6,384,3,192,3,192,76.123588,120.33734199999999,12.764117724986813,12.764117724986813
"253.84.160.220",4645,"253.37.253.43",23,3,194,0,0,3,194,149.953762,0.0031259999999804222,0,0
"253.84.160.220",4754,"253.37.253.43",23,6,664,0,0,6,664,150.047345,0.14328599999998914,0,37072.70773139317
"253.108.164.75",1433,"253.37.253.43",23,24,23722,0,0,24,23722,36.267497,24.413874,0,7773.284977222378
"253.110.77.41",4502,"253.37.253.43",23,21,18318,0,0,21,18318,5.409681,75.744479,0,1934.7152681583566
"253.116.23.130",1604,"253.37.253.43",23,75,48458,4,264,71,48194,42.828773,162.99949900000001,12.957095039905612,2365.3569634591327
"253.127.160.31",4664,"253.37.253.43",23,3,194,0,0,3,194,149.954952,0.0055030000000044765,0,282027.98473536933
"253.127.160.31",4750,"253.37.253.43",23,6,664,0,0,6,664,149.97764,0.2103569999999877,0,25252.30916965117
"253.142.108.39",4437,"253.37.253.43",23,13,8195,0,0,13,8195,13.700397,122.03973900000001,0,537.2020666153669
"253.142.108.127",3516,"253.37.253.43",23,14,5941,0,0,14,5941,196.921011,14.581732000000017,0,3259.420760167581
"253.142.160.224",3948,"253.37.253.43",23,13,7227,0,0,13,7227,193.942329,13.979106000000002,0,4135.886801344806
"253.142.253.71",2410,"253.37.253.43",23,37,25031,0,0,37,25031,48.361826,82.069017,0,2439.9951080198753
"253.142.253.218",2470,"253.37.253.43",23,6,5043,0,0,6,5043,37.309448,44.820465,0,900.1245301671904
"253.160.43.128",2426,"253.37.253.43",23,2,554,0,0,2,554,0.375423,1.585203,0,2795.8564297443295
"253.160.43.128",2435,"253.37.253.43",23,17,7721,0,0,17,7721,2.8509919999999997,6.795522,0,9089.515124813075
"253.160.108.37",4117,"253.37.253.43",23,2,1042,0,0,2,1042,28.504844,1.9433250000000015,0,4289.555272535471
"253.160.211.176",3741,"253.37.253.43",23,1,64,0,0,1,64,16.087895,0,0,0
"253.160.211.176",1203,"253.37.253.43",23,22,11834,0,0,22,11834,26.146653,147.583847,0,641.4794161043925
"253.160.251.79",4667,"253.37.253.43",446,236,321405,0,0,236,321405,21.025066,0.6460630000000016,0,3979859.5493009095
"253.160.251.79",4698,"253.37.253.43",446,133,174810,0,0,133,174810,35.227698,1.0780520000000067,0,1297228.7051088365
"253.160.251.79",4725,"253.37.253.43",446,518,722922,0,0,518,722922,59.957605,3.5231679999999983,0,1641527.1710006457
"253.160.251.79",4734,"253.37.253.43",446,34,36920,0,0,34,36920,61.477935,9.651473999999993,0,30602.57946091967
"253.160.251.79",4757,"253.37.253.43",446,48,54489,0,0,48,54489,69.199475,0.29597099999999443,0,1472819.9722270365
"253.160.251.79",4796,"253.37.253.43",446,793,1116890,0,0,793,1116890,88.728369,2.085915,0,4283549.425551856
"253.160.251.79",4809,"253.37.253.43",446,740,1040467,0,0,740,1040467,89.792635,1.8692920000000015,0,4452881.625770609
"253.160.251.79",4818,"253.37.253.43",446,39,44954,0,0,39,44954,93.204049,0.4108020000000039,0,875438.7758579477
"253.160.251.79",4834,"253.37.253.43",446,149,201381,0,0,149,201381,106.515221,0.5579210000000074,0,2887591.612432546
"253.160.251.79",4848,"253.37.253.43",446,47,57088,0,0,47,57088,133.449478,0.6154750000000035,0,742035.0136073722
"253.160.251.79",4913,"253.37.253.43",446,183,245454,0,0,183,245454,182.732539,0.48328200000000265,0,4063118.4277502354
"253.160.251.79",4922,"253.37.253.43",446,33,35341,0,0,33,35341,184.89686,0.8257159999999999,0,342403.44137693837
"253.160.251.79",4949,"253.37.253.43",446,19,16400,0,0,19,16400,212.800031,0.2723190000000102,0,481787.9031576757
"253.160.251.85",42672,"253.37.253.43",446,7,1967,0,0,7,1967,0.835096,0.06523400000000001,0,241223.90164638066
"253.160.251.85",42676,"253.37.253.43",446,12,4182,0,0,12,4182,5.026398,0.09967900000000007,0,335637.3960412923
"253.160.251.85",42706,"253.37.253.43",446,8,2950,0,0,8,2950,10.042403,0.06405200000000022,0,368450.6338599875
"253.160.251.85",42718,"253.37.253.43",446,7,1408,0,0,7,1408,10.777637,0.08123699999999978,0,138656.03111882554
"253.160.251.85",42729,"253.37.253.43",446,5,1123,0,0,5,1123,16.140644,0.044454999999999245,0,202092.00314925547
"253.160.251.85",42745,"253.37.253.43",446,5,1123,0,0,5,1123,24.323676,0.04828600000000094,0,186058.07066230016
"253.160.251.85",42766,"253.37.253.43",446,7,1967,0,0,7,1967,42.029538,0.061751999999998475,0,254825.75463143524
"253.160.251.85",42791,"253.37.253.43",446,9,3744,0,0,9,3744,45.916128,0.07670900000000103,0,390462.6575760289
"253.160.251.85",42796,"253.37.253.43",446,23,17851,0,0,23,17851,46.133904,0.2484409999999997,0,574816.5560434879
"253.160.251.85",42810,"253.37.253.43",446,36,37040,0,0,36,37040,48.972187,0.34153200000000083,0,867620.0180363752
"253.160.251.85",42819,"253.37.253.43",446,5,1453,0,0,5,1453,52.542119,0.05413300000000021,0,214730.3862708506
"253.160.251.85",42836,"253.37.253.43",446,357,494607,0,0,357,494607,57.361119,0.7518979999999971,0,5262490.390983904
"253.160.251.85",42846,"253.37.253.43",446,5,1453,0,0,5,1453,58.220294,0.047928999999996336,0,242525.4021573763
"253.160.251.85",42856,"253.37.253.43",446,25,27920,0,0,25,27920,59.115495,1.0660219999999967,0,209526.6326586137
"253.160.251.85",42873,"253.37.253.43",446,5,1453,0,0,5,1453,69.218097,0.043756000000001904,0,265654.9958862669
"253.160.251.85",42884,"253.37.253.43",446,5,1453,0,0,5,1453,72.305235,0.05952899999999772,0,195266.1727897402
"253.160.251.85",42892,"253.37.253.43",446,17,18484,0,0,17,18484,72.890531,0.08532000000001005,0,1733145.8040316757
"253.160.251.85",42908,"253.37.253.43",446,69,86224,0,0,69,86224,76.762001,0.42215300000000866,0,1633985.7824058714
"253.160.251.85",42933,"253.37.253.43",446,54,62238,0,0,54,62238,88.521252,0.2896119999999911,0,1719210.5299504693
"253.160.251.85",42960,"253.37.253.43",446,406,565051,0,0,406,565051,97.107072,1.486891,0,3040174.431078001
"253.160.251.85",42978,"253.37.253.43",446,5,1453,0,0,5,1453,101.441058,0.08017800000000364,0,144977.4252288592
"253.160.251.85",42986,"253.37.253.43",446,22,22322,0,0,22,22322,101.636618,0.29770399999999597,0,599844.140488547
"253.160.251.85",42993,"253.37.253.43",446,15,15395,0,0,15,15395,103.321611,0.19423999999999353,0,634060.9555189668
"253.160.251.85",43008,"253.37.253.43",446,5,1453,0,0,5,1453,123.008447,0.049674999999993474,0,234001.00654255715
"253.160.251.85",43040,"253.37.253.43",446,91,114772,0,0,91,114772,145.747435,0.23087400000000002,0,3976957.128130495
"253.160.251.85",43049,"253.37.253.43",446,18,18420,0,0,18,18420,148.591695,0.42045900000002234,0,350474.1247065521
"253.160.251.85",43056,"253.37.253.43",446,26,31832,0,0,26,31832,150.663865,0.19147900000001528,0,1329942.1868715612
"253.160.251.85",43062,"253.37.253.43",446,79,101403,0,0,79,101403,160.030985,0.32732200000000944,0,2478366.8680992313
"253.160.251.85",43095,"253.37.253.43",446,505,703495,0,0,505,703495,180.39741,0.7252479999999935,0,7760048.976350229
"253.160.251.90",2709,"253.37.253.43",446,49,62796,0,0,49,62796,0.025813,0.247935,0,2026208.4820618308
"253.160.251.90",2694,"253.37.253.43",446,2,176,0,0,2,176,1.408263,0.0016809999999998215,0,0
"253.160.251.90",2721,"253.37.253.43",446,32,37240,0,0,32,37240,12.698632,0.24870199999999976,0,1197899.4941737512
"253.160.251.90",2818,"253.37.253.43",446,13,9702,0,0,13,9702,55.781648,0.1873210000000043,0,414347.5638075721
"253.160.251.90",2860,"253.37.253.43",446,247,336838,0,0,247,336838,76.310288,0.6540219999999977,0,4120203.9075138294
"253.160.251.90",2886,"253.37.253.43",446,73,89568,0,0,73,89568,92.101588,0.4666609999999878,0,1535470.0735652193
"253.160.251.90",2892,"253.37.253.43",446,18,13115,0,0,18,13115,93.629013,0.18464299999999412,0,568231.6686795781
"253.160.251.90",2944,"253.37.253.43",446,247,336838,0,0,247,336838,144.301638,0.6449619999999925,0,4178081.8094709944
"253.160.251.90",2967,"253.37.253.43",446,121,157582,0,0,121,157582,151.165341,0.7003139999999917,0,1800129.6561257022
"253.160.251.90",2989,"253.37.253.43",446,437,608813,0,0,437,608813,166.940538,1.2076260000000048,0,4033122.8376997355
"253.160.251.90",3012,"253.37.253.43",446,349,485265,0,0,349,485265,173.319758,0.7367249999999785,0,5269428.891377533
"253.160.251.90",3028,"253.37.253.43",446,791,1112697,0,0,791,1112697,177.003644,3.4245909999999924,0,2599310.6914081182
"253.160.251.90",3057,"253.37.253.43",446,185,248977,0,0,185,248977,181.851597,0.7414890000000014,0,2686238.096586728
"253.160.251.90",3084,"253.37.253.43",446,814,1146038,0,0,814,1146038,194.181584,1.479723000000007,0,6195959.649204586
"253.160.251.90",3110,"253.37.253.43",446,1651,2337346,0,0,1651,2337346,203.510481,7.382498999999996,0,2532850.732522959
"253.176.108.193",2104,"253.37.253.43",23,10,8854,0,0,10,8854,52.642799,85.30980300000002,0,830.2914496239076
"253.180.253.142",2202,"253.37.253.43",23,19,14704,0,0,19,14704,7.041953,100.242138,0,1173.478562478386
"253.197.108.81",2203,"253.37.253.43",23,1,1261,0,0,1,1261,4.173453,0,0,0
"253.201.164.211",2781,"253.37.253.43",23,19,10112,0,0,19,10112,59.810116,132.833637,0,609.0023718916918
"253.201.164.241",3866,"253.37.253.43",23,14,6311,0,0,14,6311,15.110248,13.703387000000001,0,3684.3446076506484
"253.201.253.26",2047,"253.37.253.43",23,5,4617,0,0,5,4617,180.120401,5.389301000000017,0,6853.578970630863
"253.213.108.56",1191,"253.37.253.43",23,4,4860,0,0,4,4860,133.558474,8.519317000000001,0,4563.7461312919795
"253.213.108.68",1715,"253.37.253.43",23,40,35530,0,0,40,35530,0.666608,94.502474,0,3007.751945203043
"253.213.108.71",2466,"253.37.253.43",23,38,35821,4,264,34,35557,49.250142,161.377431,13.087331895870866,1762.6752281116683
"253.213.108.77",1510,"253.37.253.43",23,4,3968,0,0,4,3968,3.015915,2.0902689999999997,0,15186.562112340567
"253.213.108.79",1451,"253.37.253.43",23,5,5293,0,0,5,5293,200.230366,10.627013000000005,0,3984.562736490487
"253.213.108.105",1679,"253.37.253.43",23,4,3201,0,0,4,3201,23.850095,13.760994,0,1860.9120823684684
"253.213.108.145",1509,"253.37.253.43",23,18,19594,0,0,18,19594,2.856941,197.118245,0,795.2181189519011
"253.213.108.176",1597,"253.37.253.43",23,11,10901,0,0,11,10901,3.756243,186.07597299999998,0,468.66878401329126
"253.213.108.181",1988,"253.37.253.43",23,74,72987,0,0,74,72987,2.537181,193.20546,0,3022.150616240349
"253.213.108.188",1894,"253.37.253.43",23,4,3956,0,0,4,3956,36.060111,87.106697,0,363.3245329001512
"253.213.108.229",1840,"253.37.253.43",23,41,37934,4,264,37,37670,28.393445,134.29253799999998,15.726860415729133,2244.056181289835
"253.213.108.239",2313,"253.37.253.43",23,1,808,0,0,1,808,196.250392,0,0,0
"253.244.77.47",3189,"253.23.23.108",139,3,198,3,198,0,0,0.283126,9.037626000000001,175.2672659833456,0
"253.244.77.47",3201,"253.23.23.108",139,3,198,3,198,0,0,82.748968,8.951696999999996,176.94968898075982,0
"253.244.77.47",3214,"253.23.23.108",139,3,198,3,198,0,0,125.095684,9.15288799999999,173.0601314033343,0
"253.244.77.47",3220,"253.23.23.108",139,3,198,3,198,0,0,167.442501,9.05405300000001,174.949274098572,0
"253.244.77.47",3231,"253.23.23.108",139,2,132,2,132,0,0,209.889631,3.0171149999999898,350.003231563929,0
"253.254.77.24",3601,"253.37.253.43",23,6,6823,0,0,6,6823,41.237691,85.837507,0,635.8991763355848
"254.40.41.194",2472,"244.3.210.197",80,6,388,3,194,3,194,28.443195,110.44776099999999,14.05189191657765,14.05189191657765
"254.71.85.201",29176,"41.177.98.127",210,14,1162,7,631,7,531,3.624474,1.443002,3498.2626496706175,2943.862863668935
"254.71.85.201",29183,"41.177.98.127",210,14,1176,7,645,7,531,15.126304,2.275919,2267.2160125206565,1866.4987637960753
"254.71.85.201",29202,"41.177.98.127",210,14,1162,7,631,7,531,50.21677,1.4031970000000058,3597.499139465078,3027.3724929571417
"254.71.85.201",29261,"41.177.98.127",210,14,1162,7,631,7,531,60.273726,1.3864859999999979,3640.858977299452,3063.8607241616623
"254.71.85.201",29263,"41.177.98.127",210,16,2628,8,722,8,1906,68.591996,1.4781690000000083,3907.5369595763186,10315.464605197318
"254.71.208.31",50624,"41.177.26.176",80,1,1518,0,0,1,1518,24.885474,0,0,0
"254.120.224.98",3233,"244.3.31.68",445,2,164,2,164,0,0,54.294788,2.9556340000000034,443.89799278259704,0
"254.194.155.98",56923,"244.3.210.197",80,132,153173,29,2274,103,150899,50.999146,0.7945069999999959,22897.218023252273,1519422.7363635642
"254.210.244.164",5140,"41.177.98.127",210,14,1171,7,624,7,547,17.429425,1.5834590000000013,3152.5918890227003,2763.570133486245
"254.210.244.164",44407,"41.177.98.127",210,14,1171,7,624,7,547,19.014255,1.574936000000001,3169.6526081059783,2778.5256035800803
"254.224.83.141",3880,"41.177.98.127",210,296,239868,112,7763,184,232105,0.046269,17.468288,3555.2425057338187,106297.76655846296
"254.224.83.141",3905,"41.177.98.127",210,398,331677,137,9711,261,321966,145.751995,24.881910000000005,3122.268346762768,103518.09808812906
